ID,Флаг дозвона,Флаг продажи,Расходы,PV,NPV
0,1,0,11,0,-11
1,0,0,36,0,-36
2,1,1,310,1216,906
3,1,1,1178,1453,275
4,1,1,402,2001,1599
5,1,1,753,1544,791
6,0,0,12,0,-12
7,1,0,176,0,-176
8,1,1,204,1395,1191
9,1,0,92,0,-92
10,1,0,122,0,-122
11,1,0,17,0,-17
12,1,0,134,0,-134
13,1,0,166,0,-166
14,1,1,755,1349,594
15,1,1,759,1467,708
16,0,0,6,0,-6
17,1,0,2,0,-2
18,1,1,606,1524,918
19,0,0,28,0,-28
20,1,1,139,1704,1565
21,0,0,4,0,-4
22,0,0,18,0,-18
23,0,0,6,0,-6
24,1,1,198,1287,1089
25,1,1,205,1262,1057
26,1,0,50,0,-50
27,1,0,62,0,-62
28,0,0,2,0,-2
29,0,0,16,0,-16
30,1,1,853,1240,387
31,1,1,1039,1472,433
32,0,0,48,0,-48
33,1,1,362,1610,1248
34,0,0,69,0,-69
35,0,0,14,0,-14
36,0,0,47,0,-47
37,1,1,619,1527,908
38,0,0,1,0,-1
39,0,0,21,0,-21
40,1,0,24,0,-24
41,0,0,31,0,-31
42,0,0,74,0,-74
43,0,0,18,0,-18
44,0,0,58,0,-58
45,1,1,680,1209,529
46,0,0,24,0,-24
47,1,1,985,1521,536
48,1,0,195,0,-195
49,1,1,103,1623,1520
50,1,1,78,1343,1265
51,1,0,21,0,-21
52,1,1,36,1682,1646
53,0,0,33,0,-33
54,1,1,248,1317,1069
55,1,0,98,0,-98
56,0,0,22,0,-22
57,0,0,23,0,-23
58,0,0,30,0,-30
59,0,0,20,0,-20
60,1,1,802,1663,861
61,1,1,2276,1455,-821
62,1,0,87,0,-87
63,1,1,16,1508,1492
64,0,0,47,0,-47
65,1,0,82,0,-82
66,0,0,66,0,-66
67,1,0,15,0,-15
68,1,1,728,1752,1024
69,1,0,80,0,-80
70,1,1,63,3152,3089
71,0,0,125,0,-125
72,0,0,30,0,-30
73,0,0,20,0,-20
74,0,0,68,0,-68
75,1,0,12,0,-12
76,1,0,184,0,-184
77,0,0,16,0,-16
78,1,1,331,1268,937
79,1,1,828,1466,638
80,0,0,37,0,-37
81,1,1,171,1569,1398
82,1,0,31,0,-31
83,0,0,68,0,-68
84,0,0,320,0,-320
85,1,0,1,0,-1
86,0,0,23,0,-23
87,1,1,1252,1569,317
88,0,0,62,0,-62
89,0,0,41,0,-41
90,1,0,12,0,-12
91,1,1,827,1416,589
92,0,0,24,0,-24
93,0,0,23,0,-23
94,0,0,9,0,-9
95,1,0,34,0,-34
96,0,0,76,0,-76
97,1,0,3,0,-3
98,1,0,53,0,-53
99,1,1,3664,1209,-2455
100,0,0,15,0,-15
101,0,0,12,0,-12
102,1,0,29,0,-29
103,1,1,487,1402,915
104,1,1,43,1274,1231
105,1,1,189,1698,1509
106,1,1,787,1373,586
107,1,1,221,1821,1600
108,1,1,132,1349,1217
109,1,0,65,0,-65
110,1,0,158,0,-158
111,1,0,14,0,-14
112,1,0,22,0,-22
113,1,0,24,0,-24
114,1,1,246,1315,1069
115,1,0,8,0,-8
116,0,0,41,0,-41
117,1,0,80,0,-80
118,1,1,70,1208,1138
119,1,0,21,0,-21
120,0,0,36,0,-36
121,0,0,27,0,-27
122,1,1,150,2936,2786
123,0,0,12,0,-12
124,0,0,55,0,-55
125,0,0,6,0,-6
126,0,0,16,0,-16
127,1,1,1803,1208,-595
128,0,0,10,0,-10
129,1,1,389,1365,976
130,0,0,0,0,0
131,0,0,10,0,-10
132,0,0,156,0,-156
133,0,0,141,0,-141
134,1,0,191,0,-191
135,1,0,37,0,-37
136,0,0,41,0,-41
137,0,0,77,0,-77
138,0,0,70,0,-70
139,0,0,0,0,0
140,1,0,45,0,-45
141,1,0,12,0,-12
142,1,0,16,0,-16
143,0,0,13,0,-13
144,0,0,51,0,-51
145,0,0,126,0,-126
146,1,1,251,1360,1109
147,0,0,34,0,-34
148,0,0,64,0,-64
149,1,0,9,0,-9
150,0,0,84,0,-84
151,1,1,187,1518,1331
152,1,0,11,0,-11
153,1,1,889,1287,398
154,1,1,155,1538,1383
155,0,0,59,0,-59
156,0,0,55,0,-55
157,1,0,31,0,-31
158,1,1,458,1544,1086
159,0,0,51,0,-51
160,1,0,14,0,-14
161,0,0,127,0,-127
162,1,0,20,0,-20
163,1,0,24,0,-24
164,0,0,35,0,-35
165,1,0,1,0,-1
166,1,0,84,0,-84
167,0,0,126,0,-126
168,0,0,50,0,-50
169,1,0,4,0,-4
170,1,0,85,0,-85
171,1,1,321,1476,1155
172,0,0,156,0,-156
173,0,0,84,0,-84
174,1,0,32,0,-32
175,1,0,11,0,-11
176,1,0,69,0,-69
177,0,0,10,0,-10
178,1,1,589,1375,786
179,0,0,37,0,-37
180,1,1,1664,1280,-384
181,1,1,35,1827,1792
182,1,0,19,0,-19
183,0,0,7,0,-7
184,1,1,223,1756,1533
185,0,0,143,0,-143
186,0,0,48,0,-48
187,1,0,1,0,-1
188,1,0,68,0,-68
189,1,1,93,1430,1337
190,1,0,45,0,-45
191,0,0,54,0,-54
192,0,0,85,0,-85
193,1,0,1,0,-1
194,1,1,248,1992,1744
195,1,0,99,0,-99
196,1,0,34,0,-34
197,0,0,75,0,-75
198,0,0,124,0,-124
199,1,0,23,0,-23
200,0,0,3,0,-3
201,1,1,904,1528,624
202,0,0,130,0,-130
203,1,0,29,0,-29
204,1,1,134,2478,2344
205,0,0,40,0,-40
206,1,1,813,1537,724
207,0,0,24,0,-24
208,1,0,194,0,-194
209,1,0,1,0,-1
210,1,1,110,1273,1163
211,0,0,237,0,-237
212,0,0,15,0,-15
213,0,0,46,0,-46
214,1,0,107,0,-107
215,0,0,28,0,-28
216,1,1,669,2294,1625
217,1,0,16,0,-16
218,1,0,34,0,-34
219,1,0,127,0,-127
220,1,1,225,1332,1107
221,1,1,379,1258,879
222,1,1,400,1554,1154
223,0,0,70,0,-70
224,1,0,7,0,-7
225,1,1,1104,1548,444
226,1,0,52,0,-52
227,0,0,116,0,-116
228,0,0,11,0,-11
229,1,0,32,0,-32
230,0,0,101,0,-101
231,1,0,48,0,-48
232,0,0,136,0,-136
233,0,0,16,0,-16
234,1,1,574,1509,935
235,1,1,249,1358,1109
236,1,1,154,1427,1273
237,1,0,30,0,-30
238,1,0,0,0,0
239,1,1,174,1347,1173
240,0,0,39,0,-39
241,1,1,906,1297,391
242,0,0,19,0,-19
243,0,0,22,0,-22
244,1,0,64,0,-64
245,1,1,1486,1458,-28
246,1,0,64,0,-64
247,1,0,324,0,-324
248,1,1,548,1617,1069
249,1,0,26,0,-26
250,1,1,206,1376,1170
251,1,0,9,0,-9
252,1,0,17,0,-17
253,0,0,30,0,-30
254,1,1,1386,1646,260
255,0,0,20,0,-20
256,1,0,27,0,-27
257,1,1,87,1377,1290
258,1,0,40,0,-40
259,1,1,384,1249,865
260,1,0,31,0,-31
261,0,0,54,0,-54
262,0,0,22,0,-22
263,1,0,90,0,-90
264,1,0,129,0,-129
265,1,1,71,2489,2418
266,1,0,170,0,-170
267,0,0,70,0,-70
268,1,0,21,0,-21
269,1,1,235,1762,1527
270,0,0,8,0,-8
271,0,0,61,0,-61
272,1,0,13,0,-13
273,1,1,354,2343,1989
274,1,0,38,0,-38
275,0,0,12,0,-12
276,1,1,81,1688,1607
277,1,0,4,0,-4
278,0,0,48,0,-48
279,1,1,628,1711,1083
280,0,0,14,0,-14
281,0,0,46,0,-46
282,1,0,174,0,-174
283,1,0,63,0,-63
284,1,1,277,1468,1191
285,0,0,3,0,-3
286,1,0,64,0,-64
287,1,0,87,0,-87
288,0,0,3,0,-3
289,0,0,85,0,-85
290,0,0,4,0,-4
291,1,1,2351,2582,231
292,0,0,66,0,-66
293,1,1,621,1243,622
294,0,0,12,0,-12
295,0,0,18,0,-18
296,1,0,191,0,-191
297,0,0,40,0,-40
298,1,0,20,0,-20
299,1,0,0,0,0
300,0,0,1,0,-1
301,0,0,34,0,-34
302,0,0,55,0,-55
303,1,0,80,0,-80
304,0,0,35,0,-35
305,1,0,20,0,-20
306,0,0,54,0,-54
307,1,0,8,0,-8
308,0,0,54,0,-54
309,0,0,150,0,-150
310,1,0,6,0,-6
311,1,0,67,0,-67
312,0,0,4,0,-4
313,0,0,70,0,-70
314,0,0,2,0,-2
315,1,1,150,1353,1203
316,1,1,571,1359,788
317,1,1,29,2153,2124
318,1,0,146,0,-146
319,1,1,1542,1342,-200
320,1,0,4,0,-4
321,0,0,35,0,-35
322,0,0,10,0,-10
323,1,1,455,1200,745
324,1,1,177,1234,1057
325,0,0,21,0,-21
326,0,0,25,0,-25
327,1,0,41,0,-41
328,1,1,43,1352,1309
329,0,0,3,0,-3
330,1,1,456,1226,770
331,1,0,62,0,-62
332,1,1,27,1251,1224
333,1,0,37,0,-37
334,0,0,182,0,-182
335,1,0,0,0,0
336,0,0,17,0,-17
337,0,0,65,0,-65
338,1,0,3,0,-3
339,1,0,2,0,-2
340,1,0,60,0,-60
341,1,0,62,0,-62
342,1,1,418,1586,1168
343,1,1,249,1218,969
344,0,0,37,0,-37
345,1,1,132,1408,1276
346,1,1,140,2794,2654
347,1,0,33,0,-33
348,1,1,327,3194,2867
349,1,0,11,0,-11
350,0,0,38,0,-38
351,0,0,53,0,-53
352,1,1,907,1558,651
353,1,0,109,0,-109
354,1,1,969,1221,252
355,0,0,89,0,-89
356,0,0,95,0,-95
357,1,1,172,1433,1261
358,0,0,0,0,0
359,1,0,53,0,-53
360,0,0,131,0,-131
361,0,0,11,0,-11
362,1,0,17,0,-17
363,1,1,149,1639,1490
364,0,0,117,0,-117
365,1,0,40,0,-40
366,0,0,10,0,-10
367,0,0,47,0,-47
368,0,0,46,0,-46
369,1,1,1077,1350,273
370,1,0,20,0,-20
371,0,0,40,0,-40
372,0,0,126,0,-126
373,1,0,67,0,-67
374,1,1,376,1299,923
375,1,1,1289,1367,78
376,1,1,91,1454,1363
377,1,1,494,1344,850
378,0,0,2,0,-2
379,1,1,395,1433,1038
380,1,0,46,0,-46
381,1,0,30,0,-30
382,0,0,35,0,-35
383,0,0,51,0,-51
384,0,0,6,0,-6
385,0,0,36,0,-36
386,0,0,35,0,-35
387,1,0,1,0,-1
388,0,0,50,0,-50
389,0,0,41,0,-41
390,0,0,64,0,-64
391,1,1,715,2111,1396
392,0,0,10,0,-10
393,0,0,88,0,-88
394,0,0,43,0,-43
395,1,0,1,0,-1
396,0,0,7,0,-7
397,0,0,10,0,-10
398,0,0,31,0,-31
399,1,1,505,1602,1097
400,1,0,64,0,-64
401,0,0,120,0,-120
402,1,1,153,1290,1137
403,1,1,22,2120,2098
404,1,0,15,0,-15
405,1,0,67,0,-67
406,1,0,62,0,-62
407,0,0,12,0,-12
408,0,0,21,0,-21
409,1,1,373,1327,954
410,0,0,106,0,-106
411,1,1,255,1208,953
412,1,0,146,0,-146
413,0,0,60,0,-60
414,1,1,2476,1500,-976
415,0,0,78,0,-78
416,1,0,3,0,-3
417,1,1,62,1303,1241
418,0,0,14,0,-14
419,1,0,12,0,-12
420,0,0,6,0,-6
421,0,0,114,0,-114
422,0,0,67,0,-67
423,1,0,99,0,-99
424,1,0,98,0,-98
425,0,0,164,0,-164
426,1,0,44,0,-44
427,0,0,48,0,-48
428,1,1,715,1272,557
429,1,0,81,0,-81
430,1,0,106,0,-106
431,1,0,48,0,-48
432,0,0,6,0,-6
433,1,0,27,0,-27
434,0,0,23,0,-23
435,0,0,16,0,-16
436,1,0,5,0,-5
437,1,0,19,0,-19
438,0,0,65,0,-65
439,1,0,67,0,-67
440,0,0,18,0,-18
441,0,0,83,0,-83
442,1,1,378,1345,967
443,0,0,0,0,0
444,1,1,141,1400,1259
445,1,1,1174,1268,94
446,1,0,5,0,-5
447,1,1,258,1373,1115
448,0,0,53,0,-53
449,0,0,157,0,-157
450,1,0,32,0,-32
451,1,1,866,1246,380
452,0,0,4,0,-4
453,0,0,36,0,-36
454,1,1,272,1473,1201
455,0,0,33,0,-33
456,1,0,100,0,-100
457,0,0,48,0,-48
458,1,0,56,0,-56
459,1,1,389,1581,1192
460,0,0,29,0,-29
461,0,0,22,0,-22
462,1,0,25,0,-25
463,1,1,103,1258,1155
464,1,0,19,0,-19
465,0,0,122,0,-122
466,0,0,165,0,-165
467,0,0,62,0,-62
468,0,0,22,0,-22
469,0,0,3,0,-3
470,0,0,157,0,-157
471,1,0,30,0,-30
472,0,0,78,0,-78
473,1,1,417,1295,878
474,1,0,37,0,-37
475,1,0,3,0,-3
476,0,0,103,0,-103
477,1,0,4,0,-4
478,0,0,9,0,-9
479,0,0,57,0,-57
480,1,1,217,1550,1333
481,1,0,9,0,-9
482,1,0,90,0,-90
483,0,0,29,0,-29
484,1,0,46,0,-46
485,1,1,169,1211,1042
486,0,0,36,0,-36
487,1,1,1472,1357,-115
488,1,1,172,1249,1077
489,1,0,7,0,-7
490,0,0,218,0,-218
491,0,0,20,0,-20
492,1,1,704,1241,537
493,0,0,61,0,-61
494,0,0,88,0,-88
495,0,0,3,0,-3
496,1,1,793,1343,550
497,0,0,6,0,-6
498,1,0,16,0,-16
499,1,0,73,0,-73
500,0,0,109,0,-109
501,0,0,4,0,-4
502,1,0,22,0,-22
503,1,1,340,1410,1070
504,1,0,96,0,-96
505,1,0,82,0,-82
506,1,1,321,1541,1220
507,1,1,693,1288,595
508,0,0,45,0,-45
509,1,1,390,1381,991
510,1,1,62,1389,1327
511,0,0,57,0,-57
512,1,1,74,1430,1356
513,1,0,79,0,-79
514,1,1,688,1202,514
515,1,0,4,0,-4
516,1,1,467,1497,1030
517,0,0,30,0,-30
518,0,0,5,0,-5
519,1,0,186,0,-186
520,1,0,20,0,-20
521,1,1,1075,1801,726
522,1,0,66,0,-66
523,1,1,403,1375,972
524,1,0,66,0,-66
525,0,0,46,0,-46
526,1,0,90,0,-90
527,0,0,27,0,-27
528,1,0,159,0,-159
529,0,0,15,0,-15
530,0,0,16,0,-16
531,1,0,0,0,0
532,0,0,94,0,-94
533,1,1,281,1340,1059
534,0,0,55,0,-55
535,1,1,19,2060,2041
536,1,0,4,0,-4
537,1,0,52,0,-52
538,1,1,296,1414,1118
539,1,1,597,1658,1061
540,0,0,82,0,-82
541,1,0,22,0,-22
542,0,0,116,0,-116
543,0,0,63,0,-63
544,0,0,22,0,-22
545,1,1,576,1249,673
546,1,1,175,1347,1172
547,1,0,33,0,-33
548,1,0,10,0,-10
549,1,1,450,1682,1232
550,1,0,29,0,-29
551,1,0,45,0,-45
552,0,0,58,0,-58
553,0,0,54,0,-54
554,1,1,664,1523,859
555,1,0,59,0,-59
556,0,0,15,0,-15
557,1,1,455,1554,1099
558,1,1,533,1311,778
559,0,0,80,0,-80
560,1,0,276,0,-276
561,1,1,836,1203,367
562,0,0,29,0,-29
563,1,1,332,1328,996
564,1,1,415,1450,1035
565,0,0,22,0,-22
566,1,0,0,0,0
567,1,1,200,1247,1047
568,0,0,9,0,-9
569,1,0,11,0,-11
570,0,0,11,0,-11
571,0,0,11,0,-11
572,1,0,215,0,-215
573,1,0,34,0,-34
574,0,0,11,0,-11
575,1,0,53,0,-53
576,1,0,1,0,-1
577,0,0,76,0,-76
578,0,0,79,0,-79
579,1,0,1,0,-1
580,1,1,48,1221,1173
581,1,0,54,0,-54
582,0,0,73,0,-73
583,0,0,83,0,-83
584,0,0,33,0,-33
585,0,0,63,0,-63
586,1,1,1507,2190,683
587,1,1,679,1539,860
588,1,1,190,1314,1124
589,1,0,55,0,-55
590,1,1,1080,1629,549
591,0,0,58,0,-58
592,0,0,32,0,-32
593,0,0,25,0,-25
594,1,0,42,0,-42
595,0,0,88,0,-88
596,0,0,58,0,-58
597,1,0,3,0,-3
598,0,0,12,0,-12
599,0,0,15,0,-15
600,1,0,33,0,-33
601,0,0,105,0,-105
602,0,0,38,0,-38
603,1,0,39,0,-39
604,1,1,448,1346,898
605,0,0,49,0,-49
606,1,0,86,0,-86
607,1,0,51,0,-51
608,1,0,49,0,-49
609,1,1,32,1317,1285
610,0,0,155,0,-155
611,1,1,235,1368,1133
612,1,1,569,1204,635
613,1,0,17,0,-17
614,1,1,463,1360,897
615,1,0,28,0,-28
616,1,0,2,0,-2
617,1,1,1885,1653,-232
618,0,0,17,0,-17
619,1,0,27,0,-27
620,1,1,463,1828,1365
621,0,0,10,0,-10
622,1,0,14,0,-14
623,1,0,2,0,-2
624,0,0,33,0,-33
625,1,1,322,1201,879
626,1,1,108,1784,1676
627,0,0,60,0,-60
628,1,0,119,0,-119
629,1,0,51,0,-51
630,0,0,24,0,-24
631,1,1,245,1386,1141
632,0,0,35,0,-35
633,1,0,52,0,-52
634,0,0,64,0,-64
635,0,0,100,0,-100
636,0,0,10,0,-10
637,0,0,29,0,-29
638,0,0,7,0,-7
639,1,0,57,0,-57
640,0,0,59,0,-59
641,0,0,1,0,-1
642,1,0,5,0,-5
643,1,0,37,0,-37
644,1,0,70,0,-70
645,1,1,2173,1404,-769
646,0,0,49,0,-49
647,1,0,233,0,-233
648,1,1,212,1374,1162
649,0,0,5,0,-5
650,0,0,197,0,-197
651,1,0,118,0,-118
652,1,0,20,0,-20
653,1,0,65,0,-65
654,1,0,74,0,-74
655,1,1,206,1382,1176
656,1,1,49,1703,1654
657,0,0,3,0,-3
658,1,0,85,0,-85
659,1,0,3,0,-3
660,1,0,62,0,-62
661,1,1,965,1580,615
662,1,0,54,0,-54
663,1,1,267,1489,1222
664,1,0,103,0,-103
665,0,0,167,0,-167
666,1,1,66,1716,1650
667,0,0,9,0,-9
668,1,1,1532,1431,-101
669,1,0,0,0,0
670,1,1,138,1457,1319
671,1,0,10,0,-10
672,1,0,83,0,-83
673,1,0,80,0,-80
674,1,0,25,0,-25
675,1,1,331,1206,875
676,1,0,11,0,-11
677,1,0,34,0,-34
678,0,0,63,0,-63
679,0,0,27,0,-27
680,1,0,156,0,-156
681,1,1,152,1330,1178
682,0,0,110,0,-110
683,0,0,44,0,-44
684,1,0,27,0,-27
685,1,1,1202,1215,13
686,0,0,107,0,-107
687,0,0,10,0,-10
688,0,0,21,0,-21
689,1,0,10,0,-10
690,1,1,138,1445,1307
691,1,0,15,0,-15
692,0,0,81,0,-81
693,1,0,16,0,-16
694,0,0,31,0,-31
695,1,1,226,2085,1859
696,1,0,24,0,-24
697,1,0,0,0,0
698,1,0,19,0,-19
699,0,0,80,0,-80
700,0,0,0,0,0
701,1,0,87,0,-87
702,1,0,34,0,-34
703,1,1,311,1212,901
704,0,0,86,0,-86
705,0,0,155,0,-155
706,1,1,632,1453,821
707,0,0,1,0,-1
708,1,1,105,1425,1320
709,1,1,273,1652,1379
710,0,0,15,0,-15
711,1,0,12,0,-12
712,0,0,59,0,-59
713,1,1,588,2253,1665
714,0,0,21,0,-21
715,0,0,30,0,-30
716,1,0,19,0,-19
717,0,0,7,0,-7
718,1,1,941,1246,305
719,1,1,281,1301,1020
720,1,1,1038,1508,470
721,0,0,13,0,-13
722,1,0,121,0,-121
723,0,0,33,0,-33
724,0,0,2,0,-2
725,1,0,8,0,-8
726,1,0,68,0,-68
727,1,1,197,7083,6886
728,1,1,332,1262,930
729,1,1,124,1994,1870
730,0,0,3,0,-3
731,1,0,1,0,-1
732,1,0,12,0,-12
733,0,0,51,0,-51
734,0,0,0,0,0
735,1,1,932,1417,485
736,0,0,10,0,-10
737,0,0,86,0,-86
738,1,0,7,0,-7
739,1,0,2,0,-2
740,0,0,2,0,-2
741,1,0,5,0,-5
742,1,0,89,0,-89
743,1,0,90,0,-90
744,1,1,245,1345,1100
745,0,0,17,0,-17
746,1,0,25,0,-25
747,1,1,1417,1495,78
748,1,1,276,2695,2419
749,1,1,518,1282,764
750,0,0,7,0,-7
751,0,0,28,0,-28
752,1,1,584,1840,1256
753,1,0,13,0,-13
754,1,1,614,1251,637
755,1,1,250,2001,1751
756,0,0,165,0,-165
757,0,0,69,0,-69
758,1,1,847,1874,1027
759,1,0,10,0,-10
760,1,0,33,0,-33
761,1,1,262,1235,973
762,1,1,1669,1532,-137
763,1,1,377,1990,1613
764,1,0,40,0,-40
765,1,1,771,1923,1152
766,1,1,869,1361,492
767,1,0,4,0,-4
768,1,0,4,0,-4
769,1,1,669,1288,619
770,0,0,48,0,-48
771,0,0,64,0,-64
772,1,0,79,0,-79
773,1,0,15,0,-15
774,0,0,71,0,-71
775,0,0,25,0,-25
776,0,0,30,0,-30
777,0,0,69,0,-69
778,0,0,47,0,-47
779,0,0,27,0,-27
780,1,1,15,1621,1606
781,1,0,40,0,-40
782,1,0,28,0,-28
783,1,1,637,1377,740
784,0,0,0,0,0
785,1,0,6,0,-6
786,1,0,175,0,-175
787,0,0,34,0,-34
788,1,0,35,0,-35
789,1,0,9,0,-9
790,0,0,29,0,-29
791,0,0,37,0,-37
792,0,0,23,0,-23
793,0,0,72,0,-72
794,0,0,40,0,-40
795,1,1,528,1287,759
796,0,0,11,0,-11
797,1,0,65,0,-65
798,1,0,31,0,-31
799,0,0,39,0,-39
800,0,0,9,0,-9
801,0,0,20,0,-20
802,0,0,23,0,-23
803,1,0,13,0,-13
804,1,1,1434,1299,-135
805,0,0,38,0,-38
806,0,0,35,0,-35
807,1,1,1020,1288,268
808,1,0,44,0,-44
809,0,0,34,0,-34
810,1,0,7,0,-7
811,0,0,85,0,-85
812,0,0,39,0,-39
813,1,0,2,0,-2
814,1,0,10,0,-10
815,0,0,39,0,-39
816,1,1,733,1323,590
817,0,0,0,0,0
818,1,1,273,1275,1002
819,1,0,60,0,-60
820,1,1,47,1682,1635
821,0,0,75,0,-75
822,1,1,491,1207,716
823,0,0,38,0,-38
824,1,1,98,1344,1246
825,0,0,28,0,-28
826,1,1,2295,1219,-1076
827,1,0,71,0,-71
828,1,1,153,1715,1562
829,1,0,42,0,-42
830,0,0,41,0,-41
831,0,0,234,0,-234
832,0,0,30,0,-30
833,0,0,2,0,-2
834,1,1,766,1402,636
835,1,1,575,1453,878
836,1,0,6,0,-6
837,1,1,96,1532,1436
838,0,0,71,0,-71
839,0,0,84,0,-84
840,0,0,48,0,-48
841,1,1,289,1240,951
842,1,1,846,1304,458
843,1,0,73,0,-73
844,1,1,291,1728,1437
845,1,1,106,1387,1281
846,1,1,29,1533,1504
847,0,0,107,0,-107
848,1,0,71,0,-71
849,1,0,49,0,-49
850,0,0,9,0,-9
851,1,0,14,0,-14
852,0,0,22,0,-22
853,1,0,70,0,-70
854,1,0,4,0,-4
855,0,0,123,0,-123
856,1,1,325,1539,1214
857,0,0,5,0,-5
858,1,0,13,0,-13
859,1,1,130,1279,1149
860,0,0,53,0,-53
861,0,0,122,0,-122
862,1,1,347,1217,870
863,0,0,7,0,-7
864,1,1,620,1900,1280
865,0,0,0,0,0
866,0,0,6,0,-6
867,1,0,54,0,-54
868,0,0,13,0,-13
869,1,1,191,1266,1075
870,1,0,9,0,-9
871,0,0,14,0,-14
872,1,1,664,1556,892
873,1,0,10,0,-10
874,1,0,78,0,-78
875,1,0,0,0,0
876,1,0,32,0,-32
877,0,0,81,0,-81
878,1,0,31,0,-31
879,0,0,32,0,-32
880,0,0,24,0,-24
881,1,0,80,0,-80
882,1,0,17,0,-17
883,1,1,346,1375,1029
884,1,1,315,1961,1646
885,1,1,158,1250,1092
886,0,0,19,0,-19
887,1,1,282,1977,1695
888,0,0,18,0,-18
889,0,0,44,0,-44
890,1,1,109,1577,1468
891,1,0,52,0,-52
892,1,1,682,1779,1097
893,0,0,25,0,-25
894,0,0,29,0,-29
895,1,1,1250,1360,110
896,1,1,190,1320,1130
897,0,0,13,0,-13
898,1,1,617,1334,717
899,1,0,87,0,-87
900,0,0,0,0,0
901,0,0,122,0,-122
902,1,0,4,0,-4
903,1,1,161,1359,1198
904,1,1,121,1272,1151
905,1,0,7,0,-7
906,1,1,648,3086,2438
907,1,1,386,1263,877
908,1,0,15,0,-15
909,1,1,844,1656,812
910,1,1,182,1239,1057
911,1,1,443,1892,1449
912,0,0,6,0,-6
913,0,0,118,0,-118
914,1,0,67,0,-67
915,0,0,18,0,-18
916,1,1,56,1241,1185
917,0,0,59,0,-59
918,0,0,15,0,-15
919,1,0,75,0,-75
920,1,0,59,0,-59
921,1,1,122,1571,1449
922,1,0,28,0,-28
923,0,0,74,0,-74
924,0,0,5,0,-5
925,1,0,23,0,-23
926,0,0,11,0,-11
927,0,0,46,0,-46
928,1,1,1226,5552,4326
929,1,1,280,2751,2471
930,0,0,25,0,-25
931,0,0,2,0,-2
932,1,0,37,0,-37
933,1,1,177,1261,1084
934,1,0,6,0,-6
935,0,0,60,0,-60
936,0,0,90,0,-90
937,1,1,489,1808,1319
938,1,1,135,1412,1277
939,1,1,253,1369,1116
940,0,0,15,0,-15
941,0,0,9,0,-9
942,1,0,60,0,-60
943,0,0,37,0,-37
944,0,0,50,0,-50
945,0,0,27,0,-27
946,1,1,369,1428,1059
947,1,0,53,0,-53
948,0,0,46,0,-46
949,1,0,0,0,0
950,0,0,416,0,-416
951,1,0,8,0,-8
952,0,0,86,0,-86
953,0,0,57,0,-57
954,1,1,1209,1573,364
955,1,1,1101,1961,860
956,1,0,0,0,0
957,1,0,31,0,-31
958,1,0,180,0,-180
959,1,0,60,0,-60
960,0,0,0,0,0
961,1,1,116,1467,1351
962,0,0,1,0,-1
963,0,0,38,0,-38
964,0,0,39,0,-39
965,0,0,49,0,-49
966,1,1,246,1722,1476
967,0,0,14,0,-14
968,0,0,10,0,-10
969,0,0,90,0,-90
970,0,0,33,0,-33
971,1,0,7,0,-7
972,0,0,116,0,-116
973,1,1,624,1504,880
974,1,1,86,1914,1828
975,0,0,66,0,-66
976,1,1,183,1844,1661
977,1,0,36,0,-36
978,0,0,50,0,-50
979,0,0,218,0,-218
980,1,0,13,0,-13
981,1,1,265,1308,1043
982,0,0,7,0,-7
983,0,0,5,0,-5
984,0,0,16,0,-16
985,0,0,86,0,-86
986,1,0,53,0,-53
987,1,0,7,0,-7
988,1,1,23,1218,1195
989,0,0,126,0,-126
990,0,0,43,0,-43
991,1,0,51,0,-51
992,0,0,25,0,-25
993,0,0,48,0,-48
994,1,0,28,0,-28
995,1,0,47,0,-47
996,0,0,15,0,-15
997,0,0,75,0,-75
998,1,1,171,1245,1074
999,0,0,10,0,-10
1000,0,0,26,0,-26
1001,1,0,19,0,-19
1002,1,0,43,0,-43
1003,0,0,28,0,-28
1004,0,0,47,0,-47
1005,1,1,666,2432,1766
1006,0,0,1,0,-1
1007,1,0,114,0,-114
1008,0,0,140,0,-140
1009,1,0,19,0,-19
1010,0,0,33,0,-33
1011,1,0,23,0,-23
1012,0,0,84,0,-84
1013,1,0,36,0,-36
1014,1,0,58,0,-58
1015,1,0,15,0,-15
1016,1,1,230,1690,1460
1017,1,1,321,1404,1083
1018,0,0,10,0,-10
1019,1,1,772,1402,630
1020,0,0,24,0,-24
1021,1,1,408,1212,804
1022,0,0,40,0,-40
1023,1,1,109,2640,2531
1024,0,0,94,0,-94
1025,1,1,39,1287,1248
1026,1,0,17,0,-17
1027,0,0,79,0,-79
1028,0,0,42,0,-42
1029,1,0,40,0,-40
1030,1,0,23,0,-23
1031,1,0,35,0,-35
1032,0,0,44,0,-44
1033,0,0,114,0,-114
1034,1,0,33,0,-33
1035,0,0,102,0,-102
1036,1,0,111,0,-111
1037,1,0,64,0,-64
1038,1,1,339,1292,953
1039,0,0,172,0,-172
1040,1,0,3,0,-3
1041,1,1,72,2098,2026
1042,0,0,1,0,-1
1043,0,0,6,0,-6
1044,0,0,22,0,-22
1045,1,1,261,1227,966
1046,0,0,25,0,-25
1047,1,1,358,1602,1244
1048,1,1,162,1297,1135
1049,1,1,370,1493,1123
1050,1,0,11,0,-11
1051,0,0,87,0,-87
1052,1,0,19,0,-19
1053,0,0,41,0,-41
1054,0,0,9,0,-9
1055,1,1,62,1300,1238
1056,1,0,99,0,-99
1057,1,1,632,1404,772
1058,1,0,103,0,-103
1059,1,0,3,0,-3
1060,1,0,74,0,-74
1061,1,1,137,1523,1386
1062,1,0,3,0,-3
1063,0,0,123,0,-123
1064,1,1,173,1837,1664
1065,1,0,13,0,-13
1066,1,1,14,1237,1223
1067,1,1,472,1214,742
1068,0,0,73,0,-73
1069,1,1,1091,1257,166
1070,0,0,4,0,-4
1071,1,0,19,0,-19
1072,0,0,11,0,-11
1073,1,0,189,0,-189
1074,1,0,33,0,-33
1075,0,0,17,0,-17
1076,1,1,78,1231,1153
1077,1,0,2,0,-2
1078,1,0,32,0,-32
1079,1,1,586,2900,2314
1080,1,1,214,1340,1126
1081,1,0,198,0,-198
1082,1,0,21,0,-21
1083,1,1,406,1262,856
1084,1,0,4,0,-4
1085,1,0,5,0,-5
1086,1,0,94,0,-94
1087,1,0,11,0,-11
1088,1,0,4,0,-4
1089,0,0,73,0,-73
1090,1,1,136,1310,1174
1091,0,0,19,0,-19
1092,1,1,897,1917,1020
1093,1,1,453,1233,780
1094,1,1,93,1428,1335
1095,1,0,42,0,-42
1096,1,0,33,0,-33
1097,0,0,25,0,-25
1098,1,0,120,0,-120
1099,1,0,105,0,-105
1100,0,0,192,0,-192
1101,0,0,64,0,-64
1102,1,0,50,0,-50
1103,1,0,51,0,-51
1104,1,1,819,1569,750
1105,1,0,11,0,-11
1106,0,0,34,0,-34
1107,1,0,28,0,-28
1108,1,1,86,2430,2344
1109,0,0,23,0,-23
1110,0,0,31,0,-31
1111,0,0,11,0,-11
1112,1,0,97,0,-97
1113,1,0,14,0,-14
1114,1,1,654,1453,799
1115,1,0,94,0,-94
1116,1,1,47,1808,1761
1117,1,1,690,1429,739
1118,0,0,54,0,-54
1119,0,0,18,0,-18
1120,1,1,800,1380,580
1121,1,0,16,0,-16
1122,1,1,136,1262,1126
1123,0,0,13,0,-13
1124,1,0,8,0,-8
1125,0,0,200,0,-200
1126,1,0,4,0,-4
1127,0,0,87,0,-87
1128,1,0,42,0,-42
1129,1,1,1033,1285,252
1130,1,1,697,1274,577
1131,1,0,44,0,-44
1132,0,0,52,0,-52
1133,1,0,14,0,-14
1134,1,0,15,0,-15
1135,1,1,850,1476,626
1136,0,0,118,0,-118
1137,1,1,524,1509,985
1138,0,0,18,0,-18
1139,0,0,12,0,-12
1140,0,0,2,0,-2
1141,1,0,0,0,0
1142,0,0,0,0,0
1143,1,1,83,1929,1846
1144,1,1,540,2564,2024
1145,0,0,14,0,-14
1146,1,0,128,0,-128
1147,1,0,86,0,-86
1148,1,0,37,0,-37
1149,1,0,24,0,-24
1150,1,0,121,0,-121
1151,0,0,113,0,-113
1152,0,0,165,0,-165
1153,0,0,38,0,-38
1154,0,0,52,0,-52
1155,0,0,103,0,-103
1156,1,1,1530,1868,338
1157,0,0,45,0,-45
1158,0,0,21,0,-21
1159,1,1,207,1554,1347
1160,1,1,821,3915,3094
1161,0,0,34,0,-34
1162,1,0,16,0,-16
1163,0,0,40,0,-40
1164,0,0,18,0,-18
1165,0,0,26,0,-26
1166,0,0,37,0,-37
1167,1,0,19,0,-19
1168,1,1,664,1232,568
1169,0,0,40,0,-40
1170,1,1,250,1329,1079
1171,1,0,3,0,-3
1172,1,1,373,1290,917
1173,0,0,132,0,-132
1174,1,0,13,0,-13
1175,1,0,12,0,-12
1176,1,1,423,1485,1062
1177,1,1,139,1650,1511
1178,1,0,0,0,0
1179,1,0,60,0,-60
1180,0,0,23,0,-23
1181,0,0,63,0,-63
1182,0,0,69,0,-69
1183,1,1,77,1332,1255
1184,0,0,48,0,-48
1185,0,0,32,0,-32
1186,1,1,451,1252,801
1187,1,0,8,0,-8
1188,0,0,10,0,-10
1189,0,0,7,0,-7
1190,1,1,525,2530,2005
1191,1,0,40,0,-40
1192,0,0,197,0,-197
1193,1,0,14,0,-14
1194,1,1,423,1831,1408
1195,0,0,77,0,-77
1196,1,1,132,1421,1289
1197,0,0,0,0,0
1198,1,1,1343,1246,-97
1199,1,1,212,1484,1272
1200,0,0,31,0,-31
1201,0,0,7,0,-7
1202,0,0,77,0,-77
1203,0,0,42,0,-42
1204,1,0,1,0,-1
1205,1,1,374,1660,1286
1206,1,1,250,2686,2436
1207,0,0,220,0,-220
1208,1,0,37,0,-37
1209,0,0,166,0,-166
1210,1,1,126,1433,1307
1211,1,1,833,1803,970
1212,1,0,45,0,-45
1213,1,1,825,2508,1683
1214,1,0,10,0,-10
1215,0,0,41,0,-41
1216,0,0,32,0,-32
1217,1,0,15,0,-15
1218,0,0,59,0,-59
1219,0,0,61,0,-61
1220,1,1,597,1511,914
1221,0,0,9,0,-9
1222,1,0,44,0,-44
1223,0,0,21,0,-21
1224,1,1,742,1320,578
1225,1,1,320,1299,979
1226,0,0,73,0,-73
1227,0,0,61,0,-61
1228,1,0,48,0,-48
1229,1,1,98,3471,3373
1230,1,0,21,0,-21
1231,0,0,81,0,-81
1232,0,0,8,0,-8
1233,1,0,275,0,-275
1234,1,0,64,0,-64
1235,0,0,104,0,-104
1236,1,1,1773,1292,-481
1237,0,0,14,0,-14
1238,1,0,28,0,-28
1239,1,1,1236,3533,2297
1240,1,1,298,1470,1172
1241,1,1,270,1841,1571
1242,0,0,8,0,-8
1243,0,0,119,0,-119
1244,1,1,667,1333,666
1245,0,0,41,0,-41
1246,1,0,28,0,-28
1247,1,1,955,1278,323
1248,1,0,72,0,-72
1249,0,0,57,0,-57
1250,1,0,65,0,-65
1251,0,0,0,0,0
1252,1,0,79,0,-79
1253,0,0,21,0,-21
1254,1,1,245,3243,2998
1255,0,0,4,0,-4
1256,1,0,176,0,-176
1257,0,0,8,0,-8
1258,1,1,570,1272,702
1259,1,1,33,1321,1288
1260,0,0,16,0,-16
1261,1,1,210,2112,1902
1262,1,1,822,1578,756
1263,1,0,12,0,-12
1264,1,1,40,1511,1471
1265,1,1,1371,1291,-80
1266,0,0,36,0,-36
1267,0,0,2,0,-2
1268,1,0,69,0,-69
1269,1,0,50,0,-50
1270,0,0,1,0,-1
1271,0,0,5,0,-5
1272,1,0,29,0,-29
1273,1,1,212,1653,1441
1274,1,0,19,0,-19
1275,1,1,1180,1218,38
1276,1,1,417,1210,793
1277,0,0,121,0,-121
1278,0,0,115,0,-115
1279,1,1,467,1248,781
1280,0,0,117,0,-117
1281,0,0,98,0,-98
1282,0,0,22,0,-22
1283,1,0,5,0,-5
1284,1,0,18,0,-18
1285,0,0,29,0,-29
1286,1,1,61,1641,1580
1287,0,0,4,0,-4
1288,1,1,1696,1299,-397
1289,0,0,310,0,-310
1290,1,0,5,0,-5
1291,1,1,464,1853,1389
1292,1,0,34,0,-34
1293,1,1,331,1247,916
1294,1,1,264,1426,1162
1295,1,1,885,4287,3402
1296,1,0,46,0,-46
1297,1,0,26,0,-26
1298,1,1,98,1341,1243
1299,1,0,25,0,-25
1300,1,1,1699,1378,-321
1301,1,1,252,1431,1179
1302,0,0,76,0,-76
1303,1,1,763,1223,460
1304,0,0,30,0,-30
1305,1,0,87,0,-87
1306,0,0,89,0,-89
1307,1,0,26,0,-26
1308,1,0,13,0,-13
1309,0,0,191,0,-191
1310,1,1,14,1221,1207
1311,0,0,19,0,-19
1312,1,1,308,1287,979
1313,0,0,30,0,-30
1314,1,0,7,0,-7
1315,0,0,32,0,-32
1316,1,1,1806,1231,-575
1317,0,0,157,0,-157
1318,1,0,117,0,-117
1319,1,1,533,1540,1007
1320,1,0,45,0,-45
1321,1,1,1223,1276,53
1322,0,0,12,0,-12
1323,1,1,104,1842,1738
1324,1,1,348,1200,852
1325,0,0,0,0,0
1326,0,0,65,0,-65
1327,0,0,264,0,-264
1328,0,0,76,0,-76
1329,1,1,1422,1324,-98
1330,0,0,35,0,-35
1331,1,1,369,1312,943
1332,1,0,56,0,-56
1333,1,1,376,1431,1055
1334,0,0,29,0,-29
1335,1,0,46,0,-46
1336,1,1,809,1326,517
1337,0,0,123,0,-123
1338,1,1,632,3213,2581
1339,1,1,259,2526,2267
1340,0,0,34,0,-34
1341,0,0,33,0,-33
1342,1,0,15,0,-15
1343,0,0,15,0,-15
1344,1,1,131,1385,1254
1345,0,0,15,0,-15
1346,1,1,1638,1305,-333
1347,0,0,44,0,-44
1348,0,0,39,0,-39
1349,0,0,39,0,-39
1350,1,0,15,0,-15
1351,0,0,35,0,-35
1352,1,1,661,1301,640
1353,1,0,26,0,-26
1354,1,1,64,1311,1247
1355,1,0,25,0,-25
1356,0,0,45,0,-45
1357,1,0,81,0,-81
1358,1,1,285,1210,925
1359,0,0,22,0,-22
1360,0,0,30,0,-30
1361,1,0,52,0,-52
1362,0,0,99,0,-99
1363,0,0,109,0,-109
1364,0,0,77,0,-77
1365,1,1,18,1339,1321
1366,1,0,51,0,-51
1367,1,1,1207,1267,60
1368,1,0,86,0,-86
1369,1,0,13,0,-13
1370,1,1,579,1239,660
1371,1,1,140,1358,1218
1372,0,0,37,0,-37
1373,1,1,294,1685,1391
1374,1,1,1122,1493,371
1375,0,0,7,0,-7
1376,1,0,20,0,-20
1377,0,0,25,0,-25
1378,1,1,1339,1664,325
1379,0,0,19,0,-19
1380,1,1,619,1566,947
1381,1,0,3,0,-3
1382,1,1,311,1215,904
1383,1,0,37,0,-37
1384,1,0,0,0,0
1385,1,0,26,0,-26
1386,0,0,131,0,-131
1387,0,0,83,0,-83
1388,1,1,285,1822,1537
1389,1,0,32,0,-32
1390,1,0,81,0,-81
1391,1,1,580,1330,750
1392,0,0,147,0,-147
1393,1,1,1494,1429,-65
1394,0,0,98,0,-98
1395,1,1,1165,1351,186
1396,0,0,70,0,-70
1397,1,1,51,1356,1305
1398,1,0,53,0,-53
1399,1,1,163,2434,2271
1400,1,0,40,0,-40
1401,1,0,73,0,-73
1402,1,0,71,0,-71
1403,1,0,36,0,-36
1404,0,0,4,0,-4
1405,0,0,41,0,-41
1406,0,0,14,0,-14
1407,0,0,53,0,-53
1408,1,1,142,1605,1463
1409,1,1,99,3228,3129
1410,1,1,1371,1237,-134
1411,0,0,46,0,-46
1412,0,0,122,0,-122
1413,1,0,39,0,-39
1414,1,0,16,0,-16
1415,1,0,57,0,-57
1416,1,0,225,0,-225
1417,1,1,399,1259,860
1418,1,1,996,1305,309
1419,1,1,697,1306,609
1420,1,1,94,1446,1352
1421,1,1,587,1462,875
1422,0,0,51,0,-51
1423,0,0,14,0,-14
1424,1,0,31,0,-31
1425,0,0,31,0,-31
1426,1,0,18,0,-18
1427,1,1,834,1620,786
1428,1,1,270,1467,1197
1429,1,0,84,0,-84
1430,1,1,93,1214,1121
1431,0,0,0,0,0
1432,0,0,22,0,-22
1433,0,0,86,0,-86
1434,1,0,26,0,-26
1435,1,0,11,0,-11
1436,1,1,235,2628,2393
1437,1,1,374,1573,1199
1438,1,1,210,3059,2849
1439,0,0,66,0,-66
1440,0,0,46,0,-46
1441,1,1,550,2272,1722
1442,1,1,252,1345,1093
1443,0,0,14,0,-14
1444,1,1,575,1243,668
1445,1,1,286,6924,6638
1446,1,0,10,0,-10
1447,1,0,41,0,-41
1448,0,0,88,0,-88
1449,1,0,52,0,-52
1450,0,0,8,0,-8
1451,1,1,496,1382,886
1452,0,0,135,0,-135
1453,0,0,74,0,-74
1454,1,1,431,1237,806
1455,1,1,1674,2182,508
1456,0,0,28,0,-28
1457,0,0,2,0,-2
1458,0,0,105,0,-105
1459,1,1,705,1519,814
1460,0,0,61,0,-61
1461,1,0,15,0,-15
1462,1,1,914,1201,287
1463,1,0,25,0,-25
1464,1,0,49,0,-49
1465,0,0,53,0,-53
1466,1,0,95,0,-95
1467,1,1,1496,1811,315
1468,1,0,7,0,-7
1469,1,0,20,0,-20
1470,1,0,18,0,-18
1471,0,0,18,0,-18
1472,0,0,125,0,-125
1473,1,1,521,2241,1720
1474,1,0,6,0,-6
1475,1,1,487,1862,1375
1476,1,1,423,1909,1486
1477,1,0,10,0,-10
1478,1,0,22,0,-22
1479,1,1,262,1318,1056
1480,1,0,23,0,-23
1481,0,0,48,0,-48
1482,1,0,32,0,-32
1483,1,0,5,0,-5
1484,1,0,41,0,-41
1485,1,0,35,0,-35
1486,0,0,60,0,-60
1487,0,0,49,0,-49
1488,0,0,79,0,-79
1489,0,0,23,0,-23
1490,0,0,79,0,-79
1491,1,0,63,0,-63
1492,0,0,201,0,-201
1493,1,0,48,0,-48
1494,1,1,128,1364,1236
1495,1,0,27,0,-27
1496,0,0,15,0,-15
1497,1,0,30,0,-30
1498,1,0,14,0,-14
1499,0,0,57,0,-57
1500,1,0,21,0,-21
1501,1,0,3,0,-3
1502,0,0,0,0,0
1503,0,0,16,0,-16
1504,0,0,31,0,-31
1505,1,0,41,0,-41
1506,1,1,149,1389,1240
1507,0,0,37,0,-37
1508,0,0,37,0,-37
1509,1,1,238,1730,1492
1510,1,0,60,0,-60
1511,0,0,65,0,-65
1512,0,0,120,0,-120
1513,1,0,33,0,-33
1514,1,1,775,1517,742
1515,1,0,2,0,-2
1516,0,0,53,0,-53
1517,1,1,227,1973,1746
1518,1,1,316,1825,1509
1519,1,1,273,2304,2031
1520,1,0,3,0,-3
1521,1,0,26,0,-26
1522,1,1,36,1288,1252
1523,1,1,375,2271,1896
1524,1,0,21,0,-21
1525,1,0,83,0,-83
1526,0,0,63,0,-63
1527,1,0,92,0,-92
1528,1,0,63,0,-63
1529,0,0,91,0,-91
1530,1,1,13,1448,1435
1531,1,0,28,0,-28
1532,0,0,3,0,-3
1533,1,0,28,0,-28
1534,1,1,87,1486,1399
1535,1,1,390,2353,1963
1536,1,0,41,0,-41
1537,0,0,15,0,-15
1538,1,1,717,1286,569
1539,1,1,538,1355,817
1540,1,0,23,0,-23
1541,1,0,352,0,-352
1542,1,1,53,1535,1482
1543,1,0,9,0,-9
1544,1,1,90,1802,1712
1545,1,1,1082,1244,162
1546,0,0,19,0,-19
1547,0,0,165,0,-165
1548,0,0,39,0,-39
1549,1,0,15,0,-15
1550,1,1,456,1214,758
1551,0,0,11,0,-11
1552,0,0,152,0,-152
1553,0,0,103,0,-103
1554,1,1,56,1302,1246
1555,1,0,6,0,-6
1556,1,1,139,1825,1686
1557,1,1,371,1598,1227
1558,0,0,102,0,-102
1559,1,1,173,1295,1122
1560,1,1,282,1209,927
1561,1,1,155,1588,1433
1562,1,0,88,0,-88
1563,0,0,6,0,-6
1564,0,0,22,0,-22
1565,1,1,244,1252,1008
1566,1,1,210,1792,1582
1567,0,0,10,0,-10
1568,1,1,313,1245,932
1569,1,0,70,0,-70
1570,0,0,41,0,-41
1571,0,0,17,0,-17
1572,1,0,72,0,-72
1573,0,0,5,0,-5
1574,0,0,16,0,-16
1575,1,0,12,0,-12
1576,1,1,215,1582,1367
1577,0,0,45,0,-45
1578,1,1,223,1454,1231
1579,0,0,79,0,-79
1580,1,1,2343,1380,-963
1581,0,0,6,0,-6
1582,0,0,40,0,-40
1583,1,0,17,0,-17
1584,1,0,16,0,-16
1585,1,1,718,1772,1054
1586,1,1,967,1992,1025
1587,1,0,24,0,-24
1588,0,0,4,0,-4
1589,0,0,30,0,-30
1590,1,1,767,1304,537
1591,1,0,53,0,-53
1592,1,1,431,2190,1759
1593,1,0,39,0,-39
1594,0,0,16,0,-16
1595,0,0,13,0,-13
1596,1,1,836,1393,557
1597,0,0,122,0,-122
1598,1,1,622,1391,769
1599,1,0,103,0,-103
1600,1,0,70,0,-70
1601,1,1,411,1674,1263
1602,0,0,193,0,-193
1603,0,0,0,0,0
1604,1,0,57,0,-57
1605,1,1,519,1647,1128
1606,1,0,4,0,-4
1607,1,1,890,1481,591
1608,0,0,6,0,-6
1609,1,0,30,0,-30
1610,0,0,0,0,0
1611,0,0,23,0,-23
1612,1,1,238,1320,1082
1613,0,0,37,0,-37
1614,1,0,28,0,-28
1615,0,0,51,0,-51
1616,0,0,7,0,-7
1617,1,0,68,0,-68
1618,1,0,1,0,-1
1619,1,0,24,0,-24
1620,1,0,48,0,-48
1621,1,1,108,1433,1325
1622,1,1,600,2400,1800
1623,1,0,24,0,-24
1624,0,0,149,0,-149
1625,1,1,1587,1305,-282
1626,1,0,60,0,-60
1627,1,1,311,1409,1098
1628,1,1,1556,1575,19
1629,1,1,666,1824,1158
1630,1,0,81,0,-81
1631,0,0,20,0,-20
1632,1,0,211,0,-211
1633,0,0,66,0,-66
1634,1,1,531,1365,834
1635,1,1,699,1502,803
1636,1,0,22,0,-22
1637,1,1,131,1238,1107
1638,1,1,815,1563,748
1639,1,1,169,1581,1412
1640,1,1,1025,1303,278
1641,1,1,207,1297,1090
1642,0,0,37,0,-37
1643,0,0,35,0,-35
1644,1,0,21,0,-21
1645,0,0,23,0,-23
1646,0,0,98,0,-98
1647,1,1,43,1912,1869
1648,1,1,214,2947,2733
1649,1,1,478,1579,1101
1650,0,0,2,0,-2
1651,1,0,35,0,-35
1652,1,0,20,0,-20
1653,1,1,46,1206,1160
1654,0,0,1,0,-1
1655,0,0,22,0,-22
1656,1,0,52,0,-52
1657,1,0,92,0,-92
1658,1,1,384,1465,1081
1659,1,0,19,0,-19
1660,1,1,287,1963,1676
1661,0,0,61,0,-61
1662,1,1,648,2592,1944
1663,1,0,10,0,-10
1664,0,0,31,0,-31
1665,0,0,1,0,-1
1666,0,0,0,0,0
1667,1,1,1888,1298,-590
1668,0,0,29,0,-29
1669,1,1,578,1244,666
1670,0,0,2,0,-2
1671,0,0,8,0,-8
1672,1,0,10,0,-10
1673,1,0,79,0,-79
1674,0,0,9,0,-9
1675,1,1,279,1895,1616
1676,1,0,0,0,0
1677,0,0,152,0,-152
1678,1,1,202,2688,2486
1679,0,0,7,0,-7
1680,1,0,20,0,-20
1681,1,1,257,1442,1185
1682,1,1,826,1202,376
1683,1,0,116,0,-116
1684,1,0,11,0,-11
1685,1,0,98,0,-98
1686,1,1,440,1458,1018
1687,1,1,507,1228,721
1688,1,0,32,0,-32
1689,0,0,6,0,-6
1690,0,0,37,0,-37
1691,0,0,13,0,-13
1692,1,1,1775,1318,-457
1693,0,0,46,0,-46
1694,1,1,856,1535,679
1695,1,0,93,0,-93
1696,1,1,51,1224,1173
1697,0,0,31,0,-31
1698,1,0,7,0,-7
1699,1,1,311,1278,967
1700,0,0,51,0,-51
1701,1,1,1080,1423,343
1702,1,0,26,0,-26
1703,1,0,7,0,-7
1704,1,1,418,2671,2253
1705,0,0,10,0,-10
1706,1,0,62,0,-62
1707,0,0,176,0,-176
1708,1,0,50,0,-50
1709,0,0,49,0,-49
1710,1,1,593,2182,1589
1711,1,1,516,1438,922
1712,0,0,25,0,-25
1713,1,0,43,0,-43
1714,1,0,7,0,-7
1715,0,0,16,0,-16
1716,1,1,140,2229,2089
1717,1,0,7,0,-7
1718,1,0,11,0,-11
1719,1,0,26,0,-26
1720,0,0,88,0,-88
1721,1,0,26,0,-26
1722,1,1,694,1254,560
1723,1,0,15,0,-15
1724,0,0,70,0,-70
1725,1,1,329,1409,1080
1726,1,0,76,0,-76
1727,1,1,170,1226,1056
1728,0,0,0,0,0
1729,0,0,100,0,-100
1730,1,0,59,0,-59
1731,0,0,0,0,0
1732,0,0,259,0,-259
1733,0,0,6,0,-6
1734,0,0,92,0,-92
1735,0,0,76,0,-76
1736,1,0,50,0,-50
1737,1,1,51,1262,1211
1738,0,0,251,0,-251
1739,1,1,22,1978,1956
1740,1,1,535,1349,814
1741,1,0,3,0,-3
1742,1,0,112,0,-112
1743,0,0,25,0,-25
1744,1,1,168,1312,1144
1745,1,1,182,1511,1329
1746,1,1,892,1939,1047
1747,1,0,52,0,-52
1748,0,0,5,0,-5
1749,1,0,46,0,-46
1750,0,0,48,0,-48
1751,0,0,59,0,-59
1752,1,1,375,1735,1360
1753,0,0,15,0,-15
1754,1,1,246,1367,1121
1755,1,1,1755,1839,84
1756,1,0,0,0,0
1757,0,0,29,0,-29
1758,0,0,2,0,-2
1759,0,0,74,0,-74
1760,1,1,365,2206,1841
1761,1,1,618,1413,795
1762,1,0,47,0,-47
1763,1,1,322,1472,1150
1764,1,1,256,1487,1231
1765,1,1,177,1488,1311
1766,0,0,17,0,-17
1767,0,0,64,0,-64
1768,0,0,1,0,-1
1769,0,0,11,0,-11
1770,0,0,80,0,-80
1771,1,1,239,1473,1234
1772,1,1,705,1237,532
1773,1,1,1244,1259,15
1774,0,0,47,0,-47
1775,1,0,9,0,-9
1776,1,0,7,0,-7
1777,1,1,149,2195,2046
1778,1,1,284,1408,1124
1779,1,0,24,0,-24
1780,1,0,48,0,-48
1781,0,0,129,0,-129
1782,1,1,452,1240,788
1783,0,0,138,0,-138
1784,1,1,2905,1720,-1185
1785,1,1,844,2663,1819
1786,1,0,27,0,-27
1787,1,0,61,0,-61
1788,1,1,667,1620,953
1789,1,0,25,0,-25
1790,0,0,14,0,-14
1791,1,1,879,1940,1061
1792,0,0,27,0,-27
1793,1,1,610,1466,856
1794,0,0,18,0,-18
1795,1,0,22,0,-22
1796,1,1,223,1462,1239
1797,0,0,3,0,-3
1798,1,0,3,0,-3
1799,1,0,96,0,-96
1800,0,0,82,0,-82
1801,0,0,125,0,-125
1802,1,1,163,1626,1463
1803,1,0,15,0,-15
1804,0,0,45,0,-45
1805,0,0,11,0,-11
1806,1,1,534,1203,669
1807,0,0,16,0,-16
1808,1,1,826,1539,713
1809,1,1,1181,1999,818
1810,0,0,32,0,-32
1811,1,0,56,0,-56
1812,0,0,35,0,-35
1813,1,1,1658,1338,-320
1814,0,0,218,0,-218
1815,0,0,56,0,-56
1816,0,0,22,0,-22
1817,1,1,1793,1302,-491
1818,1,1,676,1681,1005
1819,1,0,11,0,-11
1820,1,0,32,0,-32
1821,1,0,108,0,-108
1822,1,1,379,1670,1291
1823,1,1,417,1221,804
1824,1,1,671,1350,679
1825,0,0,19,0,-19
1826,1,0,1,0,-1
1827,1,0,45,0,-45
1828,1,0,44,0,-44
1829,0,0,26,0,-26
1830,1,0,69,0,-69
1831,1,0,36,0,-36
1832,0,0,6,0,-6
1833,1,1,1665,1796,131
1834,1,1,346,1266,920
1835,1,1,1059,1409,350
1836,1,1,26,1480,1454
1837,0,0,18,0,-18
1838,1,1,231,2105,1874
1839,1,1,225,1885,1660
1840,1,1,247,1223,976
1841,0,0,4,0,-4
1842,1,1,212,1451,1239
1843,1,0,349,0,-349
1844,0,0,4,0,-4
1845,1,0,92,0,-92
1846,1,0,10,0,-10
1847,0,0,34,0,-34
1848,0,0,13,0,-13
1849,0,0,15,0,-15
1850,1,1,1082,2177,1095
1851,0,0,45,0,-45
1852,1,1,614,1403,789
1853,1,1,1346,1204,-142
1854,0,0,16,0,-16
1855,1,1,126,2851,2725
1856,0,0,117,0,-117
1857,1,0,11,0,-11
1858,0,0,1,0,-1
1859,1,1,2463,1503,-960
1860,1,0,12,0,-12
1861,1,0,6,0,-6
1862,1,1,1044,1260,216
1863,0,0,28,0,-28
1864,0,0,118,0,-118
1865,1,0,26,0,-26
1866,1,1,1077,4655,3578
1867,1,0,16,0,-16
1868,1,0,17,0,-17
1869,1,0,31,0,-31
1870,1,0,32,0,-32
1871,1,0,30,0,-30
1872,1,1,33,1244,1211
1873,1,1,406,1415,1009
1874,1,0,29,0,-29
1875,1,1,919,1403,484
1876,0,0,6,0,-6
1877,1,1,422,1204,782
1878,0,0,1,0,-1
1879,1,0,22,0,-22
1880,0,0,40,0,-40
1881,0,0,6,0,-6
1882,0,0,8,0,-8
1883,1,1,553,1460,907
1884,1,0,37,0,-37
1885,1,1,393,1881,1488
1886,0,0,37,0,-37
1887,1,0,70,0,-70
1888,1,0,67,0,-67
1889,1,0,82,0,-82
1890,0,0,45,0,-45
1891,1,0,4,0,-4
1892,1,1,520,1453,933
1893,0,0,1,0,-1
1894,1,0,15,0,-15
1895,1,0,77,0,-77
1896,1,1,558,1338,780
1897,1,1,95,1347,1252
1898,1,1,701,1988,1287
1899,1,0,6,0,-6
1900,0,0,57,0,-57
1901,0,0,71,0,-71
1902,0,0,78,0,-78
1903,1,1,557,1219,662
1904,0,0,128,0,-128
1905,0,0,78,0,-78
1906,0,0,40,0,-40
1907,0,0,26,0,-26
1908,1,0,25,0,-25
1909,0,0,60,0,-60
1910,1,1,236,3238,3002
1911,0,0,11,0,-11
1912,1,1,1024,1622,598
1913,1,1,891,1612,721
1914,1,0,54,0,-54
1915,0,0,51,0,-51
1916,1,0,168,0,-168
1917,1,0,1,0,-1
1918,0,0,21,0,-21
1919,0,0,18,0,-18
1920,1,1,57,1754,1697
1921,0,0,62,0,-62
1922,0,0,27,0,-27
1923,1,1,330,1268,938
1924,0,0,111,0,-111
1925,1,0,0,0,0
1926,1,0,83,0,-83
1927,1,0,10,0,-10
1928,1,1,222,3179,2957
1929,1,0,74,0,-74
1930,0,0,66,0,-66
1931,1,1,111,1464,1353
1932,0,0,3,0,-3
1933,0,0,50,0,-50
1934,1,1,936,1797,861
1935,1,0,210,0,-210
1936,1,1,690,1587,897
1937,1,1,716,1320,604
1938,1,1,857,1248,391
1939,1,0,29,0,-29
1940,1,0,25,0,-25
1941,0,0,58,0,-58
1942,1,0,109,0,-109
1943,1,0,31,0,-31
1944,1,0,45,0,-45
1945,0,0,45,0,-45
1946,1,1,1036,2148,1112
1947,1,1,182,1393,1211
1948,1,1,247,1760,1513
1949,0,0,56,0,-56
1950,1,1,459,1201,742
1951,0,0,29,0,-29
1952,1,1,158,1339,1181
1953,1,1,635,1634,999
1954,1,0,10,0,-10
1955,1,0,283,0,-283
1956,1,1,385,2228,1843
1957,1,1,499,1392,893
1958,1,0,93,0,-93
1959,0,0,34,0,-34
1960,1,0,11,0,-11
1961,0,0,79,0,-79
1962,0,0,24,0,-24
1963,1,1,373,1530,1157
1964,0,0,156,0,-156
1965,0,0,22,0,-22
1966,1,1,157,1707,1550
1967,0,0,54,0,-54
1968,0,0,33,0,-33
1969,1,1,148,1354,1206
1970,1,0,20,0,-20
1971,0,0,30,0,-30
1972,1,1,1120,2668,1548
1973,1,0,5,0,-5
1974,0,0,113,0,-113
1975,0,0,5,0,-5
1976,1,0,126,0,-126
1977,0,0,27,0,-27
1978,1,1,1201,1663,462
1979,1,1,1182,1335,153
1980,0,0,26,0,-26
1981,1,1,341,1431,1090
1982,1,1,699,1459,760
1983,0,0,36,0,-36
1984,0,0,6,0,-6
1985,1,1,434,3463,3029
1986,1,0,108,0,-108
1987,1,0,70,0,-70
1988,1,0,24,0,-24
1989,1,1,430,1275,845
1990,1,0,51,0,-51
1991,1,0,27,0,-27
1992,1,1,117,1468,1351
1993,0,0,16,0,-16
1994,1,0,51,0,-51
1995,1,1,106,1294,1188
1996,1,0,123,0,-123
1997,0,0,54,0,-54
1998,0,0,19,0,-19
1999,0,0,21,0,-21
2000,1,0,4,0,-4
2001,0,0,0,0,0
2002,1,1,238,1326,1088
2003,1,0,89,0,-89
2004,1,1,30,1244,1214
2005,1,1,226,1222,996
2006,0,0,23,0,-23
2007,1,1,509,1662,1153
2008,1,1,94,2252,2158
2009,1,0,56,0,-56
2010,1,1,440,2307,1867
2011,0,0,112,0,-112
2012,1,1,430,1304,874
2013,1,1,293,1710,1417
2014,1,1,28,1311,1283
2015,1,0,84,0,-84
2016,1,0,43,0,-43
2017,1,0,24,0,-24
2018,1,1,138,1538,1400
2019,1,1,23,1209,1186
2020,1,0,9,0,-9
2021,1,0,0,0,0
2022,0,0,17,0,-17
2023,1,1,45,1628,1583
2024,1,0,37,0,-37
2025,0,0,28,0,-28
2026,0,0,46,0,-46
2027,0,0,39,0,-39
2028,1,0,40,0,-40
2029,1,0,88,0,-88
2030,0,0,10,0,-10
2031,0,0,116,0,-116
2032,0,0,104,0,-104
2033,1,0,262,0,-262
2034,0,0,2,0,-2
2035,1,0,22,0,-22
2036,0,0,27,0,-27
2037,1,0,4,0,-4
2038,1,0,17,0,-17
2039,0,0,24,0,-24
2040,1,1,92,1514,1422
2041,1,1,317,4124,3807
2042,1,1,678,1678,1000
2043,1,0,33,0,-33
2044,0,0,176,0,-176
2045,1,1,1018,1426,408
2046,0,0,247,0,-247
2047,1,1,670,1405,735
2048,0,0,191,0,-191
2049,1,1,192,1399,1207
2050,0,0,20,0,-20
2051,1,1,218,1467,1249
2052,0,0,92,0,-92
2053,1,1,348,1293,945
2054,1,1,671,1466,795
2055,0,0,44,0,-44
2056,1,1,284,1221,937
2057,1,0,50,0,-50
2058,0,0,85,0,-85
2059,0,0,35,0,-35
2060,0,0,23,0,-23
2061,1,0,208,0,-208
2062,1,0,44,0,-44
2063,0,0,86,0,-86
2064,1,1,290,1472,1182
2065,0,0,18,0,-18
2066,0,0,22,0,-22
2067,0,0,29,0,-29
2068,0,0,9,0,-9
2069,1,0,162,0,-162
2070,1,1,23,1624,1601
2071,1,0,24,0,-24
2072,1,1,637,1332,695
2073,1,1,1493,1527,34
2074,0,0,40,0,-40
2075,1,0,4,0,-4
2076,1,0,34,0,-34
2077,0,0,13,0,-13
2078,1,0,73,0,-73
2079,1,1,521,2259,1738
2080,1,1,199,1715,1516
2081,1,1,201,1953,1752
2082,1,1,514,2001,1487
2083,1,0,4,0,-4
2084,1,0,119,0,-119
2085,0,0,8,0,-8
2086,0,0,12,0,-12
2087,1,0,3,0,-3
2088,0,0,29,0,-29
2089,0,0,88,0,-88
2090,1,1,583,1419,836
2091,0,0,125,0,-125
2092,1,0,24,0,-24
2093,0,0,35,0,-35
2094,0,0,22,0,-22
2095,0,0,44,0,-44
2096,1,1,56,1215,1159
2097,1,0,21,0,-21
2098,1,1,752,1344,592
2099,1,1,1045,2094,1049
2100,0,0,16,0,-16
2101,1,0,18,0,-18
2102,1,1,883,1355,472
2103,0,0,12,0,-12
2104,1,0,2,0,-2
2105,1,0,4,0,-4
2106,0,0,1,0,-1
2107,0,0,19,0,-19
2108,0,0,68,0,-68
2109,0,0,112,0,-112
2110,1,0,0,0,0
2111,1,1,90,1846,1756
2112,0,0,96,0,-96
2113,0,0,1,0,-1
2114,1,0,0,0,0
2115,0,0,41,0,-41
2116,1,1,933,1269,336
2117,0,0,55,0,-55
2118,1,0,3,0,-3
2119,1,1,14,1376,1362
2120,1,0,136,0,-136
2121,0,0,32,0,-32
2122,1,0,0,0,0
2123,0,0,36,0,-36
2124,1,1,209,1270,1061
2125,1,1,901,1372,471
2126,0,0,100,0,-100
2127,1,0,14,0,-14
2128,0,0,46,0,-46
2129,1,1,674,1521,847
2130,0,0,35,0,-35
2131,1,1,1683,1339,-344
2132,0,0,7,0,-7
2133,0,0,68,0,-68
2134,1,0,5,0,-5
2135,0,0,4,0,-4
2136,1,0,81,0,-81
2137,0,0,67,0,-67
2138,1,0,36,0,-36
2139,1,0,9,0,-9
2140,1,0,10,0,-10
2141,1,1,129,1300,1171
2142,1,1,79,1657,1578
2143,0,0,30,0,-30
2144,1,1,405,1359,954
2145,0,0,4,0,-4
2146,0,0,10,0,-10
2147,1,1,1473,2709,1236
2148,0,0,2,0,-2
2149,1,0,107,0,-107
2150,0,0,2,0,-2
2151,0,0,16,0,-16
2152,0,0,38,0,-38
2153,1,0,76,0,-76
2154,0,0,2,0,-2
2155,1,1,401,1408,1007
2156,0,0,71,0,-71
2157,0,0,5,0,-5
2158,0,0,22,0,-22
2159,0,0,40,0,-40
2160,1,0,22,0,-22
2161,1,1,206,2260,2054
2162,1,0,31,0,-31
2163,1,1,1575,1406,-169
2164,1,0,80,0,-80
2165,0,0,68,0,-68
2166,1,1,187,1460,1273
2167,1,0,25,0,-25
2168,1,1,746,2310,1564
2169,0,0,2,0,-2
2170,1,0,16,0,-16
2171,1,0,13,0,-13
2172,0,0,109,0,-109
2173,1,0,20,0,-20
2174,0,0,100,0,-100
2175,0,0,49,0,-49
2176,1,1,1046,1514,468
2177,0,0,10,0,-10
2178,1,1,360,1292,932
2179,1,1,289,1929,1640
2180,1,0,26,0,-26
2181,0,0,122,0,-122
2182,0,0,34,0,-34
2183,1,0,31,0,-31
2184,0,0,90,0,-90
2185,1,1,115,2060,1945
2186,1,1,342,1376,1034
2187,0,0,74,0,-74
2188,1,0,50,0,-50
2189,0,0,35,0,-35
2190,1,1,170,3025,2855
2191,0,0,2,0,-2
2192,0,0,64,0,-64
2193,0,0,9,0,-9
2194,1,1,385,1419,1034
2195,1,1,574,2240,1666
2196,0,0,19,0,-19
2197,1,1,452,1296,844
2198,1,0,44,0,-44
2199,1,1,134,1760,1626
2200,1,0,30,0,-30
2201,0,0,28,0,-28
2202,0,0,48,0,-48
2203,1,1,268,1302,1034
2204,0,0,28,0,-28
2205,0,0,192,0,-192
2206,1,0,69,0,-69
2207,1,0,109,0,-109
2208,0,0,66,0,-66
2209,1,1,87,1283,1196
2210,0,0,1,0,-1
2211,0,0,33,0,-33
2212,0,0,82,0,-82
2213,0,0,31,0,-31
2214,0,0,27,0,-27
2215,1,1,52,1275,1223
2216,1,0,19,0,-19
2217,0,0,0,0,0
2218,0,0,16,0,-16
2219,1,1,1472,1230,-242
2220,1,0,106,0,-106
2221,1,0,105,0,-105
2222,1,1,1253,1878,625
2223,1,1,519,2029,1510
2224,0,0,1,0,-1
2225,1,1,279,1262,983
2226,1,1,1321,1969,648
2227,0,0,198,0,-198
2228,1,0,8,0,-8
2229,1,0,36,0,-36
2230,1,1,772,1830,1058
2231,1,1,1005,1469,464
2232,1,1,211,2966,2755
2233,1,0,59,0,-59
2234,1,1,665,1674,1009
2235,0,0,72,0,-72
2236,0,0,3,0,-3
2237,0,0,99,0,-99
2238,0,0,0,0,0
2239,1,0,64,0,-64
2240,1,0,18,0,-18
2241,1,0,14,0,-14
2242,1,1,1558,1341,-217
2243,1,1,1638,2070,432
2244,1,0,20,0,-20
2245,0,0,10,0,-10
2246,0,0,16,0,-16
2247,1,0,13,0,-13
2248,1,1,99,1324,1225
2249,1,1,618,1312,694
2250,1,1,1539,2005,466
2251,0,0,17,0,-17
2252,1,1,73,1489,1416
2253,1,0,10,0,-10
2254,0,0,21,0,-21
2255,0,0,23,0,-23
2256,1,1,1152,1759,607
2257,1,1,901,2345,1444
2258,0,0,33,0,-33
2259,1,0,20,0,-20
2260,0,0,15,0,-15
2261,1,1,50,2095,2045
2262,1,0,8,0,-8
2263,1,1,1670,1869,199
2264,0,0,33,0,-33
2265,0,0,141,0,-141
2266,1,0,22,0,-22
2267,0,0,14,0,-14
2268,1,1,242,1208,966
2269,1,0,18,0,-18
2270,0,0,29,0,-29
2271,1,1,363,2055,1692
2272,1,0,3,0,-3
2273,0,0,142,0,-142
2274,0,0,26,0,-26
2275,1,1,1102,2171,1069
2276,1,1,258,1694,1436
2277,0,0,74,0,-74
2278,1,1,492,1301,809
2279,0,0,50,0,-50
2280,0,0,113,0,-113
2281,0,0,8,0,-8
2282,1,0,39,0,-39
2283,1,0,2,0,-2
2284,0,0,55,0,-55
2285,1,0,43,0,-43
2286,1,0,79,0,-79
2287,0,0,0,0,0
2288,1,1,192,1206,1014
2289,1,1,259,1595,1336
2290,1,0,3,0,-3
2291,1,0,33,0,-33
2292,1,1,59,1468,1409
2293,1,1,211,3153,2942
2294,1,0,85,0,-85
2295,0,0,13,0,-13
2296,1,1,632,1360,728
2297,0,0,82,0,-82
2298,1,1,770,1253,483
2299,1,0,9,0,-9
2300,1,0,45,0,-45
2301,0,0,0,0,0
2302,0,0,110,0,-110
2303,1,1,303,1676,1373
2304,1,0,19,0,-19
2305,1,1,64,1375,1311
2306,1,0,22,0,-22
2307,1,1,596,1202,606
2308,1,1,193,1300,1107
2309,0,0,94,0,-94
2310,1,1,248,1633,1385
2311,1,0,27,0,-27
2312,1,0,24,0,-24
2313,1,1,619,1647,1028
2314,0,0,15,0,-15
2315,1,1,717,2370,1653
2316,1,1,607,1626,1019
2317,1,1,1935,1578,-357
2318,1,1,1539,1547,8
2319,0,0,19,0,-19
2320,1,0,109,0,-109
2321,1,1,251,1377,1126
2322,1,0,56,0,-56
2323,1,1,2308,1793,-515
2324,1,0,34,0,-34
2325,1,1,194,2105,1911
2326,0,0,19,0,-19
2327,0,0,19,0,-19
2328,1,0,89,0,-89
2329,0,0,11,0,-11
2330,0,0,23,0,-23
2331,1,0,94,0,-94
2332,1,0,12,0,-12
2333,0,0,11,0,-11
2334,1,1,216,1696,1480
2335,0,0,3,0,-3
2336,1,1,723,1905,1182
2337,1,1,287,2409,2122
2338,1,1,341,1821,1480
2339,0,0,82,0,-82
2340,1,0,34,0,-34
2341,1,1,902,1224,322
2342,1,1,2138,1368,-770
2343,1,0,28,0,-28
2344,1,1,1534,1309,-225
2345,1,0,20,0,-20
2346,1,1,387,1603,1216
2347,0,0,56,0,-56
2348,1,0,55,0,-55
2349,1,1,126,1884,1758
2350,1,1,317,1391,1074
2351,1,0,104,0,-104
2352,1,1,92,1250,1158
2353,1,1,143,1268,1125
2354,1,0,9,0,-9
2355,1,0,41,0,-41
2356,1,1,1030,1646,616
2357,0,0,2,0,-2
2358,0,0,72,0,-72
2359,0,0,49,0,-49
2360,1,1,1533,1239,-294
2361,1,1,813,1726,913
2362,1,0,138,0,-138
2363,1,1,534,2450,1916
2364,1,0,2,0,-2
2365,1,0,34,0,-34
2366,1,0,19,0,-19
2367,0,0,17,0,-17
2368,0,0,50,0,-50
2369,1,0,12,0,-12
2370,1,1,270,1300,1030
2371,1,0,136,0,-136
2372,1,1,599,2884,2285
2373,1,1,434,1211,777
2374,0,0,38,0,-38
2375,1,1,251,1390,1139
2376,0,0,4,0,-4
2377,1,0,59,0,-59
2378,0,0,0,0,0
2379,0,0,99,0,-99
2380,1,1,958,1470,512
2381,0,0,5,0,-5
2382,1,1,225,1329,1104
2383,0,0,94,0,-94
2384,1,1,312,2256,1944
2385,0,0,17,0,-17
2386,1,0,162,0,-162
2387,0,0,16,0,-16
2388,1,0,28,0,-28
2389,1,0,66,0,-66
2390,1,0,40,0,-40
2391,1,1,213,1322,1109
2392,0,0,34,0,-34
2393,1,0,32,0,-32
2394,0,0,35,0,-35
2395,1,1,101,2481,2380
2396,0,0,48,0,-48
2397,1,0,34,0,-34
2398,1,1,506,1714,1208
2399,1,1,97,2128,2031
2400,0,0,18,0,-18
2401,0,0,39,0,-39
2402,0,0,19,0,-19
2403,1,0,28,0,-28
2404,1,1,232,1366,1134
2405,1,0,51,0,-51
2406,1,0,118,0,-118
2407,0,0,1,0,-1
2408,1,1,77,1535,1458
2409,1,1,332,1266,934
2410,1,1,203,1220,1017
2411,1,1,1333,1300,-33
2412,1,0,26,0,-26
2413,0,0,4,0,-4
2414,1,1,30,1568,1538
2415,1,1,137,1597,1460
2416,1,1,1396,1394,-2
2417,1,0,10,0,-10
2418,1,1,86,1509,1423
2419,0,0,71,0,-71
2420,1,1,148,1295,1147
2421,1,1,276,1671,1395
2422,1,0,28,0,-28
2423,1,1,81,1245,1164
2424,1,1,838,7557,6719
2425,0,0,11,0,-11
2426,1,1,373,1307,934
2427,1,0,20,0,-20
2428,1,0,22,0,-22
2429,1,1,610,1263,653
2430,1,0,51,0,-51
2431,0,0,71,0,-71
2432,0,0,25,0,-25
2433,1,1,761,1600,839
2434,1,0,14,0,-14
2435,1,1,601,1690,1089
2436,1,1,310,1362,1052
2437,1,1,460,1718,1258
2438,0,0,2,0,-2
2439,1,0,28,0,-28
2440,0,0,57,0,-57
2441,1,0,0,0,0
2442,1,1,95,1981,1886
2443,1,1,105,2159,2054
2444,1,1,143,1368,1225
2445,1,0,6,0,-6
2446,1,1,586,1280,694
2447,1,0,78,0,-78
2448,0,0,33,0,-33
2449,1,1,1360,1422,62
2450,0,0,173,0,-173
2451,0,0,32,0,-32
2452,1,0,33,0,-33
2453,0,0,4,0,-4
2454,1,1,103,1533,1430
2455,1,1,867,1288,421
2456,0,0,37,0,-37
2457,1,1,722,1210,488
2458,1,0,99,0,-99
2459,0,0,78,0,-78
2460,1,1,388,1216,828
2461,0,0,26,0,-26
2462,1,0,17,0,-17
2463,1,1,1045,1649,604
2464,0,0,36,0,-36
2465,1,0,27,0,-27
2466,1,1,207,1234,1027
2467,1,1,585,1255,670
2468,0,0,46,0,-46
2469,0,0,90,0,-90
2470,1,0,4,0,-4
2471,1,0,118,0,-118
2472,0,0,4,0,-4
2473,1,0,52,0,-52
2474,1,1,975,1752,777
2475,0,0,48,0,-48
2476,1,1,1077,1328,251
2477,1,0,29,0,-29
2478,0,0,50,0,-50
2479,1,0,3,0,-3
2480,1,1,161,2219,2058
2481,1,0,42,0,-42
2482,1,0,63,0,-63
2483,0,0,70,0,-70
2484,0,0,32,0,-32
2485,0,0,41,0,-41
2486,1,0,147,0,-147
2487,1,0,11,0,-11
2488,0,0,103,0,-103
2489,0,0,4,0,-4
2490,1,0,58,0,-58
2491,1,0,5,0,-5
2492,0,0,44,0,-44
2493,1,0,10,0,-10
2494,0,0,116,0,-116
2495,1,1,583,1522,939
2496,0,0,66,0,-66
2497,1,1,554,1357,803
2498,1,1,407,1230,823
2499,0,0,225,0,-225
2500,0,0,33,0,-33
2501,1,1,57,1450,1393
2502,0,0,19,0,-19
2503,1,1,617,1397,780
2504,0,0,13,0,-13
2505,0,0,49,0,-49
2506,1,1,856,1843,987
2507,1,0,11,0,-11
2508,0,0,31,0,-31
2509,1,0,30,0,-30
2510,1,1,100,1319,1219
2511,0,0,11,0,-11
2512,1,0,66,0,-66
2513,1,1,753,1269,516
2514,1,0,570,0,-570
2515,1,0,182,0,-182
2516,1,1,266,2401,2135
2517,1,0,3,0,-3
2518,1,0,27,0,-27
2519,0,0,1,0,-1
2520,1,1,107,2751,2644
2521,1,0,12,0,-12
2522,0,0,4,0,-4
2523,0,0,38,0,-38
2524,1,0,24,0,-24
2525,0,0,108,0,-108
2526,1,1,228,1869,1641
2527,1,0,61,0,-61
2528,1,1,85,1636,1551
2529,0,0,36,0,-36
2530,1,1,1044,1756,712
2531,1,1,184,1684,1500
2532,1,0,198,0,-198
2533,1,0,44,0,-44
2534,1,0,4,0,-4
2535,1,1,210,1319,1109
2536,1,0,33,0,-33
2537,1,1,590,1465,875
2538,0,0,12,0,-12
2539,1,1,1165,1661,496
2540,0,0,113,0,-113
2541,0,0,11,0,-11
2542,1,1,183,1298,1115
2543,1,0,21,0,-21
2544,1,1,586,1223,637
2545,0,0,147,0,-147
2546,0,0,33,0,-33
2547,1,1,189,1404,1215
2548,0,0,97,0,-97
2549,1,1,113,1356,1243
2550,1,0,167,0,-167
2551,1,0,14,0,-14
2552,0,0,7,0,-7
2553,1,1,38,1589,1551
2554,1,1,773,1416,643
2555,1,1,2691,1367,-1324
2556,0,0,9,0,-9
2557,1,1,62,1241,1179
2558,0,0,74,0,-74
2559,1,1,567,1302,735
2560,1,1,587,1672,1085
2561,0,0,27,0,-27
2562,1,0,12,0,-12
2563,0,0,68,0,-68
2564,1,0,19,0,-19
2565,1,1,1290,1523,233
2566,1,1,567,1718,1151
2567,1,1,477,3721,3244
2568,1,0,97,0,-97
2569,1,0,3,0,-3
2570,1,1,32,1275,1243
2571,1,0,48,0,-48
2572,0,0,14,0,-14
2573,0,0,16,0,-16
2574,1,0,136,0,-136
2575,1,0,48,0,-48
2576,1,0,43,0,-43
2577,1,1,51,1403,1352
2578,1,1,44,1759,1715
2579,0,0,10,0,-10
2580,1,1,132,1578,1446
2581,1,1,340,1778,1438
2582,1,1,649,1934,1285
2583,1,0,30,0,-30
2584,1,0,47,0,-47
2585,0,0,41,0,-41
2586,0,0,17,0,-17
2587,0,0,88,0,-88
2588,1,0,24,0,-24
2589,0,0,106,0,-106
2590,1,0,84,0,-84
2591,1,0,110,0,-110
2592,1,1,464,1213,749
2593,1,1,50,1713,1663
2594,1,1,796,1235,439
2595,0,0,22,0,-22
2596,1,1,579,2415,1836
2597,1,1,1427,1267,-160
2598,0,0,12,0,-12
2599,1,0,139,0,-139
2600,1,1,345,1200,855
2601,1,0,5,0,-5
2602,0,0,21,0,-21
2603,1,1,328,1276,948
2604,0,0,48,0,-48
2605,1,0,8,0,-8
2606,1,1,416,1338,922
2607,0,0,68,0,-68
2608,1,0,8,0,-8
2609,1,0,64,0,-64
2610,1,0,174,0,-174
2611,1,1,163,1426,1263
2612,1,1,268,1319,1051
2613,0,0,27,0,-27
2614,0,0,15,0,-15
2615,1,0,2,0,-2
2616,0,0,82,0,-82
2617,0,0,12,0,-12
2618,1,1,1535,1466,-69
2619,0,0,34,0,-34
2620,0,0,8,0,-8
2621,1,0,34,0,-34
2622,0,0,26,0,-26
2623,1,1,470,1203,733
2624,1,1,1251,1453,202
2625,1,1,191,1641,1450
2626,1,0,2,0,-2
2627,1,1,399,1830,1431
2628,1,0,107,0,-107
2629,1,0,10,0,-10
2630,1,1,486,3328,2842
2631,1,1,220,1258,1038
2632,1,0,39,0,-39
2633,1,1,611,1326,715
2634,0,0,42,0,-42
2635,1,0,0,0,0
2636,1,1,808,1243,435
2637,0,0,252,0,-252
2638,1,0,110,0,-110
2639,0,0,27,0,-27
2640,1,0,100,0,-100
2641,1,0,48,0,-48
2642,0,0,16,0,-16
2643,1,1,943,1436,493
2644,1,0,66,0,-66
2645,0,0,31,0,-31
2646,1,1,103,1714,1611
2647,0,0,10,0,-10
2648,1,0,7,0,-7
2649,0,0,46,0,-46
2650,1,1,604,2063,1459
2651,1,0,156,0,-156
2652,0,0,204,0,-204
2653,1,0,24,0,-24
2654,0,0,1,0,-1
2655,0,0,59,0,-59
2656,0,0,48,0,-48
2657,1,0,32,0,-32
2658,1,1,159,1215,1056
2659,0,0,26,0,-26
2660,0,0,119,0,-119
2661,1,1,92,1221,1129
2662,1,0,72,0,-72
2663,0,0,19,0,-19
2664,0,0,99,0,-99
2665,1,0,70,0,-70
2666,0,0,43,0,-43
2667,1,1,1060,1425,365
2668,1,0,59,0,-59
2669,1,0,18,0,-18
2670,1,1,68,3059,2991
2671,1,0,95,0,-95
2672,1,0,87,0,-87
2673,1,0,23,0,-23
2674,0,0,12,0,-12
2675,0,0,32,0,-32
2676,1,1,43,1344,1301
2677,1,1,731,2254,1523
2678,1,0,17,0,-17
2679,1,1,1013,1730,717
2680,1,0,75,0,-75
2681,1,1,75,1328,1253
2682,0,0,14,0,-14
2683,0,0,22,0,-22
2684,0,0,51,0,-51
2685,1,1,213,1608,1395
2686,0,0,16,0,-16
2687,1,1,106,1922,1816
2688,1,1,451,1595,1144
2689,0,0,6,0,-6
2690,1,1,766,1241,475
2691,0,0,20,0,-20
2692,0,0,18,0,-18
2693,1,0,4,0,-4
2694,0,0,34,0,-34
2695,1,0,132,0,-132
2696,0,0,5,0,-5
2697,0,0,12,0,-12
2698,1,0,45,0,-45
2699,0,0,18,0,-18
2700,1,1,796,1291,495
2701,0,0,26,0,-26
2702,0,0,87,0,-87
2703,1,1,445,1799,1354
2704,1,0,214,0,-214
2705,0,0,12,0,-12
2706,1,1,1123,1217,94
2707,0,0,1,0,-1
2708,0,0,119,0,-119
2709,1,1,282,1321,1039
2710,0,0,85,0,-85
2711,0,0,8,0,-8
2712,1,0,16,0,-16
2713,1,0,63,0,-63
2714,1,1,573,1465,892
2715,1,0,112,0,-112
2716,1,0,99,0,-99
2717,1,1,1037,1491,454
2718,1,1,647,1815,1168
2719,1,0,11,0,-11
2720,0,0,31,0,-31
2721,0,0,14,0,-14
2722,0,0,22,0,-22
2723,1,1,300,1820,1520
2724,0,0,7,0,-7
2725,1,1,128,1521,1393
2726,1,1,620,1395,775
2727,1,0,26,0,-26
2728,1,0,76,0,-76
2729,0,0,42,0,-42
2730,1,1,849,1759,910
2731,1,1,387,1542,1155
2732,0,0,3,0,-3
2733,1,1,135,1203,1068
2734,0,0,0,0,0
2735,0,0,14,0,-14
2736,0,0,53,0,-53
2737,0,0,36,0,-36
2738,1,0,32,0,-32
2739,1,0,23,0,-23
2740,1,0,11,0,-11
2741,0,0,20,0,-20
2742,1,1,2049,1200,-849
2743,1,1,259,1443,1184
2744,1,1,779,1249,470
2745,0,0,49,0,-49
2746,0,0,4,0,-4
2747,1,1,139,1764,1625
2748,0,0,46,0,-46
2749,1,0,17,0,-17
2750,1,0,34,0,-34
2751,1,0,1,0,-1
2752,0,0,32,0,-32
2753,0,0,22,0,-22
2754,0,0,37,0,-37
2755,1,1,178,1343,1165
2756,0,0,188,0,-188
2757,0,0,87,0,-87
2758,0,0,13,0,-13
2759,1,1,1399,1296,-103
2760,1,1,1007,1604,597
2761,1,0,162,0,-162
2762,1,1,197,1270,1073
2763,0,0,27,0,-27
2764,1,1,86,1847,1761
2765,0,0,31,0,-31
2766,1,1,93,1547,1454
2767,1,0,129,0,-129
2768,1,1,142,1239,1097
2769,0,0,119,0,-119
2770,1,1,556,1496,940
2771,1,0,22,0,-22
2772,1,0,26,0,-26
2773,1,0,40,0,-40
2774,1,1,82,1351,1269
2775,0,0,15,0,-15
2776,1,0,85,0,-85
2777,1,0,93,0,-93
2778,0,0,27,0,-27
2779,1,1,1551,1486,-65
2780,1,1,657,1657,1000
2781,0,0,41,0,-41
2782,0,0,7,0,-7
2783,0,0,217,0,-217
2784,1,1,245,1415,1170
2785,1,1,1235,1290,55
2786,1,1,713,1684,971
2787,1,0,8,0,-8
2788,0,0,13,0,-13
2789,1,0,22,0,-22
2790,1,1,1476,1511,35
2791,1,1,199,1346,1147
2792,0,0,5,0,-5
2793,1,1,239,1258,1019
2794,0,0,17,0,-17
2795,0,0,12,0,-12
2796,0,0,185,0,-185
2797,0,0,70,0,-70
2798,1,1,344,2167,1823
2799,0,0,14,0,-14
2800,0,0,19,0,-19
2801,0,0,77,0,-77
2802,1,0,87,0,-87
2803,0,0,4,0,-4
2804,1,1,103,1441,1338
2805,1,1,44,1235,1191
2806,0,0,21,0,-21
2807,0,0,25,0,-25
2808,1,1,108,1519,1411
2809,0,0,14,0,-14
2810,1,1,1744,1419,-325
2811,1,0,127,0,-127
2812,1,0,37,0,-37
2813,0,0,4,0,-4
2814,1,0,28,0,-28
2815,1,0,137,0,-137
2816,0,0,45,0,-45
2817,0,0,38,0,-38
2818,1,1,1369,1383,14
2819,1,1,1395,1240,-155
2820,1,1,198,1246,1048
2821,1,1,372,1356,984
2822,0,0,71,0,-71
2823,1,0,41,0,-41
2824,1,1,228,1643,1415
2825,1,0,8,0,-8
2826,0,0,108,0,-108
2827,0,0,182,0,-182
2828,0,0,26,0,-26
2829,1,0,21,0,-21
2830,0,0,17,0,-17
2831,1,0,4,0,-4
2832,1,0,5,0,-5
2833,1,0,3,0,-3
2834,1,1,2092,1212,-880
2835,0,0,41,0,-41
2836,1,0,104,0,-104
2837,0,0,49,0,-49
2838,0,0,75,0,-75
2839,0,0,16,0,-16
2840,1,1,424,1640,1216
2841,0,0,29,0,-29
2842,0,0,6,0,-6
2843,1,1,88,1417,1329
2844,1,0,74,0,-74
2845,1,0,33,0,-33
2846,0,0,27,0,-27
2847,1,0,38,0,-38
2848,0,0,12,0,-12
2849,1,1,381,1475,1094
2850,0,0,89,0,-89
2851,0,0,52,0,-52
2852,0,0,85,0,-85
2853,0,0,66,0,-66
2854,0,0,139,0,-139
2855,0,0,2,0,-2
2856,0,0,11,0,-11
2857,0,0,58,0,-58
2858,1,1,863,1446,583
2859,0,0,28,0,-28
2860,1,0,81,0,-81
2861,1,1,1708,1476,-232
2862,1,1,334,2376,2042
2863,0,0,16,0,-16
2864,1,0,13,0,-13
2865,0,0,21,0,-21
2866,1,0,27,0,-27
2867,0,0,22,0,-22
2868,1,1,472,1246,774
2869,0,0,22,0,-22
2870,1,0,28,0,-28
2871,0,0,13,0,-13
2872,0,0,3,0,-3
2873,1,0,9,0,-9
2874,1,0,22,0,-22
2875,1,0,99,0,-99
2876,1,0,66,0,-66
2877,1,1,371,2096,1725
2878,1,0,44,0,-44
2879,0,0,16,0,-16
2880,1,1,380,1271,891
2881,0,0,55,0,-55
2882,1,0,111,0,-111
2883,0,0,17,0,-17
2884,1,0,33,0,-33
2885,0,0,52,0,-52
2886,0,0,62,0,-62
2887,0,0,119,0,-119
2888,0,0,27,0,-27
2889,1,0,11,0,-11
2890,0,0,127,0,-127
2891,0,0,7,0,-7
2892,1,0,78,0,-78
2893,1,0,15,0,-15
2894,1,0,38,0,-38
2895,1,0,21,0,-21
2896,0,0,27,0,-27
2897,0,0,49,0,-49
2898,1,0,5,0,-5
2899,1,1,1341,1241,-100
2900,1,1,815,1209,394
2901,0,0,60,0,-60
2902,1,1,208,1750,1542
2903,1,1,1336,1322,-14
2904,1,1,1281,1390,109
2905,0,0,30,0,-30
2906,1,0,150,0,-150
2907,1,1,401,2058,1657
2908,1,1,1134,1306,172
2909,1,1,187,1250,1063
2910,1,1,921,1251,330
2911,1,0,35,0,-35
2912,0,0,81,0,-81
2913,1,0,123,0,-123
2914,1,1,278,1646,1368
2915,0,0,80,0,-80
2916,1,1,1502,1524,22
2917,1,1,219,2073,1854
2918,1,1,274,1759,1485
2919,0,0,17,0,-17
2920,0,0,97,0,-97
2921,1,1,2663,1513,-1150
2922,0,0,27,0,-27
2923,0,0,12,0,-12
2924,0,0,107,0,-107
2925,0,0,18,0,-18
2926,0,0,11,0,-11
2927,1,0,28,0,-28
2928,0,0,12,0,-12
2929,1,0,77,0,-77
2930,1,1,1235,1575,340
2931,0,0,57,0,-57
2932,1,1,177,1496,1319
2933,1,1,211,1233,1022
2934,0,0,7,0,-7
2935,1,1,475,1327,852
2936,1,1,220,1330,1110
2937,1,1,1362,1705,343
2938,1,1,319,1636,1317
2939,1,0,13,0,-13
2940,0,0,66,0,-66
2941,1,0,16,0,-16
2942,0,0,11,0,-11
2943,1,1,328,1260,932
2944,1,0,50,0,-50
2945,0,0,40,0,-40
2946,1,1,1111,1226,115
2947,0,0,77,0,-77
2948,0,0,6,0,-6
2949,1,1,205,1864,1659
2950,1,0,63,0,-63
2951,1,0,11,0,-11
2952,1,0,26,0,-26
2953,1,1,686,1490,804
2954,1,0,46,0,-46
2955,0,0,10,0,-10
2956,0,0,28,0,-28
2957,1,1,492,1242,750
2958,1,1,501,1689,1188
2959,0,0,79,0,-79
2960,0,0,12,0,-12
2961,1,1,298,1341,1043
2962,1,0,25,0,-25
2963,0,0,13,0,-13
2964,0,0,45,0,-45
2965,0,0,252,0,-252
2966,0,0,22,0,-22
2967,0,0,194,0,-194
2968,0,0,79,0,-79
2969,0,0,53,0,-53
2970,1,1,278,1772,1494
2971,1,1,603,1405,802
2972,0,0,21,0,-21
2973,0,0,3,0,-3
2974,1,1,1832,2855,1023
2975,0,0,0,0,0
2976,1,1,2090,1404,-686
2977,1,0,24,0,-24
2978,0,0,47,0,-47
2979,0,0,28,0,-28
2980,0,0,22,0,-22
2981,1,1,119,1264,1145
2982,0,0,53,0,-53
2983,1,1,546,1439,893
2984,1,1,1003,1609,606
2985,0,0,119,0,-119
2986,0,0,36,0,-36
2987,0,0,15,0,-15
2988,0,0,8,0,-8
2989,1,1,606,1532,926
2990,1,1,1806,1632,-174
2991,1,1,304,2169,1865
2992,1,1,427,1824,1397
2993,0,0,33,0,-33
2994,0,0,105,0,-105
2995,1,0,104,0,-104
2996,1,1,741,2123,1382
2997,0,0,21,0,-21
2998,1,1,287,1250,963
2999,0,0,38,0,-38
3000,0,0,63,0,-63
3001,1,1,522,1208,686
3002,0,0,15,0,-15
3003,1,0,27,0,-27
3004,0,0,12,0,-12
3005,1,1,1131,1216,85
3006,1,0,50,0,-50
3007,1,0,26,0,-26
3008,1,1,592,1310,718
3009,1,1,492,1655,1163
3010,0,0,26,0,-26
3011,0,0,14,0,-14
3012,1,0,153,0,-153
3013,1,0,9,0,-9
3014,1,0,44,0,-44
3015,1,0,12,0,-12
3016,1,1,854,1205,351
3017,1,0,71,0,-71
3018,1,0,121,0,-121
3019,0,0,23,0,-23
3020,0,0,11,0,-11
3021,0,0,14,0,-14
3022,0,0,134,0,-134
3023,0,0,33,0,-33
3024,0,0,96,0,-96
3025,0,0,80,0,-80
3026,0,0,2,0,-2
3027,1,1,358,1658,1300
3028,1,1,1309,1858,549
3029,1,0,113,0,-113
3030,1,1,1323,1398,75
3031,1,1,72,1311,1239
3032,1,0,58,0,-58
3033,1,0,5,0,-5
3034,0,0,8,0,-8
3035,0,0,16,0,-16
3036,1,0,77,0,-77
3037,0,0,7,0,-7
3038,1,0,7,0,-7
3039,1,0,9,0,-9
3040,1,0,35,0,-35
3041,1,0,1,0,-1
3042,1,1,338,1326,988
3043,0,0,26,0,-26
3044,0,0,121,0,-121
3045,1,0,20,0,-20
3046,1,1,337,1600,1263
3047,1,1,704,1446,742
3048,1,0,76,0,-76
3049,1,1,644,1481,837
3050,0,0,58,0,-58
3051,1,0,1,0,-1
3052,1,0,26,0,-26
3053,1,1,222,1273,1051
3054,1,0,88,0,-88
3055,1,0,12,0,-12
3056,1,0,4,0,-4
3057,1,0,12,0,-12
3058,0,0,72,0,-72
3059,0,0,4,0,-4
3060,1,0,42,0,-42
3061,1,1,268,1429,1161
3062,1,1,929,1372,443
3063,1,0,62,0,-62
3064,0,0,27,0,-27
3065,1,1,420,1667,1247
3066,1,0,44,0,-44
3067,0,0,48,0,-48
3068,1,0,137,0,-137
3069,0,0,22,0,-22
3070,0,0,61,0,-61
3071,1,1,69,1532,1463
3072,1,1,682,1211,529
3073,1,1,54,1205,1151
3074,1,1,392,1449,1057
3075,1,0,18,0,-18
3076,0,0,0,0,0
3077,0,0,29,0,-29
3078,1,1,83,1379,1296
3079,1,1,445,1668,1223
3080,1,0,42,0,-42
3081,1,1,385,1247,862
3082,0,0,131,0,-131
3083,1,1,56,1257,1201
3084,1,1,699,1335,636
3085,0,0,114,0,-114
3086,1,0,54,0,-54
3087,1,1,72,1410,1338
3088,0,0,37,0,-37
3089,0,0,29,0,-29
3090,0,0,23,0,-23
3091,1,1,77,1969,1892
3092,1,1,1165,1665,500
3093,1,0,0,0,0
3094,0,0,6,0,-6
3095,0,0,3,0,-3
3096,1,0,3,0,-3
3097,1,1,1062,1436,374
3098,1,0,81,0,-81
3099,0,0,111,0,-111
3100,1,1,1054,1308,254
3101,0,0,49,0,-49
3102,1,1,159,1235,1076
3103,1,0,132,0,-132
3104,0,0,27,0,-27
3105,0,0,32,0,-32
3106,0,0,9,0,-9
3107,0,0,1,0,-1
3108,1,0,9,0,-9
3109,0,0,137,0,-137
3110,0,0,7,0,-7
3111,0,0,14,0,-14
3112,0,0,0,0,0
3113,1,1,82,1870,1788
3114,1,1,2854,1311,-1543
3115,1,1,1014,1305,291
3116,0,0,18,0,-18
3117,1,1,587,1346,759
3118,1,0,31,0,-31
3119,0,0,108,0,-108
3120,1,1,213,1331,1118
3121,1,1,1637,1217,-420
3122,0,0,55,0,-55
3123,0,0,68,0,-68
3124,1,1,76,1266,1190
3125,0,0,68,0,-68
3126,1,0,147,0,-147
3127,1,1,1001,2104,1103
3128,0,0,90,0,-90
3129,0,0,4,0,-4
3130,0,0,21,0,-21
3131,1,0,60,0,-60
3132,0,0,62,0,-62
3133,1,1,157,1298,1141
3134,0,0,341,0,-341
3135,0,0,18,0,-18
3136,0,0,16,0,-16
3137,0,0,139,0,-139
3138,1,1,28,1996,1968
3139,0,0,28,0,-28
3140,1,1,833,1909,1076
3141,0,0,7,0,-7
3142,0,0,29,0,-29
3143,1,1,161,1257,1096
3144,1,0,30,0,-30
3145,1,0,39,0,-39
3146,1,0,18,0,-18
3147,1,0,63,0,-63
3148,1,0,44,0,-44
3149,1,1,29,1689,1660
3150,0,0,81,0,-81
3151,0,0,41,0,-41
3152,1,0,65,0,-65
3153,1,1,1116,1296,180
3154,1,0,38,0,-38
3155,1,0,55,0,-55
3156,1,0,100,0,-100
3157,0,0,40,0,-40
3158,1,0,481,0,-481
3159,1,0,7,0,-7
3160,0,0,81,0,-81
3161,1,1,283,1510,1227
3162,0,0,82,0,-82
3163,0,0,32,0,-32
3164,1,0,84,0,-84
3165,0,0,35,0,-35
3166,1,1,203,1400,1197
3167,0,0,9,0,-9
3168,1,0,111,0,-111
3169,0,0,97,0,-97
3170,1,1,700,1679,979
3171,1,1,855,1559,704
3172,1,0,94,0,-94
3173,1,0,13,0,-13
3174,1,0,75,0,-75
3175,1,1,819,1385,566
3176,1,0,42,0,-42
3177,0,0,16,0,-16
3178,1,0,66,0,-66
3179,0,0,28,0,-28
3180,1,1,181,2521,2340
3181,1,1,342,1373,1031
3182,1,1,249,1355,1106
3183,0,0,27,0,-27
3184,1,0,14,0,-14
3185,0,0,14,0,-14
3186,0,0,63,0,-63
3187,0,0,10,0,-10
3188,0,0,40,0,-40
3189,0,0,10,0,-10
3190,0,0,24,0,-24
3191,0,0,15,0,-15
3192,0,0,86,0,-86
3193,1,1,544,1313,769
3194,0,0,159,0,-159
3195,1,1,806,1223,417
3196,1,1,100,1757,1657
3197,1,0,72,0,-72
3198,1,1,358,1775,1417
3199,0,0,182,0,-182
3200,0,0,29,0,-29
3201,1,0,3,0,-3
3202,0,0,51,0,-51
3203,0,0,52,0,-52
3204,1,1,52,1796,1744
3205,0,0,131,0,-131
3206,1,1,1132,1229,97
3207,0,0,22,0,-22
3208,1,0,3,0,-3
3209,1,0,21,0,-21
3210,1,0,15,0,-15
3211,1,1,331,1565,1234
3212,0,0,56,0,-56
3213,0,0,7,0,-7
3214,0,0,22,0,-22
3215,1,1,76,1216,1140
3216,0,0,84,0,-84
3217,1,1,414,1314,900
3218,0,0,48,0,-48
3219,0,0,163,0,-163
3220,0,0,21,0,-21
3221,1,0,37,0,-37
3222,1,0,58,0,-58
3223,0,0,130,0,-130
3224,1,0,47,0,-47
3225,1,1,557,1627,1070
3226,1,1,175,1370,1195
3227,1,1,524,1401,877
3228,0,0,56,0,-56
3229,1,1,294,1560,1266
3230,0,0,136,0,-136
3231,0,0,22,0,-22
3232,1,0,202,0,-202
3233,0,0,8,0,-8
3234,1,0,32,0,-32
3235,0,0,84,0,-84
3236,1,1,152,1842,1690
3237,1,1,364,1898,1534
3238,0,0,229,0,-229
3239,1,0,104,0,-104
3240,0,0,8,0,-8
3241,0,0,21,0,-21
3242,1,0,19,0,-19
3243,0,0,5,0,-5
3244,1,0,13,0,-13
3245,1,0,71,0,-71
3246,1,1,231,2135,1904
3247,0,0,31,0,-31
3248,0,0,37,0,-37
3249,0,0,106,0,-106
3250,0,0,49,0,-49
3251,0,0,230,0,-230
3252,1,1,396,1558,1162
3253,1,0,3,0,-3
3254,1,1,456,1236,780
3255,1,0,42,0,-42
3256,1,1,394,1351,957
3257,0,0,24,0,-24
3258,1,0,25,0,-25
3259,1,0,21,0,-21
3260,0,0,13,0,-13
3261,1,1,294,1640,1346
3262,0,0,11,0,-11
3263,1,1,121,2099,1978
3264,0,0,78,0,-78
3265,1,1,377,1212,835
3266,0,0,90,0,-90
3267,0,0,110,0,-110
3268,1,0,42,0,-42
3269,0,0,85,0,-85
3270,1,0,9,0,-9
3271,1,0,2,0,-2
3272,1,0,105,0,-105
3273,0,0,16,0,-16
3274,1,0,93,0,-93
3275,1,0,3,0,-3
3276,1,1,399,1408,1009
3277,0,0,32,0,-32
3278,1,0,95,0,-95
3279,0,0,25,0,-25
3280,1,0,78,0,-78
3281,1,0,18,0,-18
3282,0,0,4,0,-4
3283,1,0,30,0,-30
3284,0,0,76,0,-76
3285,1,0,29,0,-29
3286,0,0,147,0,-147
3287,1,1,231,1373,1142
3288,0,0,63,0,-63
3289,0,0,203,0,-203
3290,0,0,12,0,-12
3291,0,0,88,0,-88
3292,1,0,5,0,-5
3293,0,0,32,0,-32
3294,0,0,48,0,-48
3295,1,0,0,0,0
3296,1,1,1177,1329,152
3297,1,1,445,1529,1084
3298,0,0,113,0,-113
3299,1,1,966,1945,979
3300,0,0,18,0,-18
3301,1,1,219,1679,1460
3302,1,1,491,1210,719
3303,0,0,33,0,-33
3304,1,1,298,1329,1031
3305,1,1,500,1530,1030
3306,1,0,31,0,-31
3307,1,1,867,1297,430
3308,1,0,177,0,-177
3309,1,0,12,0,-12
3310,1,0,59,0,-59
3311,1,1,198,1860,1662
3312,1,0,2,0,-2
3313,1,1,197,1511,1314
3314,1,0,61,0,-61
3315,0,0,59,0,-59
3316,1,1,239,1259,1020
3317,1,1,556,1310,754
3318,0,0,61,0,-61
3319,1,0,0,0,0
3320,1,1,711,1658,947
3321,1,0,60,0,-60
3322,0,0,8,0,-8
3323,1,0,193,0,-193
3324,0,0,21,0,-21
3325,1,0,2,0,-2
3326,1,1,23,1497,1474
3327,0,0,110,0,-110
3328,0,0,92,0,-92
3329,0,0,34,0,-34
3330,1,0,24,0,-24
3331,1,1,655,1502,847
3332,1,0,28,0,-28
3333,0,0,3,0,-3
3334,1,0,42,0,-42
3335,1,0,74,0,-74
3336,0,0,126,0,-126
3337,1,0,23,0,-23
3338,0,0,21,0,-21
3339,1,1,1027,1398,371
3340,1,0,3,0,-3
3341,1,1,277,1303,1026
3342,0,0,93,0,-93
3343,1,1,49,2186,2137
3344,1,0,122,0,-122
3345,1,0,14,0,-14
3346,1,1,117,1259,1142
3347,0,0,6,0,-6
3348,0,0,10,0,-10
3349,0,0,16,0,-16
3350,0,0,32,0,-32
3351,0,0,32,0,-32
3352,1,0,89,0,-89
3353,1,0,33,0,-33
3354,0,0,16,0,-16
3355,0,0,2,0,-2
3356,1,1,135,1336,1201
3357,1,1,218,2408,2190
3358,1,0,8,0,-8
3359,0,0,29,0,-29
3360,1,1,263,1733,1470
3361,0,0,54,0,-54
3362,1,1,25,1763,1738
3363,0,0,96,0,-96
3364,0,0,26,0,-26
3365,1,1,367,2215,1848
3366,0,0,36,0,-36
3367,1,1,840,1511,671
3368,1,0,6,0,-6
3369,1,1,41,1484,1443
3370,1,0,212,0,-212
3371,1,1,404,1408,1004
3372,0,0,119,0,-119
3373,1,1,211,1871,1660
3374,0,0,50,0,-50
3375,0,0,2,0,-2
3376,0,0,13,0,-13
3377,1,0,91,0,-91
3378,1,0,13,0,-13
3379,1,0,19,0,-19
3380,1,1,695,1625,930
3381,1,0,17,0,-17
3382,1,1,559,1294,735
3383,0,0,124,0,-124
3384,0,0,26,0,-26
3385,0,0,5,0,-5
3386,1,0,86,0,-86
3387,0,0,32,0,-32
3388,0,0,44,0,-44
3389,1,0,111,0,-111
3390,1,0,59,0,-59
3391,1,1,776,1383,607
3392,0,0,55,0,-55
3393,0,0,141,0,-141
3394,0,0,105,0,-105
3395,0,0,69,0,-69
3396,1,1,463,1343,880
3397,1,0,6,0,-6
3398,1,1,84,1242,1158
3399,1,1,252,2046,1794
3400,1,0,1,0,-1
3401,0,0,10,0,-10
3402,1,1,162,1264,1102
3403,1,1,1959,1537,-422
3404,0,0,9,0,-9
3405,1,1,50,1349,1299
3406,0,0,85,0,-85
3407,0,0,65,0,-65
3408,1,0,59,0,-59
3409,1,1,617,1980,1363
3410,1,1,626,1800,1174
3411,1,1,346,1376,1030
3412,1,0,22,0,-22
3413,1,0,8,0,-8
3414,0,0,4,0,-4
3415,0,0,8,0,-8
3416,1,1,867,1383,516
3417,1,0,41,0,-41
3418,0,0,49,0,-49
3419,1,0,34,0,-34
3420,0,0,5,0,-5
3421,0,0,13,0,-13
3422,1,0,38,0,-38
3423,1,0,5,0,-5
3424,0,0,119,0,-119
3425,1,1,128,1742,1614
3426,1,1,41,1277,1236
3427,1,1,252,1299,1047
3428,0,0,24,0,-24
3429,0,0,7,0,-7
3430,0,0,33,0,-33
3431,0,0,1,0,-1
3432,0,0,71,0,-71
3433,0,0,5,0,-5
3434,1,0,35,0,-35
3435,1,0,19,0,-19
3436,1,1,123,1334,1211
3437,0,0,35,0,-35
3438,1,1,610,1303,693
3439,0,0,54,0,-54
3440,0,0,52,0,-52
3441,1,1,736,1240,504
3442,1,0,33,0,-33
3443,1,0,7,0,-7
3444,1,0,45,0,-45
3445,1,0,191,0,-191
3446,1,1,677,1944,1267
3447,1,0,119,0,-119
3448,0,0,59,0,-59
3449,1,0,59,0,-59
3450,0,0,20,0,-20
3451,0,0,12,0,-12
3452,1,0,26,0,-26
3453,1,0,4,0,-4
3454,1,0,4,0,-4
3455,0,0,22,0,-22
3456,0,0,14,0,-14
3457,1,0,117,0,-117
3458,1,1,869,1398,529
3459,1,1,440,1234,794
3460,1,1,1007,1252,245
3461,1,1,568,2327,1759
3462,1,1,29,1302,1273
3463,1,1,117,1209,1092
3464,1,0,97,0,-97
3465,0,0,22,0,-22
3466,0,0,16,0,-16
3467,1,1,175,1247,1072
3468,1,1,2490,1426,-1064
3469,1,1,1087,1283,196
3470,1,1,172,1383,1211
3471,1,0,24,0,-24
3472,1,0,50,0,-50
3473,1,0,0,0,0
3474,0,0,18,0,-18
3475,0,0,56,0,-56
3476,1,1,171,1283,1112
3477,0,0,7,0,-7
3478,0,0,14,0,-14
3479,1,1,54,1973,1919
3480,1,1,549,1248,699
3481,1,1,473,1390,917
3482,1,1,498,1246,748
3483,0,0,105,0,-105
3484,1,1,225,2081,1856
3485,1,1,477,1610,1133
3486,1,1,324,1412,1088
3487,1,0,46,0,-46
3488,0,0,10,0,-10
3489,1,0,21,0,-21
3490,0,0,8,0,-8
3491,1,1,561,1267,706
3492,0,0,181,0,-181
3493,1,1,1353,2024,671
3494,1,0,212,0,-212
3495,0,0,41,0,-41
3496,0,0,13,0,-13
3497,1,1,322,1511,1189
3498,1,1,549,1295,746
3499,1,1,254,1252,998
3500,0,0,32,0,-32
3501,0,0,175,0,-175
3502,1,1,1273,2282,1009
3503,1,0,89,0,-89
3504,1,1,572,1690,1118
3505,0,0,16,0,-16
3506,1,0,11,0,-11
3507,1,1,257,1408,1151
3508,1,1,169,1450,1281
3509,0,0,97,0,-97
3510,0,0,111,0,-111
3511,1,0,25,0,-25
3512,1,1,882,1350,468
3513,1,1,1834,1312,-522
3514,0,0,17,0,-17
3515,0,0,14,0,-14
3516,0,0,42,0,-42
3517,1,0,48,0,-48
3518,0,0,39,0,-39
3519,0,0,147,0,-147
3520,0,0,23,0,-23
3521,1,0,14,0,-14
3522,1,1,232,1206,974
3523,1,1,1040,1252,212
3524,1,1,103,1230,1127
3525,1,1,491,1283,792
3526,0,0,114,0,-114
3527,1,0,91,0,-91
3528,1,0,26,0,-26
3529,0,0,5,0,-5
3530,1,0,42,0,-42
3531,1,1,137,1853,1716
3532,0,0,9,0,-9
3533,1,0,28,0,-28
3534,1,0,80,0,-80
3535,1,1,748,1486,738
3536,0,0,124,0,-124
3537,1,1,1067,1359,292
3538,0,0,20,0,-20
3539,0,0,8,0,-8
3540,1,0,14,0,-14
3541,0,0,6,0,-6
3542,0,0,12,0,-12
3543,1,0,36,0,-36
3544,1,1,510,1581,1071
3545,0,0,121,0,-121
3546,1,1,2059,1410,-649
3547,1,0,73,0,-73
3548,1,0,9,0,-9
3549,1,1,236,1938,1702
3550,0,0,33,0,-33
3551,1,0,20,0,-20
3552,0,0,5,0,-5
3553,1,0,68,0,-68
3554,0,0,26,0,-26
3555,1,0,16,0,-16
3556,1,0,32,0,-32
3557,1,1,623,1240,617
3558,1,0,75,0,-75
3559,0,0,279,0,-279
3560,1,0,49,0,-49
3561,1,0,66,0,-66
3562,1,1,533,1422,889
3563,0,0,46,0,-46
3564,1,1,1594,1203,-391
3565,1,1,244,1431,1187
3566,1,1,1281,1297,16
3567,1,1,207,1411,1204
3568,0,0,420,0,-420
3569,1,0,8,0,-8
3570,0,0,10,0,-10
3571,1,0,106,0,-106
3572,1,0,3,0,-3
3573,1,1,40,1904,1864
3574,1,1,801,1376,575
3575,0,0,17,0,-17
3576,0,0,61,0,-61
3577,1,0,17,0,-17
3578,1,0,103,0,-103
3579,0,0,53,0,-53
3580,1,0,71,0,-71
3581,1,0,243,0,-243
3582,0,0,8,0,-8
3583,0,0,65,0,-65
3584,0,0,60,0,-60
3585,1,1,22,1688,1666
3586,1,1,262,1326,1064
3587,1,1,123,1385,1262
3588,0,0,43,0,-43
3589,0,0,5,0,-5
3590,0,0,8,0,-8
3591,1,1,120,2083,1963
3592,0,0,55,0,-55
3593,1,1,303,1904,1601
3594,1,0,23,0,-23
3595,0,0,108,0,-108
3596,0,0,12,0,-12
3597,1,0,61,0,-61
3598,1,0,4,0,-4
3599,0,0,4,0,-4
3600,1,1,2285,1216,-1069
3601,1,0,55,0,-55
3602,1,1,166,1370,1204
3603,1,0,13,0,-13
3604,0,0,36,0,-36
3605,0,0,63,0,-63
3606,0,0,68,0,-68
3607,1,0,66,0,-66
3608,0,0,61,0,-61
3609,1,1,294,1319,1025
3610,0,0,19,0,-19
3611,0,0,1,0,-1
3612,1,0,79,0,-79
3613,1,0,67,0,-67
3614,0,0,139,0,-139
3615,1,1,1506,1729,223
3616,1,1,391,1216,825
3617,1,1,130,1442,1312
3618,0,0,44,0,-44
3619,0,0,13,0,-13
3620,1,0,93,0,-93
3621,1,0,13,0,-13
3622,0,0,61,0,-61
3623,0,0,8,0,-8
3624,1,0,79,0,-79
3625,1,1,1437,1359,-78
3626,1,1,339,2659,2320
3627,0,0,12,0,-12
3628,0,0,95,0,-95
3629,0,0,81,0,-81
3630,0,0,58,0,-58
3631,1,1,1020,1771,751
3632,1,1,706,1397,691
3633,1,1,1221,2046,825
3634,1,1,784,1386,602
3635,1,1,892,1262,370
3636,0,0,63,0,-63
3637,1,0,34,0,-34
3638,1,1,597,1279,682
3639,0,0,28,0,-28
3640,0,0,26,0,-26
3641,0,0,3,0,-3
3642,0,0,156,0,-156
3643,1,0,25,0,-25
3644,1,0,109,0,-109
3645,1,1,1770,1222,-548
3646,0,0,1,0,-1
3647,0,0,113,0,-113
3648,0,0,8,0,-8
3649,0,0,70,0,-70
3650,1,1,295,1226,931
3651,1,1,1675,1515,-160
3652,1,0,15,0,-15
3653,0,0,38,0,-38
3654,1,1,469,1949,1480
3655,1,0,9,0,-9
3656,1,0,14,0,-14
3657,1,1,400,1807,1407
3658,0,0,82,0,-82
3659,0,0,44,0,-44
3660,0,0,49,0,-49
3661,1,1,119,1936,1817
3662,1,0,34,0,-34
3663,0,0,56,0,-56
3664,1,1,155,1284,1129
3665,1,0,57,0,-57
3666,1,0,38,0,-38
3667,1,0,24,0,-24
3668,1,0,92,0,-92
3669,1,1,428,1902,1474
3670,1,0,24,0,-24
3671,0,0,21,0,-21
3672,1,1,130,1314,1184
3673,0,0,54,0,-54
3674,1,0,73,0,-73
3675,1,0,70,0,-70
3676,1,0,4,0,-4
3677,1,0,20,0,-20
3678,1,0,19,0,-19
3679,0,0,21,0,-21
3680,1,0,33,0,-33
3681,1,1,1851,2306,455
3682,1,0,215,0,-215
3683,1,0,5,0,-5
3684,0,0,106,0,-106
3685,1,1,308,1903,1595
3686,1,0,13,0,-13
3687,1,1,547,1632,1085
3688,1,1,53,2244,2191
3689,1,0,87,0,-87
3690,1,1,192,1712,1520
3691,0,0,89,0,-89
3692,1,0,11,0,-11
3693,0,0,29,0,-29
3694,1,0,1,0,-1
3695,1,1,1407,1745,338
3696,1,1,535,1924,1389
3697,1,0,17,0,-17
3698,0,0,56,0,-56
3699,0,0,123,0,-123
3700,0,0,3,0,-3
3701,0,0,20,0,-20
3702,1,0,21,0,-21
3703,1,0,53,0,-53
3704,0,0,18,0,-18
3705,1,0,6,0,-6
3706,0,0,38,0,-38
3707,0,0,36,0,-36
3708,1,1,162,1357,1195
3709,1,0,124,0,-124
3710,0,0,100,0,-100
3711,1,1,23,1265,1242
3712,0,0,29,0,-29
3713,1,0,63,0,-63
3714,0,0,3,0,-3
3715,1,0,23,0,-23
3716,0,0,11,0,-11
3717,1,1,30,1204,1174
3718,1,0,38,0,-38
3719,1,1,1024,1235,211
3720,1,1,58,1207,1149
3721,0,0,24,0,-24
3722,1,1,410,1266,856
3723,1,0,2,0,-2
3724,1,1,275,1425,1150
3725,1,0,13,0,-13
3726,1,1,37,1368,1331
3727,1,0,47,0,-47
3728,1,1,431,1830,1399
3729,0,0,67,0,-67
3730,1,1,528,1295,767
3731,0,0,55,0,-55
3732,1,0,62,0,-62
3733,1,0,3,0,-3
3734,1,0,7,0,-7
3735,1,1,711,3272,2561
3736,0,0,13,0,-13
3737,1,0,27,0,-27
3738,1,1,718,1358,640
3739,0,0,146,0,-146
3740,1,0,16,0,-16
3741,1,0,23,0,-23
3742,1,1,369,1771,1402
3743,0,0,13,0,-13
3744,0,0,83,0,-83
3745,0,0,17,0,-17
3746,1,0,66,0,-66
3747,1,1,279,1823,1544
3748,1,0,99,0,-99
3749,1,1,589,1952,1363
3750,1,0,26,0,-26
3751,1,1,66,1766,1700
3752,1,0,17,0,-17
3753,1,1,76,1885,1809
3754,1,0,25,0,-25
3755,1,0,8,0,-8
3756,1,0,9,0,-9
3757,0,0,26,0,-26
3758,0,0,20,0,-20
3759,0,0,44,0,-44
3760,1,1,82,1902,1820
3761,1,1,1379,3091,1712
3762,1,0,179,0,-179
3763,0,0,38,0,-38
3764,1,1,508,1706,1198
3765,1,1,227,1477,1250
3766,1,1,37,1482,1445
3767,1,1,1949,1297,-652
3768,1,1,1118,1313,195
3769,1,0,23,0,-23
3770,1,1,1902,1885,-17
3771,0,0,46,0,-46
3772,1,1,186,1307,1121
3773,1,1,841,1851,1010
3774,0,0,147,0,-147
3775,1,1,834,1610,776
3776,0,0,37,0,-37
3777,0,0,62,0,-62
3778,0,0,164,0,-164
3779,1,1,299,1296,997
3780,1,0,14,0,-14
3781,0,0,13,0,-13
3782,1,1,465,1278,813
3783,1,0,66,0,-66
3784,1,0,33,0,-33
3785,1,1,285,1885,1600
3786,0,0,13,0,-13
3787,1,0,8,0,-8
3788,1,1,196,1325,1129
3789,0,0,39,0,-39
3790,0,0,161,0,-161
3791,1,0,31,0,-31
3792,1,0,24,0,-24
3793,1,0,69,0,-69
3794,1,1,794,1280,486
3795,1,1,529,1540,1011
3796,0,0,3,0,-3
3797,1,1,614,1213,599
3798,1,0,69,0,-69
3799,1,0,3,0,-3
3800,1,0,29,0,-29
3801,0,0,13,0,-13
3802,1,1,305,1263,958
3803,1,1,589,1235,646
3804,1,1,437,1449,1012
3805,1,0,14,0,-14
3806,1,1,2562,1725,-837
3807,1,1,1042,1304,262
3808,1,0,76,0,-76
3809,0,0,33,0,-33
3810,0,0,17,0,-17
3811,1,0,0,0,0
3812,1,0,44,0,-44
3813,1,0,12,0,-12
3814,0,0,7,0,-7
3815,0,0,32,0,-32
3816,0,0,1,0,-1
3817,1,0,50,0,-50
3818,1,1,1260,1286,26
3819,1,1,228,2258,2030
3820,1,0,90,0,-90
3821,1,0,35,0,-35
3822,1,0,45,0,-45
3823,0,0,120,0,-120
3824,0,0,2,0,-2
3825,0,0,36,0,-36
3826,0,0,12,0,-12
3827,1,0,25,0,-25
3828,0,0,31,0,-31
3829,0,0,69,0,-69
3830,1,0,5,0,-5
3831,0,0,53,0,-53
3832,1,1,191,1660,1469
3833,1,1,347,3423,3076
3834,1,1,119,1265,1146
3835,0,0,30,0,-30
3836,0,0,105,0,-105
3837,0,0,14,0,-14
3838,1,0,27,0,-27
3839,1,1,193,1263,1070
3840,1,1,318,1629,1311
3841,0,0,31,0,-31
3842,1,1,95,1225,1130
3843,1,0,10,0,-10
3844,0,0,84,0,-84
3845,1,0,53,0,-53
3846,1,1,374,1976,1602
3847,1,0,69,0,-69
3848,1,0,63,0,-63
3849,0,0,2,0,-2
3850,0,0,213,0,-213
3851,1,1,278,1250,972
3852,0,0,82,0,-82
3853,0,0,12,0,-12
3854,1,0,1,0,-1
3855,1,0,9,0,-9
3856,0,0,3,0,-3
3857,1,0,149,0,-149
3858,0,0,64,0,-64
3859,0,0,41,0,-41
3860,0,0,145,0,-145
3861,0,0,33,0,-33
3862,0,0,34,0,-34
3863,0,0,155,0,-155
3864,1,1,82,1289,1207
3865,1,1,144,1248,1104
3866,0,0,18,0,-18
3867,1,0,41,0,-41
3868,0,0,44,0,-44
3869,1,1,109,1369,1260
3870,0,0,2,0,-2
3871,0,0,35,0,-35
3872,1,0,2,0,-2
3873,1,0,19,0,-19
3874,1,0,55,0,-55
3875,1,0,2,0,-2
3876,0,0,6,0,-6
3877,1,1,307,1633,1326
3878,0,0,22,0,-22
3879,1,0,79,0,-79
3880,1,1,223,1544,1321
3881,0,0,46,0,-46
3882,1,0,101,0,-101
3883,0,0,90,0,-90
3884,0,0,18,0,-18
3885,0,0,53,0,-53
3886,0,0,36,0,-36
3887,1,0,60,0,-60
3888,0,0,36,0,-36
3889,0,0,44,0,-44
3890,1,1,1114,1955,841
3891,1,0,44,0,-44
3892,0,0,44,0,-44
3893,0,0,148,0,-148
3894,0,0,43,0,-43
3895,1,1,525,1211,686
3896,1,1,437,1271,834
3897,1,1,659,1329,670
3898,0,0,6,0,-6
3899,0,0,11,0,-11
3900,1,0,14,0,-14
3901,0,0,70,0,-70
3902,0,0,22,0,-22
3903,0,0,47,0,-47
3904,1,0,31,0,-31
3905,0,0,9,0,-9
3906,1,0,77,0,-77
3907,1,1,1383,1508,125
3908,0,0,23,0,-23
3909,0,0,1,0,-1
3910,1,1,507,1209,702
3911,1,1,636,2647,2011
3912,0,0,24,0,-24
3913,1,1,1204,1768,564
3914,1,0,0,0,0
3915,1,1,365,1550,1185
3916,1,1,104,1506,1402
3917,1,1,190,1330,1140
3918,0,0,6,0,-6
3919,1,0,28,0,-28
3920,1,1,223,1337,1114
3921,0,0,220,0,-220
3922,0,0,35,0,-35
3923,0,0,117,0,-117
3924,1,0,51,0,-51
3925,0,0,119,0,-119
3926,1,0,2,0,-2
3927,1,0,6,0,-6
3928,1,0,7,0,-7
3929,1,0,34,0,-34
3930,0,0,38,0,-38
3931,0,0,1,0,-1
3932,1,1,485,1491,1006
3933,0,0,12,0,-12
3934,1,1,176,1452,1276
3935,0,0,140,0,-140
3936,1,0,15,0,-15
3937,0,0,43,0,-43
3938,0,0,96,0,-96
3939,1,0,154,0,-154
3940,0,0,142,0,-142
3941,1,0,51,0,-51
3942,1,0,17,0,-17
3943,1,1,171,1418,1247
3944,1,1,865,2572,1707
3945,1,0,98,0,-98
3946,0,0,73,0,-73
3947,1,0,58,0,-58
3948,0,0,15,0,-15
3949,1,1,936,1681,745
3950,1,1,2109,1634,-475
3951,1,1,368,1885,1517
3952,1,1,363,1272,909
3953,1,1,107,3771,3664
3954,0,0,37,0,-37
3955,1,0,7,0,-7
3956,1,0,48,0,-48
3957,0,0,23,0,-23
3958,0,0,11,0,-11
3959,1,0,0,0,0
3960,1,1,403,1524,1121
3961,0,0,21,0,-21
3962,0,0,14,0,-14
3963,0,0,43,0,-43
3964,1,1,235,2148,1913
3965,1,1,963,1544,581
3966,0,0,83,0,-83
3967,0,0,44,0,-44
3968,0,0,101,0,-101
3969,1,1,408,1503,1095
3970,0,0,23,0,-23
3971,1,0,28,0,-28
3972,1,0,0,0,0
3973,1,0,126,0,-126
3974,0,0,15,0,-15
3975,0,0,17,0,-17
3976,1,1,643,1249,606
3977,1,0,86,0,-86
3978,1,0,118,0,-118
3979,0,0,166,0,-166
3980,1,1,498,2385,1887
3981,0,0,49,0,-49
3982,1,1,627,1472,845
3983,0,0,29,0,-29
3984,1,1,762,1280,518
3985,1,1,892,1409,517
3986,1,1,85,1635,1550
3987,0,0,103,0,-103
3988,0,0,52,0,-52
3989,1,0,29,0,-29
3990,1,1,463,2939,2476
3991,1,0,21,0,-21
3992,1,1,631,1206,575
3993,1,1,347,1312,965
3994,0,0,47,0,-47
3995,1,1,1384,1261,-123
3996,1,0,63,0,-63
3997,0,0,130,0,-130
3998,1,0,27,0,-27
3999,1,0,25,0,-25
4000,1,0,7,0,-7
4001,0,0,31,0,-31
4002,0,0,24,0,-24
4003,1,1,569,1656,1087
4004,1,1,1521,1248,-273
4005,1,0,165,0,-165
4006,0,0,56,0,-56
4007,0,0,6,0,-6
4008,1,1,931,1608,677
4009,1,1,367,1272,905
4010,1,0,26,0,-26
4011,0,0,84,0,-84
4012,1,1,121,1424,1303
4013,1,0,32,0,-32
4014,0,0,32,0,-32
4015,1,0,64,0,-64
4016,1,0,73,0,-73
4017,1,0,193,0,-193
4018,0,0,29,0,-29
4019,1,0,83,0,-83
4020,1,0,95,0,-95
4021,1,0,10,0,-10
4022,1,0,0,0,0
4023,1,0,61,0,-61
4024,0,0,33,0,-33
4025,1,0,49,0,-49
4026,1,0,2,0,-2
4027,1,0,138,0,-138
4028,1,0,6,0,-6
4029,0,0,48,0,-48
4030,1,1,326,1504,1178
4031,1,0,20,0,-20
4032,0,0,83,0,-83
4033,1,0,35,0,-35
4034,1,1,237,2049,1812
4035,0,0,83,0,-83
4036,1,1,268,2780,2512
4037,0,0,42,0,-42
4038,1,0,55,0,-55
4039,0,0,12,0,-12
4040,0,0,77,0,-77
4041,1,1,474,1448,974
4042,1,1,274,1479,1205
4043,0,0,7,0,-7
4044,1,0,2,0,-2
4045,1,0,28,0,-28
4046,1,1,114,1441,1327
4047,0,0,4,0,-4
4048,1,1,352,1216,864
4049,0,0,21,0,-21
4050,0,0,61,0,-61
4051,1,1,505,1225,720
4052,0,0,23,0,-23
4053,0,0,88,0,-88
4054,0,0,58,0,-58
4055,1,0,61,0,-61
4056,1,0,26,0,-26
4057,0,0,83,0,-83
4058,0,0,35,0,-35
4059,1,1,42,2498,2456
4060,1,0,80,0,-80
4061,1,1,87,1718,1631
4062,1,0,23,0,-23
4063,1,1,208,1979,1771
4064,1,0,3,0,-3
4065,0,0,56,0,-56
4066,0,0,25,0,-25
4067,0,0,13,0,-13
4068,1,0,6,0,-6
4069,0,0,42,0,-42
4070,1,0,82,0,-82
4071,1,0,9,0,-9
4072,0,0,32,0,-32
4073,1,1,228,1213,985
4074,1,1,224,1469,1245
4075,0,0,1,0,-1
4076,0,0,27,0,-27
4077,1,0,2,0,-2
4078,0,0,75,0,-75
4079,0,0,11,0,-11
4080,0,0,25,0,-25
4081,0,0,69,0,-69
4082,0,0,2,0,-2
4083,0,0,12,0,-12
4084,0,0,63,0,-63
4085,1,0,16,0,-16
4086,0,0,54,0,-54
4087,0,0,10,0,-10
4088,0,0,5,0,-5
4089,1,0,19,0,-19
4090,0,0,33,0,-33
4091,1,0,7,0,-7
4092,0,0,9,0,-9
4093,1,0,88,0,-88
4094,0,0,105,0,-105
4095,0,0,113,0,-113
4096,0,0,7,0,-7
4097,1,0,17,0,-17
4098,1,1,204,1571,1367
4099,1,1,126,1412,1286
4100,1,1,407,1296,889
4101,1,0,9,0,-9
4102,1,0,123,0,-123
4103,0,0,51,0,-51
4104,0,0,25,0,-25
4105,1,0,92,0,-92
4106,1,0,28,0,-28
4107,1,0,8,0,-8
4108,0,0,107,0,-107
4109,0,0,53,0,-53
4110,1,1,870,1243,373
4111,0,0,9,0,-9
4112,1,0,11,0,-11
4113,1,1,206,1383,1177
4114,1,0,22,0,-22
4115,0,0,46,0,-46
4116,0,0,19,0,-19
4117,1,0,67,0,-67
4118,1,0,136,0,-136
4119,1,0,2,0,-2
4120,0,0,46,0,-46
4121,1,1,687,1389,702
4122,1,1,675,1462,787
4123,0,0,86,0,-86
4124,0,0,1,0,-1
4125,1,0,115,0,-115
4126,0,0,42,0,-42
4127,0,0,52,0,-52
4128,1,0,25,0,-25
4129,0,0,18,0,-18
4130,1,1,979,1505,526
4131,1,1,1956,1419,-537
4132,0,0,81,0,-81
4133,1,1,382,1255,873
4134,0,0,0,0,0
4135,1,0,149,0,-149
4136,0,0,101,0,-101
4137,1,1,269,1354,1085
4138,0,0,77,0,-77
4139,0,0,37,0,-37
4140,1,0,71,0,-71
4141,0,0,5,0,-5
4142,1,1,182,1261,1079
4143,0,0,48,0,-48
4144,1,0,136,0,-136
4145,0,0,70,0,-70
4146,0,0,122,0,-122
4147,1,0,5,0,-5
4148,0,0,102,0,-102
4149,0,0,13,0,-13
4150,1,1,645,1250,605
4151,0,0,79,0,-79
4152,0,0,5,0,-5
4153,1,1,658,1627,969
4154,1,0,138,0,-138
4155,1,1,25,1453,1428
4156,1,1,392,1285,893
4157,1,1,1203,1587,384
4158,0,0,2,0,-2
4159,1,1,52,1371,1319
4160,1,1,244,1208,964
4161,1,0,5,0,-5
4162,1,1,349,1503,1154
4163,1,1,109,1332,1223
4164,0,0,48,0,-48
4165,1,0,77,0,-77
4166,1,1,577,1212,635
4167,0,0,35,0,-35
4168,1,1,309,1451,1142
4169,0,0,6,0,-6
4170,1,0,11,0,-11
4171,1,1,636,3040,2404
4172,1,0,70,0,-70
4173,1,1,102,1361,1259
4174,0,0,32,0,-32
4175,1,0,3,0,-3
4176,1,0,116,0,-116
4177,0,0,25,0,-25
4178,1,0,108,0,-108
4179,1,0,63,0,-63
4180,1,1,260,1560,1300
4181,1,0,6,0,-6
4182,1,0,150,0,-150
4183,1,1,1256,1933,677
4184,0,0,15,0,-15
4185,0,0,1,0,-1
4186,0,0,10,0,-10
4187,1,1,1892,1399,-493
4188,1,0,73,0,-73
4189,0,0,1,0,-1
4190,1,1,612,1583,971
4191,1,0,15,0,-15
4192,1,0,21,0,-21
4193,1,1,1574,1229,-345
4194,1,1,126,1401,1275
4195,1,1,1098,1973,875
4196,1,0,0,0,0
4197,0,0,37,0,-37
4198,0,0,5,0,-5
4199,0,0,63,0,-63
4200,1,0,24,0,-24
4201,0,0,19,0,-19
4202,0,0,5,0,-5
4203,1,0,34,0,-34
4204,0,0,63,0,-63
4205,0,0,11,0,-11
4206,1,0,98,0,-98
4207,1,1,276,1434,1158
4208,1,0,55,0,-55
4209,1,1,678,1233,555
4210,0,0,127,0,-127
4211,1,1,252,1347,1095
4212,0,0,10,0,-10
4213,1,1,2266,1401,-865
4214,0,0,64,0,-64
4215,1,1,414,1215,801
4216,1,0,55,0,-55
4217,1,0,107,0,-107
4218,0,0,51,0,-51
4219,1,0,16,0,-16
4220,1,0,54,0,-54
4221,1,1,1161,1226,65
4222,0,0,61,0,-61
4223,1,1,366,1453,1087
4224,1,1,44,1394,1350
4225,0,0,31,0,-31
4226,0,0,68,0,-68
4227,1,0,12,0,-12
4228,0,0,12,0,-12
4229,1,0,16,0,-16
4230,0,0,13,0,-13
4231,1,1,45,1636,1591
4232,0,0,8,0,-8
4233,1,0,10,0,-10
4234,0,0,1,0,-1
4235,0,0,146,0,-146
4236,0,0,77,0,-77
4237,1,1,898,1661,763
4238,1,1,848,1258,410
4239,1,1,2756,1269,-1487
4240,0,0,22,0,-22
4241,0,0,17,0,-17
4242,0,0,20,0,-20
4243,1,1,292,1271,979
4244,0,0,30,0,-30
4245,1,0,33,0,-33
4246,0,0,178,0,-178
4247,1,1,682,1909,1227
4248,1,1,19,1237,1218
4249,1,0,3,0,-3
4250,0,0,23,0,-23
4251,0,0,20,0,-20
4252,1,0,60,0,-60
4253,1,0,53,0,-53
4254,0,0,121,0,-121
4255,1,1,169,1387,1218
4256,1,0,8,0,-8
4257,1,0,17,0,-17
4258,0,0,62,0,-62
4259,1,0,15,0,-15
4260,1,1,1220,1346,126
4261,0,0,12,0,-12
4262,1,0,39,0,-39
4263,1,1,1274,2399,1125
4264,0,0,8,0,-8
4265,1,0,19,0,-19
4266,1,1,654,1214,560
4267,1,1,225,1253,1028
4268,0,0,73,0,-73
4269,1,0,41,0,-41
4270,0,0,16,0,-16
4271,1,1,2256,1252,-1004
4272,1,1,1403,1968,565
4273,0,0,16,0,-16
4274,1,0,0,0,0
4275,0,0,68,0,-68
4276,1,1,786,1276,490
4277,1,1,735,1770,1035
4278,1,1,1102,1669,567
4279,1,1,352,1320,968
4280,0,0,138,0,-138
4281,0,0,146,0,-146
4282,1,1,110,1227,1117
4283,1,1,706,1219,513
4284,0,0,31,0,-31
4285,1,0,65,0,-65
4286,1,1,1298,1393,95
4287,0,0,23,0,-23
4288,0,0,8,0,-8
4289,1,0,10,0,-10
4290,1,0,102,0,-102
4291,1,1,405,1390,985
4292,0,0,15,0,-15
4293,0,0,0,0,0
4294,1,1,463,1728,1265
4295,0,0,39,0,-39
4296,0,0,36,0,-36
4297,1,1,239,1454,1215
4298,1,0,8,0,-8
4299,1,1,123,1386,1263
4300,1,0,48,0,-48
4301,0,0,127,0,-127
4302,1,0,134,0,-134
4303,0,0,43,0,-43
4304,1,0,9,0,-9
4305,0,0,17,0,-17
4306,1,0,32,0,-32
4307,0,0,1,0,-1
4308,1,1,223,1429,1206
4309,1,1,244,1880,1636
4310,1,1,84,1720,1636
4311,1,1,173,1248,1075
4312,1,0,12,0,-12
4313,1,0,17,0,-17
4314,1,0,68,0,-68
4315,0,0,21,0,-21
4316,1,1,933,2243,1310
4317,1,0,25,0,-25
4318,0,0,125,0,-125
4319,0,0,76,0,-76
4320,0,0,34,0,-34
4321,1,1,367,1721,1354
4322,0,0,177,0,-177
4323,1,0,20,0,-20
4324,1,0,109,0,-109
4325,1,0,30,0,-30
4326,1,0,7,0,-7
4327,0,0,50,0,-50
4328,0,0,12,0,-12
4329,1,1,278,1424,1146
4330,1,1,71,1813,1742
4331,1,1,264,1451,1187
4332,1,0,115,0,-115
4333,1,0,4,0,-4
4334,1,0,21,0,-21
4335,0,0,78,0,-78
4336,1,0,19,0,-19
4337,0,0,16,0,-16
4338,1,1,90,1579,1489
4339,0,0,14,0,-14
4340,1,0,25,0,-25
4341,1,1,823,1230,407
4342,1,0,72,0,-72
4343,0,0,100,0,-100
4344,1,0,26,0,-26
4345,0,0,30,0,-30
4346,0,0,43,0,-43
4347,1,0,13,0,-13
4348,1,0,0,0,0
4349,1,0,22,0,-22
4350,1,1,1289,1354,65
4351,1,1,602,1565,963
4352,0,0,7,0,-7
4353,0,0,25,0,-25
4354,0,0,24,0,-24
4355,0,0,165,0,-165
4356,1,1,400,1393,993
4357,1,1,77,1981,1904
4358,0,0,0,0,0
4359,1,1,606,1324,718
4360,1,0,13,0,-13
4361,0,0,130,0,-130
4362,0,0,30,0,-30
4363,1,0,35,0,-35
4364,1,0,41,0,-41
4365,1,1,231,1259,1028
4366,1,1,275,1201,926
4367,0,0,27,0,-27
4368,1,0,149,0,-149
4369,0,0,48,0,-48
4370,1,1,471,1302,831
4371,1,1,113,2074,1961
4372,0,0,89,0,-89
4373,0,0,40,0,-40
4374,0,0,15,0,-15
4375,1,0,82,0,-82
4376,0,0,7,0,-7
4377,1,1,154,1288,1134
4378,1,1,156,1420,1264
4379,0,0,83,0,-83
4380,1,1,1057,1487,430
4381,0,0,10,0,-10
4382,1,1,169,1215,1046
4383,0,0,9,0,-9
4384,0,0,4,0,-4
4385,1,1,228,1458,1230
4386,1,1,40,1275,1235
4387,1,0,16,0,-16
4388,1,0,15,0,-15
4389,1,1,109,1659,1550
4390,1,0,10,0,-10
4391,1,0,22,0,-22
4392,0,0,103,0,-103
4393,1,1,129,1967,1838
4394,1,1,285,1610,1325
4395,0,0,12,0,-12
4396,1,1,131,1317,1186
4397,0,0,26,0,-26
4398,0,0,22,0,-22
4399,1,0,0,0,0
4400,0,0,25,0,-25
4401,1,0,25,0,-25
4402,0,0,40,0,-40
4403,1,0,36,0,-36
4404,0,0,2,0,-2
4405,1,0,19,0,-19
4406,1,1,385,1289,904
4407,1,1,555,1487,932
4408,1,1,105,1343,1238
4409,1,0,29,0,-29
4410,0,0,61,0,-61
4411,1,0,99,0,-99
4412,1,0,98,0,-98
4413,0,0,20,0,-20
4414,0,0,87,0,-87
4415,0,0,33,0,-33
4416,1,0,157,0,-157
4417,0,0,47,0,-47
4418,1,0,125,0,-125
4419,1,1,258,1646,1388
4420,1,1,25,1352,1327
4421,1,0,98,0,-98
4422,0,0,28,0,-28
4423,1,1,109,1343,1234
4424,1,0,189,0,-189
4425,1,1,797,1247,450
4426,0,0,17,0,-17
4427,1,0,5,0,-5
4428,1,0,1,0,-1
4429,0,0,116,0,-116
4430,1,0,185,0,-185
4431,0,0,98,0,-98
4432,1,0,19,0,-19
4433,1,0,213,0,-213
4434,1,1,41,1669,1628
4435,0,0,143,0,-143
4436,0,0,0,0,0
4437,1,1,402,1539,1137
4438,0,0,9,0,-9
4439,1,0,3,0,-3
4440,1,0,72,0,-72
4441,1,1,370,1233,863
4442,1,1,170,1799,1629
4443,0,0,41,0,-41
4444,0,0,25,0,-25
4445,0,0,49,0,-49
4446,0,0,18,0,-18
4447,0,0,48,0,-48
4448,1,0,32,0,-32
4449,1,1,163,1676,1513
4450,1,1,1111,1781,670
4451,1,0,8,0,-8
4452,1,1,1094,1363,269
4453,1,0,10,0,-10
4454,0,0,1,0,-1
4455,0,0,15,0,-15
4456,0,0,90,0,-90
4457,0,0,61,0,-61
4458,0,0,149,0,-149
4459,0,0,5,0,-5
4460,1,1,246,1565,1319
4461,0,0,26,0,-26
4462,1,0,5,0,-5
4463,0,0,65,0,-65
4464,1,0,25,0,-25
4465,0,0,16,0,-16
4466,0,0,14,0,-14
4467,1,1,404,1227,823
4468,1,0,40,0,-40
4469,0,0,32,0,-32
4470,1,0,38,0,-38
4471,0,0,108,0,-108
4472,0,0,9,0,-9
4473,1,1,167,2013,1846
4474,1,1,99,1552,1453
4475,0,0,0,0,0
4476,0,0,29,0,-29
4477,1,0,49,0,-49
4478,0,0,64,0,-64
4479,1,0,13,0,-13
4480,0,0,9,0,-9
4481,1,1,1096,1444,348
4482,1,1,499,1389,890
4483,1,1,124,1565,1441
4484,1,0,22,0,-22
4485,0,0,61,0,-61
4486,1,0,112,0,-112
4487,0,0,35,0,-35
4488,1,0,14,0,-14
4489,0,0,15,0,-15
4490,1,1,192,1314,1122
4491,0,0,119,0,-119
4492,1,0,158,0,-158
4493,1,0,2,0,-2
4494,0,0,101,0,-101
4495,1,1,256,1211,955
4496,0,0,57,0,-57
4497,0,0,12,0,-12
4498,0,0,63,0,-63
4499,1,1,225,1332,1107
4500,0,0,176,0,-176
4501,0,0,49,0,-49
4502,0,0,62,0,-62
4503,1,0,29,0,-29
4504,1,0,86,0,-86
4505,1,0,8,0,-8
4506,0,0,48,0,-48
4507,1,0,97,0,-97
4508,1,1,138,1317,1179
4509,1,1,449,2141,1692
4510,1,0,79,0,-79
4511,1,1,49,1734,1685
4512,1,1,574,1245,671
4513,0,0,6,0,-6
4514,1,0,38,0,-38
4515,1,1,196,1275,1079
4516,1,1,507,1607,1100
4517,1,0,32,0,-32
4518,1,0,16,0,-16
4519,1,1,479,1735,1256
4520,0,0,97,0,-97
4521,1,0,46,0,-46
4522,0,0,66,0,-66
4523,1,1,1250,1354,104
4524,0,0,7,0,-7
4525,1,1,167,1335,1168
4526,1,0,6,0,-6
4527,0,0,7,0,-7
4528,0,0,5,0,-5
4529,1,0,81,0,-81
4530,1,0,60,0,-60
4531,1,1,202,1228,1026
4532,1,0,114,0,-114
4533,1,1,551,1464,913
4534,1,1,375,1819,1444
4535,1,0,28,0,-28
4536,1,1,378,1212,834
4537,1,1,200,1309,1109
4538,1,0,76,0,-76
4539,1,0,23,0,-23
4540,0,0,104,0,-104
4541,1,0,55,0,-55
4542,1,1,100,1209,1109
4543,1,0,0,0,0
4544,1,0,25,0,-25
4545,1,1,1379,2628,1249
4546,0,0,102,0,-102
4547,0,0,17,0,-17
4548,0,0,47,0,-47
4549,1,1,1201,1612,411
4550,0,0,127,0,-127
4551,0,0,47,0,-47
4552,1,1,692,1404,712
4553,1,0,60,0,-60
4554,1,1,667,1260,593
4555,0,0,60,0,-60
4556,0,0,27,0,-27
4557,0,0,147,0,-147
4558,1,1,1116,1269,153
4559,1,0,7,0,-7
4560,1,1,1103,1347,244
4561,0,0,26,0,-26
4562,1,1,374,1578,1204
4563,0,0,92,0,-92
4564,1,1,154,1257,1103
4565,1,0,11,0,-11
4566,1,1,181,1206,1025
4567,0,0,124,0,-124
4568,0,0,3,0,-3
4569,0,0,70,0,-70
4570,1,1,2408,1601,-807
4571,1,0,19,0,-19
4572,1,0,2,0,-2
4573,0,0,27,0,-27
4574,1,1,254,1452,1198
4575,0,0,63,0,-63
4576,1,0,105,0,-105
4577,1,0,61,0,-61
4578,1,1,20,1251,1231
4579,0,0,32,0,-32
4580,0,0,25,0,-25
4581,0,0,89,0,-89
4582,1,0,12,0,-12
4583,0,0,52,0,-52
4584,0,0,24,0,-24
4585,1,0,21,0,-21
4586,0,0,48,0,-48
4587,1,0,9,0,-9
4588,1,1,216,1242,1026
4589,0,0,4,0,-4
4590,1,0,20,0,-20
4591,1,1,443,3781,3338
4592,0,0,147,0,-147
4593,1,0,23,0,-23
4594,1,1,454,1267,813
4595,0,0,216,0,-216
4596,1,1,217,2058,1841
4597,1,0,2,0,-2
4598,0,0,10,0,-10
4599,0,0,17,0,-17
4600,1,0,71,0,-71
4601,1,1,104,1290,1186
4602,0,0,0,0,0
4603,0,0,10,0,-10
4604,0,0,69,0,-69
4605,1,0,19,0,-19
4606,0,0,33,0,-33
4607,1,0,54,0,-54
4608,0,0,1,0,-1
4609,1,0,17,0,-17
4610,0,0,88,0,-88
4611,0,0,77,0,-77
4612,1,0,41,0,-41
4613,0,0,1,0,-1
4614,0,0,105,0,-105
4615,0,0,17,0,-17
4616,0,0,39,0,-39
4617,1,1,20,1328,1308
4618,0,0,75,0,-75
4619,0,0,5,0,-5
4620,0,0,48,0,-48
4621,0,0,48,0,-48
4622,1,1,716,1766,1050
4623,1,0,6,0,-6
4624,1,0,8,0,-8
4625,1,1,482,1242,760
4626,1,0,61,0,-61
4627,1,1,110,1437,1327
4628,1,1,1634,1319,-315
4629,0,0,0,0,0
4630,1,0,10,0,-10
4631,1,1,227,1605,1378
4632,1,0,21,0,-21
4633,1,1,1464,1259,-205
4634,1,1,76,1304,1228
4635,1,1,1294,1288,-6
4636,1,1,2446,1716,-730
4637,1,0,27,0,-27
4638,1,0,3,0,-3
4639,1,0,56,0,-56
4640,0,0,3,0,-3
4641,0,0,293,0,-293
4642,0,0,26,0,-26
4643,1,1,344,1338,994
4644,1,1,482,1243,761
4645,0,0,18,0,-18
4646,1,0,10,0,-10
4647,1,1,772,1222,450
4648,0,0,27,0,-27
4649,0,0,19,0,-19
4650,1,0,20,0,-20
4651,1,1,70,2846,2776
4652,1,0,86,0,-86
4653,0,0,0,0,0
4654,0,0,100,0,-100
4655,1,0,129,0,-129
4656,1,0,81,0,-81
4657,0,0,5,0,-5
4658,0,0,7,0,-7
4659,0,0,24,0,-24
4660,1,1,204,2104,1900
4661,0,0,15,0,-15
4662,0,0,4,0,-4
4663,0,0,7,0,-7
4664,0,0,0,0,0
4665,1,0,19,0,-19
4666,1,0,16,0,-16
4667,1,1,339,1227,888
4668,1,0,9,0,-9
4669,1,1,139,1221,1082
4670,0,0,24,0,-24
4671,1,1,3049,1252,-1797
4672,1,1,240,1245,1005
4673,1,1,581,1390,809
4674,0,0,81,0,-81
4675,1,0,29,0,-29
4676,1,0,23,0,-23
4677,1,0,30,0,-30
4678,1,0,106,0,-106
4679,0,0,3,0,-3
4680,0,0,11,0,-11
4681,0,0,115,0,-115
4682,1,0,9,0,-9
4683,0,0,7,0,-7
4684,1,1,224,1406,1182
4685,0,0,82,0,-82
4686,1,1,628,1629,1001
4687,1,1,37,1768,1731
4688,1,0,19,0,-19
4689,1,1,108,1217,1109
4690,1,0,27,0,-27
4691,0,0,97,0,-97
4692,0,0,8,0,-8
4693,0,0,148,0,-148
4694,1,1,496,1811,1315
4695,1,0,10,0,-10
4696,0,0,29,0,-29
4697,0,0,39,0,-39
4698,0,0,106,0,-106
4699,1,1,412,1265,853
4700,1,1,472,1441,969
4701,0,0,14,0,-14
4702,1,1,564,1255,691
4703,1,1,355,1476,1121
4704,1,1,2692,1449,-1243
4705,1,0,21,0,-21
4706,1,1,393,1490,1097
4707,0,0,80,0,-80
4708,1,1,800,1585,785
4709,1,0,7,0,-7
4710,1,0,32,0,-32
4711,1,1,488,1590,1102
4712,1,1,645,1725,1080
4713,0,0,6,0,-6
4714,1,1,947,2159,1212
4715,1,0,94,0,-94
4716,0,0,10,0,-10
4717,0,0,12,0,-12
4718,0,0,72,0,-72
4719,1,1,405,1459,1054
4720,1,0,53,0,-53
4721,1,1,278,1491,1213
4722,0,0,7,0,-7
4723,0,0,9,0,-9
4724,1,0,143,0,-143
4725,0,0,65,0,-65
4726,1,1,273,1532,1259
4727,0,0,41,0,-41
4728,0,0,47,0,-47
4729,0,0,19,0,-19
4730,0,0,102,0,-102
4731,0,0,24,0,-24
4732,1,0,28,0,-28
4733,1,0,50,0,-50
4734,1,1,835,1315,480
4735,0,0,27,0,-27
4736,1,0,15,0,-15
4737,1,0,11,0,-11
4738,0,0,54,0,-54
4739,1,0,18,0,-18
4740,0,0,15,0,-15
4741,1,0,18,0,-18
4742,1,1,706,1466,760
4743,0,0,59,0,-59
4744,0,0,204,0,-204
4745,1,1,132,1233,1101
4746,0,0,22,0,-22
4747,1,0,18,0,-18
4748,1,0,65,0,-65
4749,0,0,3,0,-3
4750,1,1,428,1208,780
4751,1,0,52,0,-52
4752,1,1,224,1322,1098
4753,1,0,35,0,-35
4754,0,0,110,0,-110
4755,0,0,3,0,-3
4756,0,0,22,0,-22
4757,1,1,1507,1538,31
4758,1,1,822,1471,649
4759,1,0,30,0,-30
4760,0,0,0,0,0
4761,0,0,43,0,-43
4762,0,0,38,0,-38
4763,0,0,148,0,-148
4764,0,0,98,0,-98
4765,1,0,66,0,-66
4766,1,0,9,0,-9
4767,0,0,34,0,-34
4768,0,0,24,0,-24
4769,0,0,54,0,-54
4770,1,1,805,1582,777
4771,0,0,180,0,-180
4772,1,1,236,1373,1137
4773,0,0,12,0,-12
4774,0,0,52,0,-52
4775,0,0,112,0,-112
4776,1,0,83,0,-83
4777,1,0,10,0,-10
4778,0,0,29,0,-29
4779,1,1,1797,3587,1790
4780,0,0,38,0,-38
4781,1,1,85,1259,1174
4782,1,1,1569,1911,342
4783,1,1,133,2300,2167
4784,1,0,269,0,-269
4785,0,0,54,0,-54
4786,0,0,130,0,-130
4787,0,0,30,0,-30
4788,0,0,13,0,-13
4789,1,0,18,0,-18
4790,0,0,49,0,-49
4791,1,1,1181,1280,99
4792,1,1,430,1238,808
4793,1,0,167,0,-167
4794,0,0,35,0,-35
4795,0,0,13,0,-13
4796,0,0,34,0,-34
4797,0,0,33,0,-33
4798,0,0,174,0,-174
4799,0,0,9,0,-9
4800,1,1,1390,1398,8
4801,0,0,72,0,-72
4802,1,1,206,1236,1030
4803,1,0,4,0,-4
4804,1,0,213,0,-213
4805,1,1,785,1246,461
4806,1,1,362,2300,1938
4807,1,1,474,1332,858
4808,1,0,12,0,-12
4809,1,0,14,0,-14
4810,0,0,131,0,-131
4811,0,0,20,0,-20
4812,1,1,52,1774,1722
4813,1,1,492,1512,1020
4814,1,0,52,0,-52
4815,0,0,10,0,-10
4816,1,0,3,0,-3
4817,1,0,44,0,-44
4818,0,0,88,0,-88
4819,0,0,89,0,-89
4820,0,0,47,0,-47
4821,0,0,0,0,0
4822,1,0,47,0,-47
4823,1,1,461,1556,1095
4824,1,0,38,0,-38
4825,1,0,75,0,-75
4826,1,1,503,1228,725
4827,1,1,156,1410,1254
4828,1,0,276,0,-276
4829,0,0,0,0,0
4830,0,0,37,0,-37
4831,1,1,1353,2856,1503
4832,1,1,77,1450,1373
4833,0,0,16,0,-16
4834,1,1,1902,1500,-402
4835,0,0,19,0,-19
4836,1,1,725,1438,713
4837,0,0,40,0,-40
4838,1,0,53,0,-53
4839,1,0,24,0,-24
4840,1,1,596,1854,1258
4841,1,1,487,1372,885
4842,0,0,32,0,-32
4843,0,0,55,0,-55
4844,0,0,96,0,-96
4845,1,1,1266,1416,150
4846,1,1,960,1458,498
4847,1,1,452,1620,1168
4848,1,1,310,1763,1453
4849,0,0,80,0,-80
4850,1,0,8,0,-8
4851,1,0,57,0,-57
4852,1,1,772,2111,1339
4853,1,1,73,1281,1208
4854,0,0,27,0,-27
4855,0,0,104,0,-104
4856,0,0,82,0,-82
4857,1,1,750,1758,1008
4858,0,0,59,0,-59
4859,1,1,371,2210,1839
4860,1,0,1,0,-1
4861,0,0,45,0,-45
4862,1,0,43,0,-43
4863,1,1,331,2582,2251
4864,1,0,47,0,-47
4865,1,1,589,2624,2035
4866,1,0,99,0,-99
4867,0,0,65,0,-65
4868,1,0,35,0,-35
4869,1,0,70,0,-70
4870,0,0,50,0,-50
4871,1,0,17,0,-17
4872,0,0,6,0,-6
4873,0,0,9,0,-9
4874,1,1,174,1272,1098
4875,1,1,295,1484,1189
4876,1,0,11,0,-11
4877,1,0,17,0,-17
4878,0,0,25,0,-25
4879,1,0,37,0,-37
4880,1,0,39,0,-39
4881,1,1,890,1504,614
4882,1,1,283,1480,1197
4883,1,1,36,1521,1485
4884,1,1,609,1299,690
4885,0,0,63,0,-63
4886,1,0,19,0,-19
4887,1,1,241,1757,1516
4888,0,0,34,0,-34
4889,1,0,32,0,-32
4890,0,0,36,0,-36
4891,0,0,30,0,-30
4892,1,0,10,0,-10
4893,1,1,26,1342,1316
4894,1,0,17,0,-17
4895,1,1,197,1365,1168
4896,1,0,2,0,-2
4897,1,1,40,1493,1453
4898,0,0,13,0,-13
4899,1,0,13,0,-13
4900,1,1,145,1333,1188
4901,1,1,84,1227,1143
4902,1,0,165,0,-165
4903,1,0,57,0,-57
4904,0,0,49,0,-49
4905,1,0,179,0,-179
4906,0,0,55,0,-55
4907,1,1,864,1207,343
4908,1,0,131,0,-131
4909,0,0,132,0,-132
4910,1,0,117,0,-117
4911,1,0,97,0,-97
4912,1,0,75,0,-75
4913,1,0,32,0,-32
4914,1,1,573,1267,694
4915,0,0,25,0,-25
4916,0,0,57,0,-57
4917,0,0,36,0,-36
4918,1,0,33,0,-33
4919,0,0,64,0,-64
4920,0,0,42,0,-42
4921,0,0,15,0,-15
4922,1,1,500,1208,708
4923,1,0,103,0,-103
4924,0,0,26,0,-26
4925,0,0,6,0,-6
4926,1,0,7,0,-7
4927,0,0,31,0,-31
4928,1,0,0,0,0
4929,0,0,46,0,-46
4930,1,0,10,0,-10
4931,0,0,31,0,-31
4932,0,0,239,0,-239
4933,1,1,367,1414,1047
4934,0,0,245,0,-245
4935,0,0,32,0,-32
4936,1,1,430,1293,863
4937,0,0,66,0,-66
4938,0,0,54,0,-54
4939,1,1,379,1863,1484
4940,1,0,43,0,-43
4941,1,0,36,0,-36
4942,1,0,25,0,-25
4943,1,1,84,2580,2496
4944,1,1,225,1266,1041
4945,1,0,12,0,-12
4946,0,0,2,0,-2
4947,1,0,71,0,-71
4948,1,1,583,1862,1279
4949,1,1,429,1817,1388
4950,1,0,24,0,-24
4951,1,0,56,0,-56
4952,0,0,29,0,-29
4953,0,0,25,0,-25
4954,1,1,624,1244,620
4955,0,0,1,0,-1
4956,1,1,253,2371,2118
4957,1,0,7,0,-7
4958,0,0,46,0,-46
4959,1,0,49,0,-49
4960,1,1,608,1247,639
4961,1,1,513,1504,991
4962,1,1,398,1204,806
4963,1,1,115,1791,1676
4964,1,0,32,0,-32
4965,1,0,67,0,-67
4966,1,1,454,1735,1281
4967,0,0,62,0,-62
4968,1,0,20,0,-20
4969,1,0,191,0,-191
4970,0,0,27,0,-27
4971,1,0,20,0,-20
4972,1,1,434,1937,1503
4973,1,1,577,1921,1344
4974,1,0,58,0,-58
4975,0,0,40,0,-40
4976,0,0,81,0,-81
4977,1,0,177,0,-177
4978,1,0,0,0,0
4979,0,0,27,0,-27
4980,1,0,9,0,-9
4981,0,0,166,0,-166
4982,1,0,81,0,-81
4983,0,0,72,0,-72
4984,1,0,40,0,-40
4985,0,0,28,0,-28
4986,1,1,434,1207,773
4987,1,1,300,1307,1007
4988,0,0,37,0,-37
4989,1,1,1359,1311,-48
4990,1,1,1231,1580,349
4991,1,1,709,1383,674
4992,0,0,58,0,-58
4993,0,0,46,0,-46
4994,1,0,63,0,-63
4995,1,0,3,0,-3
4996,1,0,8,0,-8
4997,1,1,407,1336,929
4998,0,0,161,0,-161
4999,0,0,104,0,-104
5000,1,0,42,0,-42
5001,1,1,127,1307,1180
5002,0,0,59,0,-59
5003,0,0,146,0,-146
5004,1,0,4,0,-4
5005,0,0,14,0,-14
5006,1,1,623,1792,1169
5007,0,0,9,0,-9
5008,0,0,105,0,-105
5009,0,0,96,0,-96
5010,1,1,316,1225,909
5011,1,0,75,0,-75
5012,0,0,7,0,-7
5013,0,0,86,0,-86
5014,1,0,40,0,-40
5015,0,0,89,0,-89
5016,0,0,13,0,-13
5017,0,0,79,0,-79
5018,0,0,68,0,-68
5019,1,1,365,1513,1148
5020,1,0,5,0,-5
5021,0,0,2,0,-2
5022,0,0,46,0,-46
5023,0,0,48,0,-48
5024,1,1,989,1206,217
5025,0,0,35,0,-35
5026,1,0,72,0,-72
5027,1,1,437,3657,3220
5028,0,0,99,0,-99
5029,1,1,239,1473,1234
5030,1,1,161,1233,1072
5031,0,0,3,0,-3
5032,1,1,814,1268,454
5033,0,0,171,0,-171
5034,1,1,745,1260,515
5035,0,0,26,0,-26
5036,1,1,641,1243,602
5037,1,0,75,0,-75
5038,1,1,549,1637,1088
5039,1,0,3,0,-3
5040,1,1,711,1473,762
5041,1,1,598,1296,698
5042,0,0,37,0,-37
5043,0,0,14,0,-14
5044,1,0,3,0,-3
5045,0,0,43,0,-43
5046,1,0,18,0,-18
5047,0,0,1,0,-1
5048,1,1,366,1758,1392
5049,1,0,40,0,-40
5050,1,0,1,0,-1
5051,1,1,126,1991,1865
5052,0,0,68,0,-68
5053,0,0,48,0,-48
5054,1,0,4,0,-4
5055,0,0,107,0,-107
5056,0,0,16,0,-16
5057,0,0,175,0,-175
5058,1,1,264,3220,2956
5059,1,0,1,0,-1
5060,1,0,50,0,-50
5061,0,0,116,0,-116
5062,1,1,992,1445,453
5063,1,0,64,0,-64
5064,1,1,101,2442,2341
5065,0,0,62,0,-62
5066,1,1,520,1823,1303
5067,0,0,22,0,-22
5068,1,1,347,1293,946
5069,1,1,168,1323,1155
5070,1,1,1167,1417,250
5071,0,0,11,0,-11
5072,1,1,262,1771,1509
5073,1,0,6,0,-6
5074,1,0,66,0,-66
5075,0,0,34,0,-34
5076,1,0,102,0,-102
5077,1,1,815,1613,798
5078,0,0,109,0,-109
5079,0,0,6,0,-6
5080,0,0,0,0,0
5081,1,0,1,0,-1
5082,1,0,133,0,-133
5083,0,0,32,0,-32
5084,1,0,5,0,-5
5085,1,1,276,1859,1583
5086,1,1,640,1282,642
5087,1,0,4,0,-4
5088,0,0,27,0,-27
5089,0,0,55,0,-55
5090,0,0,23,0,-23
5091,1,1,191,1869,1678
5092,0,0,8,0,-8
5093,1,0,162,0,-162
5094,1,1,763,1205,442
5095,0,0,87,0,-87
5096,1,0,30,0,-30
5097,0,0,18,0,-18
5098,0,0,73,0,-73
5099,1,1,270,1742,1472
5100,0,0,105,0,-105
5101,1,0,78,0,-78
5102,1,1,470,1228,758
5103,1,1,236,1568,1332
5104,1,1,379,1200,821
5105,1,1,1005,1218,213
5106,1,1,1068,1378,310
5107,1,0,126,0,-126
5108,1,0,83,0,-83
5109,1,0,50,0,-50
5110,0,0,25,0,-25
5111,1,1,793,1429,636
5112,0,0,114,0,-114
5113,0,0,87,0,-87
5114,1,1,2123,2147,24
5115,0,0,9,0,-9
5116,0,0,54,0,-54
5117,1,0,3,0,-3
5118,0,0,50,0,-50
5119,0,0,2,0,-2
5120,1,0,145,0,-145
5121,1,0,42,0,-42
5122,1,1,231,1285,1054
5123,1,1,465,1847,1382
5124,0,0,81,0,-81
5125,0,0,3,0,-3
5126,1,0,11,0,-11
5127,0,0,5,0,-5
5128,1,0,23,0,-23
5129,1,0,39,0,-39
5130,1,0,15,0,-15
5131,1,0,69,0,-69
5132,0,0,31,0,-31
5133,1,0,42,0,-42
5134,0,0,90,0,-90
5135,1,1,196,1653,1457
5136,1,1,1515,1457,-58
5137,1,0,3,0,-3
5138,1,0,42,0,-42
5139,1,1,477,1227,750
5140,1,1,833,1215,382
5141,0,0,50,0,-50
5142,0,0,0,0,0
5143,1,1,558,1290,732
5144,1,1,291,1370,1079
5145,1,1,265,1468,1203
5146,1,0,63,0,-63
5147,1,0,84,0,-84
5148,0,0,235,0,-235
5149,0,0,44,0,-44
5150,0,0,71,0,-71
5151,1,0,71,0,-71
5152,1,1,507,1618,1111
5153,1,0,2,0,-2
5154,0,0,1,0,-1
5155,0,0,43,0,-43
5156,0,0,92,0,-92
5157,1,1,349,1483,1134
5158,1,0,48,0,-48
5159,1,1,540,1271,731
5160,1,0,137,0,-137
5161,1,1,807,3002,2195
5162,1,0,50,0,-50
5163,1,1,675,1374,699
5164,1,0,47,0,-47
5165,1,0,173,0,-173
5166,1,1,160,1752,1592
5167,0,0,82,0,-82
5168,1,1,1709,1325,-384
5169,0,0,50,0,-50
5170,0,0,70,0,-70
5171,1,0,17,0,-17
5172,0,0,10,0,-10
5173,1,1,179,1597,1418
5174,1,1,362,1546,1184
5175,0,0,54,0,-54
5176,0,0,33,0,-33
5177,1,1,335,1283,948
5178,0,0,23,0,-23
5179,0,0,35,0,-35
5180,1,1,291,1783,1492
5181,1,0,3,0,-3
5182,0,0,7,0,-7
5183,0,0,59,0,-59
5184,1,1,105,1304,1199
5185,0,0,114,0,-114
5186,0,0,85,0,-85
5187,1,0,26,0,-26
5188,1,0,56,0,-56
5189,1,1,21,1280,1259
5190,1,1,57,1417,1360
5191,1,0,29,0,-29
5192,0,0,45,0,-45
5193,1,0,42,0,-42
5194,1,0,6,0,-6
5195,1,0,23,0,-23
5196,0,0,29,0,-29
5197,0,0,28,0,-28
5198,0,0,192,0,-192
5199,0,0,51,0,-51
5200,0,0,60,0,-60
5201,1,1,1133,2399,1266
5202,0,0,78,0,-78
5203,1,0,28,0,-28
5204,1,1,112,1769,1657
5205,1,0,7,0,-7
5206,1,0,82,0,-82
5207,1,0,4,0,-4
5208,0,0,23,0,-23
5209,0,0,7,0,-7
5210,0,0,71,0,-71
5211,0,0,85,0,-85
5212,1,0,2,0,-2
5213,1,0,128,0,-128
5214,1,1,337,1308,971
5215,1,1,840,1287,447
5216,1,0,15,0,-15
5217,1,0,74,0,-74
5218,1,0,2,0,-2
5219,1,0,28,0,-28
5220,1,1,97,1637,1540
5221,1,1,493,1316,823
5222,1,1,640,1571,931
5223,1,0,20,0,-20
5224,1,0,135,0,-135
5225,1,0,24,0,-24
5226,1,1,238,1429,1191
5227,1,0,28,0,-28
5228,1,1,73,1427,1354
5229,1,1,197,1241,1044
5230,1,1,1927,1253,-674
5231,1,1,597,6916,6319
5232,1,0,28,0,-28
5233,1,1,648,1335,687
5234,1,1,732,1626,894
5235,0,0,65,0,-65
5236,0,0,15,0,-15
5237,1,0,88,0,-88
5238,1,0,15,0,-15
5239,0,0,13,0,-13
5240,1,0,82,0,-82
5241,1,1,617,1399,782
5242,1,1,1087,1443,356
5243,1,1,1307,1296,-11
5244,1,1,508,1364,856
5245,1,0,7,0,-7
5246,1,0,17,0,-17
5247,1,0,0,0,0
5248,0,0,7,0,-7
5249,1,1,279,2011,1732
5250,1,1,875,1284,409
5251,0,0,42,0,-42
5252,1,0,24,0,-24
5253,0,0,37,0,-37
5254,1,0,2,0,-2
5255,1,0,87,0,-87
5256,1,1,755,1215,460
5257,1,1,334,1212,878
5258,1,1,794,1358,564
5259,0,0,5,0,-5
5260,0,0,24,0,-24
5261,1,1,462,1386,924
5262,1,0,41,0,-41
5263,1,1,1630,1259,-371
5264,1,1,1635,1905,270
5265,0,0,53,0,-53
5266,1,1,1944,1337,-607
5267,1,0,51,0,-51
5268,1,1,345,1281,936
5269,0,0,21,0,-21
5270,0,0,19,0,-19
5271,0,0,77,0,-77
5272,0,0,43,0,-43
5273,0,0,52,0,-52
5274,0,0,293,0,-293
5275,1,1,345,1547,1202
5276,1,1,423,1297,874
5277,1,1,171,1275,1104
5278,1,1,861,1763,902
5279,1,0,111,0,-111
5280,0,0,9,0,-9
5281,0,0,1,0,-1
5282,1,1,74,1818,1744
5283,1,0,47,0,-47
5284,1,1,485,1758,1273
5285,0,0,91,0,-91
5286,1,0,34,0,-34
5287,1,0,88,0,-88
5288,1,1,991,1567,576
5289,1,0,38,0,-38
5290,1,0,37,0,-37
5291,1,0,9,0,-9
5292,0,0,5,0,-5
5293,0,0,13,0,-13
5294,1,1,37,1393,1356
5295,1,0,82,0,-82
5296,1,0,95,0,-95
5297,1,1,240,1650,1410
5298,0,0,2,0,-2
5299,0,0,39,0,-39
5300,0,0,8,0,-8
5301,1,1,33,1347,1314
5302,1,0,76,0,-76
5303,0,0,18,0,-18
5304,0,0,161,0,-161
5305,0,0,53,0,-53
5306,0,0,72,0,-72
5307,0,0,4,0,-4
5308,0,0,10,0,-10
5309,0,0,25,0,-25
5310,0,0,8,0,-8
5311,0,0,23,0,-23
5312,1,0,48,0,-48
5313,1,0,11,0,-11
5314,1,1,494,1455,961
5315,1,1,927,1367,440
5316,1,0,44,0,-44
5317,0,0,29,0,-29
5318,1,0,77,0,-77
5319,1,1,1150,1258,108
5320,1,0,37,0,-37
5321,1,0,6,0,-6
5322,1,1,822,1246,424
5323,1,0,108,0,-108
5324,1,0,29,0,-29
5325,0,0,9,0,-9
5326,0,0,3,0,-3
5327,0,0,133,0,-133
5328,1,0,104,0,-104
5329,1,1,500,1700,1200
5330,1,0,19,0,-19
5331,1,1,1198,1296,98
5332,1,0,62,0,-62
5333,1,0,65,0,-65
5334,1,1,474,1250,776
5335,0,0,3,0,-3
5336,1,1,130,1323,1193
5337,1,0,40,0,-40
5338,1,1,388,2053,1665
5339,0,0,64,0,-64
5340,1,0,42,0,-42
5341,1,0,83,0,-83
5342,0,0,35,0,-35
5343,0,0,15,0,-15
5344,1,1,171,1249,1078
5345,1,0,15,0,-15
5346,0,0,74,0,-74
5347,0,0,4,0,-4
5348,0,0,62,0,-62
5349,0,0,207,0,-207
5350,1,0,29,0,-29
5351,0,0,7,0,-7
5352,0,0,44,0,-44
5353,1,0,50,0,-50
5354,0,0,76,0,-76
5355,1,0,80,0,-80
5356,1,0,80,0,-80
5357,1,1,403,2340,1937
5358,1,1,161,1313,1152
5359,1,1,436,1267,831
5360,1,1,773,1550,777
5361,1,0,68,0,-68
5362,1,0,0,0,0
5363,1,1,171,1697,1526
5364,1,1,544,1616,1072
5365,1,0,46,0,-46
5366,1,0,107,0,-107
5367,0,0,85,0,-85
5368,1,0,89,0,-89
5369,0,0,90,0,-90
5370,1,1,614,1291,677
5371,0,0,55,0,-55
5372,0,0,103,0,-103
5373,1,0,10,0,-10
5374,0,0,32,0,-32
5375,1,0,336,0,-336
5376,1,1,93,4089,3996
5377,0,0,1,0,-1
5378,1,0,58,0,-58
5379,1,0,70,0,-70
5380,1,1,168,1208,1040
5381,0,0,85,0,-85
5382,0,0,5,0,-5
5383,1,1,511,1475,964
5384,1,1,527,1482,955
5385,1,1,1058,1251,193
5386,0,0,20,0,-20
5387,0,0,22,0,-22
5388,0,0,29,0,-29
5389,1,1,947,1877,930
5390,1,1,607,2501,1894
5391,0,0,6,0,-6
5392,1,1,1220,1333,113
5393,1,1,397,1202,805
5394,0,0,41,0,-41
5395,1,0,13,0,-13
5396,0,0,102,0,-102
5397,1,0,25,0,-25
5398,1,1,1169,1300,131
5399,1,1,178,1839,1661
5400,1,0,83,0,-83
5401,0,0,106,0,-106
5402,0,0,68,0,-68
5403,1,0,26,0,-26
5404,0,0,32,0,-32
5405,0,0,4,0,-4
5406,1,0,23,0,-23
5407,0,0,11,0,-11
5408,0,0,25,0,-25
5409,1,1,367,1549,1182
5410,0,0,33,0,-33
5411,1,1,652,1276,624
5412,1,0,41,0,-41
5413,1,0,157,0,-157
5414,1,1,800,1969,1169
5415,0,0,190,0,-190
5416,1,0,20,0,-20
5417,1,1,447,1433,986
5418,0,0,9,0,-9
5419,0,0,19,0,-19
5420,1,1,329,2190,1861
5421,1,0,56,0,-56
5422,1,1,357,2144,1787
5423,0,0,172,0,-172
5424,1,1,406,1357,951
5425,1,1,232,1329,1097
5426,0,0,23,0,-23
5427,0,0,40,0,-40
5428,1,1,361,1591,1230
5429,1,1,896,1887,991
5430,1,1,954,1247,293
5431,0,0,0,0,0
5432,0,0,69,0,-69
5433,0,0,6,0,-6
5434,0,0,48,0,-48
5435,0,0,17,0,-17
5436,0,0,18,0,-18
5437,0,0,71,0,-71
5438,1,0,74,0,-74
5439,0,0,19,0,-19
5440,0,0,0,0,0
5441,0,0,67,0,-67
5442,1,0,58,0,-58
5443,0,0,42,0,-42
5444,1,0,143,0,-143
5445,1,0,146,0,-146
5446,1,0,6,0,-6
5447,1,1,91,1467,1376
5448,0,0,16,0,-16
5449,0,0,26,0,-26
5450,1,0,48,0,-48
5451,0,0,3,0,-3
5452,1,1,290,2651,2361
5453,1,1,223,1910,1687
5454,0,0,15,0,-15
5455,0,0,63,0,-63
5456,1,1,84,1317,1233
5457,1,0,34,0,-34
5458,1,1,2063,1554,-509
5459,1,1,481,2047,1566
5460,0,0,2,0,-2
5461,1,1,1902,2027,125
5462,1,1,359,1683,1324
5463,0,0,85,0,-85
5464,1,1,246,1931,1685
5465,1,0,0,0,0
5466,1,0,13,0,-13
5467,0,0,55,0,-55
5468,0,0,4,0,-4
5469,1,1,1174,1243,69
5470,1,1,605,1456,851
5471,1,1,179,1282,1103
5472,1,0,10,0,-10
5473,0,0,18,0,-18
5474,1,1,1054,1467,413
5475,1,1,881,1337,456
5476,1,0,3,0,-3
5477,1,0,20,0,-20
5478,0,0,2,0,-2
5479,1,1,607,1211,604
5480,1,0,100,0,-100
5481,1,0,18,0,-18
5482,1,1,276,1417,1141
5483,1,1,181,1328,1147
5484,1,1,381,1202,821
5485,0,0,45,0,-45
5486,0,0,48,0,-48
5487,0,0,8,0,-8
5488,0,0,37,0,-37
5489,1,1,548,1303,755
5490,1,0,17,0,-17
5491,0,0,37,0,-37
5492,1,0,82,0,-82
5493,1,1,440,1406,966
5494,1,0,20,0,-20
5495,0,0,1,0,-1
5496,1,1,1069,1296,227
5497,0,0,11,0,-11
5498,1,0,70,0,-70
5499,0,0,4,0,-4
5500,0,0,10,0,-10
5501,1,0,42,0,-42
5502,0,0,9,0,-9
5503,0,0,66,0,-66
5504,1,0,0,0,0
5505,0,0,14,0,-14
5506,0,0,16,0,-16
5507,1,1,300,1409,1109
5508,1,1,181,1257,1076
5509,0,0,37,0,-37
5510,1,1,40,1320,1280
5511,0,0,32,0,-32
5512,1,1,191,1212,1021
5513,1,1,277,1307,1030
5514,0,0,77,0,-77
5515,1,1,1266,1807,541
5516,1,1,2279,1201,-1078
5517,0,0,44,0,-44
5518,0,0,7,0,-7
5519,0,0,45,0,-45
5520,1,1,2080,1238,-842
5521,1,1,72,1233,1161
5522,1,0,30,0,-30
5523,0,0,9,0,-9
5524,1,0,14,0,-14
5525,0,0,8,0,-8
5526,1,1,126,1298,1172
5527,1,1,615,1387,772
5528,0,0,157,0,-157
5529,0,0,6,0,-6
5530,0,0,121,0,-121
5531,1,0,57,0,-57
5532,0,0,12,0,-12
5533,1,0,90,0,-90
5534,0,0,23,0,-23
5535,1,1,252,1553,1301
5536,0,0,7,0,-7
5537,1,1,217,1613,1396
5538,0,0,18,0,-18
5539,0,0,40,0,-40
5540,1,0,47,0,-47
5541,1,0,35,0,-35
5542,1,1,757,1570,813
5543,1,0,20,0,-20
5544,0,0,77,0,-77
5545,0,0,18,0,-18
5546,1,0,3,0,-3
5547,0,0,137,0,-137
5548,0,0,30,0,-30
5549,0,0,175,0,-175
5550,0,0,31,0,-31
5551,0,0,53,0,-53
5552,0,0,13,0,-13
5553,1,0,19,0,-19
5554,0,0,86,0,-86
5555,1,0,0,0,0
5556,0,0,37,0,-37
5557,0,0,23,0,-23
5558,1,1,945,1604,659
5559,0,0,9,0,-9
5560,0,0,54,0,-54
5561,1,0,11,0,-11
5562,0,0,84,0,-84
5563,0,0,43,0,-43
5564,1,0,21,0,-21
5565,1,0,31,0,-31
5566,1,1,977,1222,245
5567,1,0,118,0,-118
5568,1,0,160,0,-160
5569,1,0,36,0,-36
5570,1,0,73,0,-73
5571,1,0,71,0,-71
5572,1,1,483,1250,767
5573,1,1,717,1452,735
5574,1,0,56,0,-56
5575,0,0,30,0,-30
5576,0,0,22,0,-22
5577,0,0,16,0,-16
5578,0,0,97,0,-97
5579,0,0,33,0,-33
5580,1,1,605,1200,595
5581,0,0,35,0,-35
5582,0,0,81,0,-81
5583,1,0,23,0,-23
5584,1,1,165,1726,1561
5585,1,1,638,1422,784
5586,1,0,20,0,-20
5587,1,1,1521,2039,518
5588,0,0,221,0,-221
5589,1,1,47,1322,1275
5590,1,1,835,2136,1301
5591,1,1,567,1253,686
5592,1,1,388,1529,1141
5593,0,0,22,0,-22
5594,1,1,157,2188,2031
5595,1,0,42,0,-42
5596,0,0,89,0,-89
5597,1,1,697,1253,556
5598,0,0,15,0,-15
5599,1,1,283,1277,994
5600,0,0,84,0,-84
5601,1,1,758,1554,796
5602,0,0,4,0,-4
5603,0,0,73,0,-73
5604,1,1,200,1540,1340
5605,1,0,32,0,-32
5606,0,0,45,0,-45
5607,1,1,262,1304,1042
5608,1,1,144,1664,1520
5609,1,1,268,1360,1092
5610,1,0,1,0,-1
5611,1,0,60,0,-60
5612,1,1,306,1383,1077
5613,1,0,25,0,-25
5614,1,0,27,0,-27
5615,0,0,5,0,-5
5616,1,1,52,2051,1999
5617,1,1,617,1239,622
5618,1,1,417,1283,866
5619,1,1,1792,1309,-483
5620,0,0,38,0,-38
5621,1,1,196,1418,1222
5622,1,1,205,1212,1007
5623,1,0,64,0,-64
5624,1,0,5,0,-5
5625,1,0,70,0,-70
5626,0,0,52,0,-52
5627,0,0,16,0,-16
5628,0,0,4,0,-4
5629,1,0,4,0,-4
5630,1,0,113,0,-113
5631,0,0,1,0,-1
5632,0,0,33,0,-33
5633,1,0,30,0,-30
5634,1,1,903,1266,363
5635,1,1,516,1411,895
5636,1,1,503,1768,1265
5637,1,1,954,1260,306
5638,1,1,1068,2083,1015
5639,1,0,12,0,-12
5640,0,0,32,0,-32
5641,1,1,198,1526,1328
5642,0,0,46,0,-46
5643,0,0,37,0,-37
5644,0,0,45,0,-45
5645,0,0,20,0,-20
5646,0,0,43,0,-43
5647,1,1,797,1265,468
5648,1,1,1211,1649,438
5649,1,1,350,1236,886
5650,1,0,69,0,-69
5651,0,0,42,0,-42
5652,1,0,27,0,-27
5653,1,1,196,1257,1061
5654,1,0,18,0,-18
5655,1,1,398,2101,1703
5656,1,1,242,1239,997
5657,1,1,344,1318,974
5658,0,0,2,0,-2
5659,0,0,13,0,-13
5660,1,1,631,1657,1026
5661,1,0,79,0,-79
5662,1,1,257,2606,2349
5663,1,0,99,0,-99
5664,0,0,89,0,-89
5665,0,0,3,0,-3
5666,0,0,51,0,-51
5667,0,0,4,0,-4
5668,0,0,17,0,-17
5669,0,0,59,0,-59
5670,0,0,19,0,-19
5671,1,1,290,1385,1095
5672,0,0,21,0,-21
5673,0,0,0,0,0
5674,1,1,153,1464,1311
5675,1,1,67,1416,1349
5676,1,0,70,0,-70
5677,1,1,831,1345,514
5678,1,0,69,0,-69
5679,1,0,5,0,-5
5680,1,0,7,0,-7
5681,0,0,3,0,-3
5682,1,1,552,1705,1153
5683,1,0,20,0,-20
5684,1,1,1151,1596,445
5685,0,0,35,0,-35
5686,1,1,187,2466,2279
5687,1,0,16,0,-16
5688,0,0,47,0,-47
5689,1,0,9,0,-9
5690,0,0,19,0,-19
5691,0,0,1,0,-1
5692,0,0,28,0,-28
5693,0,0,34,0,-34
5694,1,0,189,0,-189
5695,0,0,14,0,-14
5696,0,0,30,0,-30
5697,1,0,58,0,-58
5698,0,0,30,0,-30
5699,1,0,63,0,-63
5700,1,0,98,0,-98
5701,1,1,155,1403,1248
5702,1,0,69,0,-69
5703,1,1,721,1431,710
5704,1,0,69,0,-69
5705,1,0,11,0,-11
5706,0,0,73,0,-73
5707,1,0,62,0,-62
5708,1,1,284,1336,1052
5709,1,0,3,0,-3
5710,1,1,719,1217,498
5711,1,1,646,1330,684
5712,1,1,502,1220,718
5713,1,0,128,0,-128
5714,0,0,102,0,-102
5715,1,0,8,0,-8
5716,0,0,87,0,-87
5717,0,0,12,0,-12
5718,1,1,529,3043,2514
5719,1,0,93,0,-93
5720,0,0,36,0,-36
5721,1,1,285,1296,1011
5722,1,1,1533,1237,-296
5723,0,0,99,0,-99
5724,1,1,1550,1363,-187
5725,1,1,1492,1341,-151
5726,1,1,768,2249,1481
5727,1,1,808,1220,412
5728,1,1,143,1545,1402
5729,1,0,62,0,-62
5730,1,1,754,1399,645
5731,0,0,32,0,-32
5732,0,0,139,0,-139
5733,0,0,72,0,-72
5734,1,1,2593,1534,-1059
5735,0,0,4,0,-4
5736,1,1,430,1466,1036
5737,0,0,35,0,-35
5738,1,0,43,0,-43
5739,1,0,72,0,-72
5740,1,1,752,1397,645
5741,0,0,2,0,-2
5742,0,0,167,0,-167
5743,0,0,50,0,-50
5744,1,1,590,2048,1458
5745,1,0,22,0,-22
5746,0,0,7,0,-7
5747,1,1,1148,1248,100
5748,1,1,953,1380,427
5749,1,1,57,2099,2042
5750,1,1,399,1509,1110
5751,0,0,12,0,-12
5752,1,0,95,0,-95
5753,1,0,62,0,-62
5754,0,0,72,0,-72
5755,0,0,2,0,-2
5756,1,0,24,0,-24
5757,1,0,41,0,-41
5758,0,0,0,0,0
5759,1,0,22,0,-22
5760,1,1,579,1694,1115
5761,1,0,9,0,-9
5762,1,0,3,0,-3
5763,0,0,91,0,-91
5764,1,1,48,4219,4171
5765,0,0,55,0,-55
5766,1,0,139,0,-139
5767,1,1,445,1290,845
5768,1,0,13,0,-13
5769,0,0,78,0,-78
5770,1,1,83,1406,1323
5771,0,0,5,0,-5
5772,0,0,29,0,-29
5773,0,0,9,0,-9
5774,0,0,203,0,-203
5775,1,0,11,0,-11
5776,1,0,23,0,-23
5777,1,1,1760,1490,-270
5778,0,0,22,0,-22
5779,1,0,43,0,-43
5780,0,0,49,0,-49
5781,1,1,374,1433,1059
5782,1,1,470,4371,3901
5783,0,0,26,0,-26
5784,1,1,1879,1709,-170
5785,0,0,49,0,-49
5786,1,1,386,1307,921
5787,1,0,102,0,-102
5788,0,0,114,0,-114
5789,1,1,1989,1418,-571
5790,0,0,124,0,-124
5791,0,0,29,0,-29
5792,1,0,27,0,-27
5793,0,0,22,0,-22
5794,1,1,34,1905,1871
5795,1,0,53,0,-53
5796,0,0,32,0,-32
5797,1,1,115,1650,1535
5798,0,0,52,0,-52
5799,1,1,875,1431,556
5800,1,0,17,0,-17
5801,0,0,86,0,-86
5802,1,1,21,1750,1729
5803,0,0,6,0,-6
5804,1,0,65,0,-65
5805,0,0,32,0,-32
5806,1,0,50,0,-50
5807,0,0,2,0,-2
5808,1,0,54,0,-54
5809,1,1,48,1214,1166
5810,1,0,65,0,-65
5811,1,0,110,0,-110
5812,1,1,1852,1477,-375
5813,0,0,10,0,-10
5814,0,0,68,0,-68
5815,1,1,1125,1635,510
5816,0,0,113,0,-113
5817,1,0,16,0,-16
5818,0,0,69,0,-69
5819,1,0,53,0,-53
5820,1,1,691,1331,640
5821,1,0,23,0,-23
5822,1,0,144,0,-144
5823,0,0,201,0,-201
5824,1,1,997,2089,1092
5825,1,1,495,1770,1275
5826,0,0,25,0,-25
5827,1,1,56,1523,1467
5828,0,0,45,0,-45
5829,0,0,8,0,-8
5830,1,0,105,0,-105
5831,0,0,7,0,-7
5832,1,0,14,0,-14
5833,0,0,36,0,-36
5834,1,0,28,0,-28
5835,1,0,52,0,-52
5836,1,0,22,0,-22
5837,1,0,38,0,-38
5838,1,1,81,1474,1393
5839,1,1,49,1969,1920
5840,1,1,731,1246,515
5841,1,0,57,0,-57
5842,0,0,37,0,-37
5843,0,0,26,0,-26
5844,1,0,56,0,-56
5845,1,1,202,2119,1917
5846,0,0,1,0,-1
5847,0,0,3,0,-3
5848,0,0,104,0,-104
5849,1,0,136,0,-136
5850,0,0,68,0,-68
5851,1,1,142,2005,1863
5852,1,0,17,0,-17
5853,0,0,85,0,-85
5854,1,1,104,2295,2191
5855,1,1,1026,2885,1859
5856,1,1,245,1599,1354
5857,1,0,12,0,-12
5858,0,0,223,0,-223
5859,1,1,1724,1395,-329
5860,0,0,23,0,-23
5861,0,0,4,0,-4
5862,1,0,46,0,-46
5863,0,0,28,0,-28
5864,1,1,29,1669,1640
5865,1,0,33,0,-33
5866,1,0,0,0,0
5867,1,0,122,0,-122
5868,1,0,114,0,-114
5869,0,0,142,0,-142
5870,0,0,192,0,-192
5871,1,1,430,1271,841
5872,1,0,24,0,-24
5873,0,0,34,0,-34
5874,0,0,22,0,-22
5875,0,0,101,0,-101
5876,1,1,1532,1659,127
5877,0,0,88,0,-88
5878,0,0,8,0,-8
5879,1,0,108,0,-108
5880,0,0,21,0,-21
5881,1,0,8,0,-8
5882,1,0,20,0,-20
5883,0,0,72,0,-72
5884,1,0,61,0,-61
5885,1,0,0,0,0
5886,1,1,2596,1458,-1138
5887,1,1,35,1248,1213
5888,1,0,20,0,-20
5889,0,0,11,0,-11
5890,0,0,95,0,-95
5891,1,1,722,1711,989
5892,1,1,336,1380,1044
5893,1,1,972,1258,286
5894,1,1,193,2313,2120
5895,0,0,103,0,-103
5896,0,0,6,0,-6
5897,0,0,15,0,-15
5898,1,1,1835,1320,-515
5899,1,0,313,0,-313
5900,1,0,60,0,-60
5901,0,0,155,0,-155
5902,1,1,863,1255,392
5903,0,0,42,0,-42
5904,0,0,25,0,-25
5905,0,0,17,0,-17
5906,1,1,711,1915,1204
5907,1,1,78,1588,1510
5908,0,0,73,0,-73
5909,1,1,848,1477,629
5910,1,0,17,0,-17
5911,1,0,22,0,-22
5912,1,0,4,0,-4
5913,0,0,97,0,-97
5914,1,1,1077,1204,127
5915,1,0,59,0,-59
5916,1,0,33,0,-33
5917,1,1,513,1467,954
5918,1,0,13,0,-13
5919,1,0,106,0,-106
5920,0,0,46,0,-46
5921,1,0,15,0,-15
5922,1,0,25,0,-25
5923,1,0,56,0,-56
5924,1,1,315,2139,1824
5925,0,0,55,0,-55
5926,0,0,45,0,-45
5927,1,1,170,1599,1429
5928,1,0,113,0,-113
5929,0,0,19,0,-19
5930,1,0,148,0,-148
5931,0,0,57,0,-57
5932,0,0,38,0,-38
5933,0,0,111,0,-111
5934,1,0,97,0,-97
5935,0,0,27,0,-27
5936,1,1,381,1929,1548
5937,1,0,29,0,-29
5938,0,0,62,0,-62
5939,0,0,6,0,-6
5940,1,1,57,1310,1253
5941,0,0,14,0,-14
5942,0,0,89,0,-89
5943,1,0,32,0,-32
5944,0,0,14,0,-14
5945,1,1,226,1607,1381
5946,1,1,681,1300,619
5947,1,1,220,1328,1108
5948,1,0,36,0,-36
5949,0,0,0,0,0
5950,1,1,634,6363,5729
5951,0,0,7,0,-7
5952,1,1,169,1236,1067
5953,0,0,48,0,-48
5954,0,0,98,0,-98
5955,1,1,566,1479,913
5956,0,0,37,0,-37
5957,1,0,72,0,-72
5958,1,1,199,1422,1223
5959,1,1,937,1268,331
5960,1,0,48,0,-48
5961,1,1,301,1285,984
5962,0,0,96,0,-96
5963,0,0,88,0,-88
5964,1,1,584,2344,1760
5965,0,0,37,0,-37
5966,1,0,63,0,-63
5967,0,0,103,0,-103
5968,1,0,57,0,-57
5969,1,1,50,1484,1434
5970,1,1,1177,3188,2011
5971,1,1,406,1205,799
5972,1,0,150,0,-150
5973,1,0,29,0,-29
5974,0,0,61,0,-61
5975,1,1,587,1325,738
5976,0,0,55,0,-55
5977,1,1,699,1692,993
5978,1,1,257,1521,1264
5979,0,0,24,0,-24
5980,1,0,16,0,-16
5981,0,0,36,0,-36
5982,0,0,43,0,-43
5983,0,0,55,0,-55
5984,1,1,4,1588,1584
5985,0,0,29,0,-29
5986,0,0,46,0,-46
5987,0,0,44,0,-44
5988,1,0,38,0,-38
5989,1,0,110,0,-110
5990,0,0,31,0,-31
5991,0,0,93,0,-93
5992,1,1,528,1528,1000
5993,1,1,1042,2830,1788
5994,1,0,2,0,-2
5995,1,0,56,0,-56
5996,0,0,19,0,-19
5997,1,1,186,1253,1067
5998,1,0,136,0,-136
5999,0,0,61,0,-61
6000,1,0,83,0,-83
6001,1,1,85,1258,1173
6002,1,0,41,0,-41
6003,1,1,271,1322,1051
6004,0,0,37,0,-37
6005,1,0,130,0,-130
6006,0,0,59,0,-59
6007,1,0,37,0,-37
6008,0,0,79,0,-79
6009,0,0,36,0,-36
6010,1,1,135,1265,1130
6011,1,1,601,1533,932
6012,0,0,0,0,0
6013,0,0,140,0,-140
6014,1,0,7,0,-7
6015,1,1,661,1239,578
6016,1,0,22,0,-22
6017,0,0,84,0,-84
6018,0,0,78,0,-78
6019,0,0,15,0,-15
6020,0,0,25,0,-25
6021,1,0,73,0,-73
6022,0,0,37,0,-37
6023,1,0,44,0,-44
6024,0,0,51,0,-51
6025,0,0,52,0,-52
6026,1,1,499,1235,736
6027,1,1,87,2331,2244
6028,0,0,24,0,-24
6029,1,1,1622,1203,-419
6030,0,0,61,0,-61
6031,0,0,6,0,-6
6032,1,0,4,0,-4
6033,1,1,971,1327,356
6034,0,0,71,0,-71
6035,0,0,43,0,-43
6036,0,0,13,0,-13
6037,0,0,4,0,-4
6038,1,0,119,0,-119
6039,1,1,420,1680,1260
6040,1,1,1339,1993,654
6041,1,0,85,0,-85
6042,1,0,224,0,-224
6043,0,0,43,0,-43
6044,0,0,0,0,0
6045,0,0,34,0,-34
6046,0,0,10,0,-10
6047,0,0,114,0,-114
6048,1,1,340,1399,1059
6049,0,0,28,0,-28
6050,0,0,73,0,-73
6051,1,0,25,0,-25
6052,0,0,15,0,-15
6053,0,0,77,0,-77
6054,1,0,20,0,-20
6055,0,0,9,0,-9
6056,0,0,117,0,-117
6057,1,0,0,0,0
6058,1,1,1297,1401,104
6059,1,0,30,0,-30
6060,0,0,9,0,-9
6061,1,0,27,0,-27
6062,1,1,341,1834,1493
6063,1,0,84,0,-84
6064,1,0,2,0,-2
6065,0,0,88,0,-88
6066,1,0,23,0,-23
6067,0,0,49,0,-49
6068,1,1,47,1516,1469
6069,1,1,693,1250,557
6070,1,1,98,1675,1577
6071,0,0,51,0,-51
6072,1,1,222,1415,1193
6073,0,0,34,0,-34
6074,1,0,108,0,-108
6075,1,0,82,0,-82
6076,0,0,63,0,-63
6077,1,0,29,0,-29
6078,1,0,7,0,-7
6079,1,0,15,0,-15
6080,1,1,641,1265,624
6081,0,0,33,0,-33
6082,1,0,4,0,-4
6083,0,0,10,0,-10
6084,1,0,137,0,-137
6085,1,0,8,0,-8
6086,1,1,595,1399,804
6087,1,0,5,0,-5
6088,1,1,1580,1339,-241
6089,1,0,85,0,-85
6090,1,0,38,0,-38
6091,1,1,235,2049,1814
6092,1,0,61,0,-61
6093,1,0,35,0,-35
6094,0,0,145,0,-145
6095,1,0,12,0,-12
6096,1,1,471,1466,995
6097,0,0,110,0,-110
6098,1,0,126,0,-126
6099,0,0,14,0,-14
6100,1,1,238,1377,1139
6101,0,0,101,0,-101
6102,0,0,80,0,-80
6103,1,0,8,0,-8
6104,1,1,504,1819,1315
6105,0,0,37,0,-37
6106,0,0,70,0,-70
6107,0,0,13,0,-13
6108,1,0,1,0,-1
6109,0,0,14,0,-14
6110,0,0,30,0,-30
6111,0,0,262,0,-262
6112,1,1,689,1883,1194
6113,1,0,51,0,-51
6114,0,0,62,0,-62
6115,0,0,26,0,-26
6116,0,0,55,0,-55
6117,1,0,6,0,-6
6118,0,0,37,0,-37
6119,0,0,14,0,-14
6120,1,1,496,2278,1782
6121,0,0,19,0,-19
6122,0,0,202,0,-202
6123,1,1,852,1233,381
6124,1,0,26,0,-26
6125,1,1,149,1220,1071
6126,1,1,115,1553,1438
6127,1,0,35,0,-35
6128,1,0,0,0,0
6129,1,1,325,1381,1056
6130,0,0,25,0,-25
6131,0,0,63,0,-63
6132,1,0,4,0,-4
6133,1,0,8,0,-8
6134,0,0,85,0,-85
6135,1,1,397,1397,1000
6136,0,0,52,0,-52
6137,1,0,123,0,-123
6138,1,0,3,0,-3
6139,0,0,19,0,-19
6140,1,1,277,1250,973
6141,0,0,165,0,-165
6142,0,0,54,0,-54
6143,0,0,46,0,-46
6144,1,1,342,1273,931
6145,0,0,61,0,-61
6146,1,0,66,0,-66
6147,0,0,25,0,-25
6148,1,1,1083,1209,126
6149,0,0,19,0,-19
6150,1,1,161,2169,2008
6151,1,1,137,1283,1146
6152,0,0,7,0,-7
6153,0,0,23,0,-23
6154,1,1,389,1337,948
6155,1,0,1,0,-1
6156,1,1,169,1478,1309
6157,1,1,121,1967,1846
6158,1,0,12,0,-12
6159,1,0,0,0,0
6160,0,0,16,0,-16
6161,0,0,36,0,-36
6162,1,1,566,1967,1401
6163,0,0,47,0,-47
6164,1,0,30,0,-30
6165,1,1,43,1414,1371
6166,1,0,14,0,-14
6167,0,0,44,0,-44
6168,1,0,100,0,-100
6169,1,0,27,0,-27
6170,0,0,99,0,-99
6171,1,0,84,0,-84
6172,0,0,36,0,-36
6173,0,0,46,0,-46
6174,1,0,26,0,-26
6175,1,0,30,0,-30
6176,0,0,22,0,-22
6177,1,1,94,1339,1245
6178,0,0,11,0,-11
6179,1,0,28,0,-28
6180,0,0,45,0,-45
6181,1,1,585,1661,1076
6182,1,0,65,0,-65
6183,1,1,215,1789,1574
6184,0,0,20,0,-20
6185,0,0,55,0,-55
6186,1,1,471,1655,1184
6187,0,0,68,0,-68
6188,1,0,31,0,-31
6189,1,0,11,0,-11
6190,1,1,162,1341,1179
6191,1,1,1215,4488,3273
6192,1,1,1197,1334,137
6193,1,1,730,1567,837
6194,1,0,203,0,-203
6195,1,1,655,1932,1277
6196,1,0,9,0,-9
6197,1,1,346,1400,1054
6198,1,1,978,1234,256
6199,1,0,49,0,-49
6200,1,0,20,0,-20
6201,1,0,24,0,-24
6202,0,0,86,0,-86
6203,1,1,141,1627,1486
6204,0,0,78,0,-78
6205,0,0,51,0,-51
6206,0,0,31,0,-31
6207,1,0,67,0,-67
6208,1,0,29,0,-29
6209,0,0,25,0,-25
6210,1,0,189,0,-189
6211,0,0,31,0,-31
6212,0,0,11,0,-11
6213,0,0,51,0,-51
6214,1,0,1,0,-1
6215,1,1,541,1584,1043
6216,1,0,2,0,-2
6217,1,0,28,0,-28
6218,1,1,136,1424,1288
6219,0,0,62,0,-62
6220,1,0,109,0,-109
6221,1,1,1157,2266,1109
6222,0,0,50,0,-50
6223,1,0,30,0,-30
6224,1,0,74,0,-74
6225,0,0,28,0,-28
6226,0,0,56,0,-56
6227,0,0,36,0,-36
6228,0,0,32,0,-32
6229,0,0,100,0,-100
6230,1,0,4,0,-4
6231,0,0,9,0,-9
6232,0,0,79,0,-79
6233,1,0,13,0,-13
6234,1,0,13,0,-13
6235,1,0,42,0,-42
6236,1,1,368,1686,1318
6237,1,0,51,0,-51
6238,0,0,26,0,-26
6239,0,0,10,0,-10
6240,1,1,259,1201,942
6241,1,1,53,1245,1192
6242,0,0,2,0,-2
6243,0,0,1,0,-1
6244,1,1,273,1277,1004
6245,1,0,27,0,-27
6246,0,0,126,0,-126
6247,0,0,55,0,-55
6248,1,1,549,1795,1246
6249,1,0,24,0,-24
6250,1,1,1306,1582,276
6251,1,0,1,0,-1
6252,1,1,294,1941,1647
6253,1,1,176,1449,1273
6254,0,0,74,0,-74
6255,0,0,134,0,-134
6256,1,1,570,1986,1416
6257,0,0,34,0,-34
6258,0,0,26,0,-26
6259,1,0,3,0,-3
6260,0,0,214,0,-214
6261,1,1,134,1281,1147
6262,1,0,33,0,-33
6263,1,1,239,1446,1207
6264,1,1,26,1352,1326
6265,0,0,19,0,-19
6266,1,1,1048,1760,712
6267,0,0,5,0,-5
6268,1,1,1045,1329,284
6269,1,1,205,1405,1200
6270,1,0,36,0,-36
6271,1,1,437,3879,3442
6272,1,0,67,0,-67
6273,1,1,398,1266,868
6274,0,0,26,0,-26
6275,0,0,1,0,-1
6276,0,0,59,0,-59
6277,0,0,6,0,-6
6278,1,1,284,1224,940
6279,1,1,590,2176,1586
6280,1,0,27,0,-27
6281,0,0,0,0,0
6282,0,0,19,0,-19
6283,1,1,111,1225,1114
6284,1,0,44,0,-44
6285,0,0,50,0,-50
6286,0,0,25,0,-25
6287,1,1,1457,1364,-93
6288,0,0,44,0,-44
6289,0,0,3,0,-3
6290,0,0,6,0,-6
6291,1,0,1,0,-1
6292,1,1,679,1358,679
6293,1,0,25,0,-25
6294,0,0,223,0,-223
6295,1,1,409,1333,924
6296,1,1,1472,1431,-41
6297,1,0,4,0,-4
6298,1,0,120,0,-120
6299,1,1,1175,2801,1626
6300,0,0,5,0,-5
6301,0,0,31,0,-31
6302,0,0,126,0,-126
6303,0,0,44,0,-44
6304,0,0,82,0,-82
6305,1,0,37,0,-37
6306,1,0,110,0,-110
6307,0,0,4,0,-4
6308,1,0,74,0,-74
6309,0,0,97,0,-97
6310,0,0,81,0,-81
6311,0,0,33,0,-33
6312,0,0,35,0,-35
6313,0,0,22,0,-22
6314,1,0,13,0,-13
6315,1,1,99,1321,1222
6316,1,1,540,1732,1192
6317,1,1,153,1481,1328
6318,1,1,941,1428,487
6319,1,1,846,1367,521
6320,0,0,18,0,-18
6321,1,1,130,1494,1364
6322,1,1,750,4160,3410
6323,1,1,64,1354,1290
6324,1,0,23,0,-23
6325,1,1,785,1395,610
6326,1,0,18,0,-18
6327,0,0,103,0,-103
6328,1,0,98,0,-98
6329,0,0,12,0,-12
6330,0,0,2,0,-2
6331,0,0,86,0,-86
6332,1,1,153,1250,1097
6333,1,1,953,1248,295
6334,1,1,1636,3592,1956
6335,0,0,70,0,-70
6336,0,0,39,0,-39
6337,0,0,12,0,-12
6338,1,1,560,1446,886
6339,1,1,411,1450,1039
6340,1,1,1095,1628,533
6341,0,0,191,0,-191
6342,1,1,41,4947,4906
6343,1,1,509,1318,809
6344,0,0,2,0,-2
6345,1,1,226,1776,1550
6346,1,0,73,0,-73
6347,0,0,299,0,-299
6348,0,0,4,0,-4
6349,1,1,126,1531,1405
6350,0,0,30,0,-30
6351,1,0,72,0,-72
6352,1,0,60,0,-60
6353,0,0,92,0,-92
6354,0,0,51,0,-51
6355,1,1,212,1433,1221
6356,1,0,106,0,-106
6357,1,0,6,0,-6
6358,1,0,55,0,-55
6359,0,0,21,0,-21
6360,0,0,131,0,-131
6361,0,0,95,0,-95
6362,0,0,61,0,-61
6363,1,1,424,2169,1745
6364,1,1,535,1404,869
6365,1,0,4,0,-4
6366,1,1,217,2915,2698
6367,0,0,43,0,-43
6368,1,1,464,1692,1228
6369,1,0,99,0,-99
6370,1,1,164,1680,1516
6371,0,0,4,0,-4
6372,1,0,26,0,-26
6373,0,0,15,0,-15
6374,1,1,92,1737,1645
6375,1,0,37,0,-37
6376,0,0,171,0,-171
6377,1,1,178,1689,1511
6378,1,0,2,0,-2
6379,1,0,3,0,-3
6380,0,0,44,0,-44
6381,1,0,28,0,-28
6382,1,1,637,2100,1463
6383,1,0,101,0,-101
6384,1,0,4,0,-4
6385,0,0,4,0,-4
6386,0,0,81,0,-81
6387,1,1,110,1676,1566
6388,1,0,196,0,-196
6389,1,0,0,0,0
6390,0,0,28,0,-28
6391,0,0,0,0,0
6392,1,1,23,1249,1226
6393,0,0,54,0,-54
6394,0,0,139,0,-139
6395,1,1,81,2176,2095
6396,0,0,14,0,-14
6397,1,1,428,1307,879
6398,0,0,235,0,-235
6399,0,0,40,0,-40
6400,1,0,20,0,-20
6401,1,0,138,0,-138
6402,1,0,54,0,-54
6403,1,0,93,0,-93
6404,1,0,22,0,-22
6405,1,0,30,0,-30
6406,0,0,42,0,-42
6407,0,0,49,0,-49
6408,1,0,45,0,-45
6409,1,0,17,0,-17
6410,1,0,27,0,-27
6411,0,0,169,0,-169
6412,1,0,71,0,-71
6413,0,0,37,0,-37
6414,1,0,49,0,-49
6415,0,0,12,0,-12
6416,1,1,766,1835,1069
6417,1,0,75,0,-75
6418,1,1,298,1557,1259
6419,1,1,1071,1237,166
6420,1,0,52,0,-52
6421,1,0,90,0,-90
6422,1,1,728,1271,543
6423,1,1,45,1504,1459
6424,1,0,0,0,0
6425,1,1,883,1408,525
6426,1,0,18,0,-18
6427,1,1,315,1495,1180
6428,0,0,36,0,-36
6429,1,0,152,0,-152
6430,1,1,272,1307,1035
6431,0,0,32,0,-32
6432,0,0,41,0,-41
6433,1,0,39,0,-39
6434,1,1,52,1318,1266
6435,1,1,91,1352,1261
6436,1,0,153,0,-153
6437,0,0,26,0,-26
6438,1,0,6,0,-6
6439,0,0,48,0,-48
6440,1,0,77,0,-77
6441,1,0,37,0,-37
6442,1,1,136,1276,1140
6443,0,0,49,0,-49
6444,1,1,450,1418,968
6445,1,0,54,0,-54
6446,0,0,173,0,-173
6447,1,0,8,0,-8
6448,0,0,128,0,-128
6449,0,0,7,0,-7
6450,1,1,452,1384,932
6451,0,0,7,0,-7
6452,0,0,17,0,-17
6453,1,1,256,1401,1145
6454,1,0,66,0,-66
6455,1,1,408,1236,828
6456,0,0,3,0,-3
6457,1,0,10,0,-10
6458,1,1,1655,2899,1244
6459,0,0,14,0,-14
6460,1,1,717,1207,490
6461,1,0,10,0,-10
6462,1,0,8,0,-8
6463,1,1,2292,1826,-466
6464,1,1,203,1278,1075
6465,1,1,50,1240,1190
6466,1,0,33,0,-33
6467,1,1,304,1692,1388
6468,0,0,1,0,-1
6469,0,0,4,0,-4
6470,1,0,24,0,-24
6471,0,0,42,0,-42
6472,1,0,111,0,-111
6473,1,0,4,0,-4
6474,0,0,2,0,-2
6475,0,0,204,0,-204
6476,1,1,291,1555,1264
6477,0,0,6,0,-6
6478,1,1,130,2101,1971
6479,0,0,33,0,-33
6480,1,0,41,0,-41
6481,0,0,100,0,-100
6482,1,0,85,0,-85
6483,0,0,37,0,-37
6484,0,0,1,0,-1
6485,1,0,105,0,-105
6486,0,0,37,0,-37
6487,1,0,0,0,0
6488,0,0,3,0,-3
6489,1,0,4,0,-4
6490,0,0,44,0,-44
6491,0,0,133,0,-133
6492,0,0,11,0,-11
6493,1,1,325,1337,1012
6494,0,0,12,0,-12
6495,1,1,1219,1370,151
6496,0,0,66,0,-66
6497,0,0,117,0,-117
6498,1,0,15,0,-15
6499,1,1,1178,1218,40
6500,1,1,1092,1534,442
6501,1,1,571,3957,3386
6502,0,0,113,0,-113
6503,0,0,75,0,-75
6504,1,1,102,2066,1964
6505,1,0,30,0,-30
6506,1,1,560,1238,678
6507,1,1,524,1237,713
6508,0,0,117,0,-117
6509,0,0,17,0,-17
6510,1,0,56,0,-56
6511,1,0,70,0,-70
6512,0,0,1,0,-1
6513,0,0,32,0,-32
6514,0,0,19,0,-19
6515,1,0,53,0,-53
6516,1,0,7,0,-7
6517,1,0,19,0,-19
6518,0,0,91,0,-91
6519,0,0,1,0,-1
6520,1,1,201,1217,1016
6521,1,1,587,1709,1122
6522,0,0,23,0,-23
6523,1,0,25,0,-25
6524,1,0,3,0,-3
6525,0,0,49,0,-49
6526,1,0,6,0,-6
6527,0,0,51,0,-51
6528,0,0,54,0,-54
6529,0,0,5,0,-5
6530,1,1,472,1309,837
6531,1,1,319,1974,1655
6532,1,1,281,1209,928
6533,1,0,9,0,-9
6534,1,1,448,3043,2595
6535,0,0,42,0,-42
6536,1,0,6,0,-6
6537,1,0,6,0,-6
6538,1,0,60,0,-60
6539,1,1,181,1550,1369
6540,0,0,110,0,-110
6541,1,0,44,0,-44
6542,1,0,39,0,-39
6543,0,0,77,0,-77
6544,0,0,160,0,-160
6545,0,0,1,0,-1
6546,1,0,260,0,-260
6547,0,0,225,0,-225
6548,0,0,81,0,-81
6549,0,0,179,0,-179
6550,1,1,489,1206,717
6551,1,0,5,0,-5
6552,0,0,1,0,-1
6553,1,1,506,1884,1378
6554,0,0,195,0,-195
6555,1,0,2,0,-2
6556,0,0,273,0,-273
6557,0,0,33,0,-33
6558,1,0,6,0,-6
6559,1,0,26,0,-26
6560,0,0,130,0,-130
6561,1,0,86,0,-86
6562,1,0,14,0,-14
6563,1,0,20,0,-20
6564,0,0,100,0,-100
6565,0,0,48,0,-48
6566,1,1,340,1363,1023
6567,1,1,1499,1596,97
6568,0,0,11,0,-11
6569,1,1,411,2128,1717
6570,0,0,39,0,-39
6571,1,1,1743,1831,88
6572,0,0,24,0,-24
6573,0,0,17,0,-17
6574,1,0,1,0,-1
6575,1,1,1154,1498,344
6576,1,0,15,0,-15
6577,1,1,1265,1666,401
6578,1,0,104,0,-104
6579,1,1,268,1970,1702
6580,1,1,815,1333,518
6581,0,0,122,0,-122
6582,1,0,2,0,-2
6583,1,1,22,2617,2595
6584,1,0,72,0,-72
6585,1,1,83,3546,3463
6586,1,1,801,1364,563
6587,0,0,65,0,-65
6588,0,0,67,0,-67
6589,0,0,27,0,-27
6590,0,0,62,0,-62
6591,0,0,10,0,-10
6592,0,0,95,0,-95
6593,0,0,31,0,-31
6594,1,1,583,2259,1676
6595,1,1,375,1348,973
6596,1,0,15,0,-15
6597,1,1,563,1366,803
6598,1,0,25,0,-25
6599,0,0,46,0,-46
6600,0,0,7,0,-7
6601,0,0,24,0,-24
6602,0,0,71,0,-71
6603,1,0,51,0,-51
6604,1,0,88,0,-88
6605,1,0,18,0,-18
6606,1,0,4,0,-4
6607,1,1,883,1240,357
6608,1,0,81,0,-81
6609,1,0,41,0,-41
6610,0,0,5,0,-5
6611,1,0,50,0,-50
6612,0,0,18,0,-18
6613,0,0,41,0,-41
6614,1,1,648,1250,602
6615,1,1,294,1715,1421
6616,1,1,243,1389,1146
6617,1,1,789,1445,656
6618,1,0,128,0,-128
6619,0,0,151,0,-151
6620,1,0,113,0,-113
6621,1,0,33,0,-33
6622,1,1,442,3860,3418
6623,0,0,36,0,-36
6624,1,1,77,1330,1253
6625,0,0,23,0,-23
6626,0,0,23,0,-23
6627,1,0,4,0,-4
6628,1,1,1178,1407,229
6629,1,0,67,0,-67
6630,0,0,54,0,-54
6631,1,1,156,1295,1139
6632,1,1,442,1323,881
6633,1,1,94,1735,1641
6634,1,0,4,0,-4
6635,0,0,11,0,-11
6636,0,0,13,0,-13
6637,1,1,204,1405,1201
6638,0,0,21,0,-21
6639,1,0,24,0,-24
6640,0,0,57,0,-57
6641,1,0,28,0,-28
6642,1,1,342,1283,941
6643,0,0,63,0,-63
6644,0,0,126,0,-126
6645,1,0,154,0,-154
6646,1,1,123,1224,1101
6647,1,0,21,0,-21
6648,1,0,7,0,-7
6649,1,1,32,1313,1281
6650,1,0,20,0,-20
6651,1,1,357,1214,857
6652,1,0,35,0,-35
6653,0,0,7,0,-7
6654,0,0,4,0,-4
6655,1,0,26,0,-26
6656,1,0,10,0,-10
6657,1,1,518,1244,726
6658,1,0,66,0,-66
6659,0,0,78,0,-78
6660,1,0,42,0,-42
6661,1,1,73,1348,1275
6662,0,0,377,0,-377
6663,1,0,27,0,-27
6664,1,1,868,1314,446
6665,0,0,31,0,-31
6666,1,0,1,0,-1
6667,0,0,10,0,-10
6668,0,0,26,0,-26
6669,1,0,25,0,-25
6670,0,0,10,0,-10
6671,0,0,14,0,-14
6672,0,0,0,0,0
6673,1,0,23,0,-23
6674,0,0,5,0,-5
6675,1,0,7,0,-7
6676,0,0,9,0,-9
6677,1,1,108,1925,1817
6678,1,1,420,1574,1154
6679,1,0,14,0,-14
6680,0,0,102,0,-102
6681,1,0,16,0,-16
6682,0,0,55,0,-55
6683,1,0,7,0,-7
6684,1,1,22,1285,1263
6685,1,1,770,1239,469
6686,1,0,31,0,-31
6687,1,1,141,1983,1842
6688,1,1,1101,1577,476
6689,1,1,516,1945,1429
6690,1,1,186,1531,1345
6691,1,1,880,1347,467
6692,1,0,37,0,-37
6693,1,0,121,0,-121
6694,1,0,59,0,-59
6695,1,0,100,0,-100
6696,1,1,380,1283,903
6697,0,0,75,0,-75
6698,1,1,61,1427,1366
6699,1,0,41,0,-41
6700,0,0,0,0,0
6701,1,1,161,1604,1443
6702,1,0,64,0,-64
6703,0,0,7,0,-7
6704,1,0,6,0,-6
6705,0,0,115,0,-115
6706,1,0,15,0,-15
6707,1,0,6,0,-6
6708,0,0,0,0,0
6709,1,0,49,0,-49
6710,1,1,318,1459,1141
6711,0,0,124,0,-124
6712,0,0,70,0,-70
6713,1,0,46,0,-46
6714,1,1,51,1545,1494
6715,0,0,3,0,-3
6716,1,0,76,0,-76
6717,1,0,48,0,-48
6718,1,0,33,0,-33
6719,0,0,11,0,-11
6720,1,1,218,1368,1150
6721,1,1,266,1316,1050
6722,0,0,54,0,-54
6723,1,1,103,2022,1919
6724,1,0,16,0,-16
6725,1,1,300,1222,922
6726,0,0,10,0,-10
6727,1,0,26,0,-26
6728,0,0,76,0,-76
6729,0,0,73,0,-73
6730,0,0,59,0,-59
6731,0,0,26,0,-26
6732,1,1,318,1218,900
6733,0,0,139,0,-139
6734,0,0,63,0,-63
6735,0,0,63,0,-63
6736,0,0,34,0,-34
6737,0,0,69,0,-69
6738,0,0,93,0,-93
6739,1,1,724,1282,558
6740,0,0,84,0,-84
6741,0,0,34,0,-34
6742,0,0,31,0,-31
6743,0,0,35,0,-35
6744,1,1,905,1642,737
6745,1,1,304,1721,1417
6746,1,1,507,1608,1101
6747,1,1,147,1333,1186
6748,0,0,57,0,-57
6749,0,0,3,0,-3
6750,0,0,59,0,-59
6751,1,1,241,1258,1017
6752,0,0,77,0,-77
6753,1,1,612,1217,605
6754,1,1,216,2504,2288
6755,1,1,515,1541,1026
6756,1,1,154,1591,1437
6757,1,0,178,0,-178
6758,1,0,0,0,0
6759,1,0,27,0,-27
6760,0,0,32,0,-32
6761,0,0,3,0,-3
6762,1,0,78,0,-78
6763,0,0,101,0,-101
6764,1,0,3,0,-3
6765,1,1,290,1210,920
6766,1,0,38,0,-38
6767,1,0,2,0,-2
6768,1,0,75,0,-75
6769,1,0,72,0,-72
6770,1,1,210,1265,1055
6771,0,0,77,0,-77
6772,0,0,70,0,-70
6773,0,0,62,0,-62
6774,1,1,445,1370,925
6775,1,0,139,0,-139
6776,1,1,180,1217,1037
6777,1,0,130,0,-130
6778,1,0,59,0,-59
6779,1,0,142,0,-142
6780,0,0,52,0,-52
6781,1,1,1109,1466,357
6782,1,0,121,0,-121
6783,0,0,77,0,-77
6784,1,1,756,1429,673
6785,1,1,343,1438,1095
6786,0,0,26,0,-26
6787,1,0,100,0,-100
6788,1,1,156,1221,1065
6789,1,1,202,1372,1170
6790,1,0,8,0,-8
6791,1,0,29,0,-29
6792,0,0,18,0,-18
6793,0,0,34,0,-34
6794,1,0,11,0,-11
6795,1,1,1446,1304,-142
6796,0,0,37,0,-37
6797,1,1,233,1506,1273
6798,1,1,152,1234,1082
6799,1,0,14,0,-14
6800,0,0,107,0,-107
6801,1,0,9,0,-9
6802,1,1,215,1245,1030
6803,1,1,276,1562,1286
6804,1,0,56,0,-56
6805,0,0,26,0,-26
6806,1,1,120,1220,1100
6807,0,0,99,0,-99
6808,1,0,48,0,-48
6809,0,0,87,0,-87
6810,1,0,27,0,-27
6811,0,0,56,0,-56
6812,0,0,24,0,-24
6813,0,0,102,0,-102
6814,1,1,1281,1222,-59
6815,0,0,76,0,-76
6816,0,0,248,0,-248
6817,0,0,35,0,-35
6818,1,0,10,0,-10
6819,1,1,271,2162,1891
6820,0,0,93,0,-93
6821,1,0,39,0,-39
6822,1,1,414,1557,1143
6823,0,0,44,0,-44
6824,0,0,55,0,-55
6825,0,0,61,0,-61
6826,1,1,1309,1360,51
6827,0,0,8,0,-8
6828,1,1,312,1449,1137
6829,1,0,4,0,-4
6830,0,0,21,0,-21
6831,1,0,28,0,-28
6832,1,1,135,1251,1116
6833,1,1,1989,1351,-638
6834,0,0,46,0,-46
6835,0,0,54,0,-54
6836,0,0,36,0,-36
6837,0,0,46,0,-46
6838,1,1,738,1521,783
6839,0,0,6,0,-6
6840,0,0,124,0,-124
6841,1,1,264,1409,1145
6842,1,1,397,1718,1321
6843,0,0,4,0,-4
6844,0,0,12,0,-12
6845,0,0,64,0,-64
6846,0,0,5,0,-5
6847,1,1,112,1809,1697
6848,1,1,373,1354,981
6849,1,1,365,1292,927
6850,0,0,49,0,-49
6851,1,0,11,0,-11
6852,0,0,17,0,-17
6853,0,0,11,0,-11
6854,0,0,10,0,-10
6855,1,0,22,0,-22
6856,1,0,8,0,-8
6857,1,0,28,0,-28
6858,0,0,1,0,-1
6859,1,1,1362,1439,77
6860,0,0,22,0,-22
6861,0,0,45,0,-45
6862,1,0,148,0,-148
6863,1,0,49,0,-49
6864,1,1,417,1643,1226
6865,1,1,480,1280,800
6866,1,0,7,0,-7
6867,1,1,729,1203,474
6868,1,0,128,0,-128
6869,0,0,83,0,-83
6870,1,1,554,1642,1088
6871,1,0,2,0,-2
6872,1,0,57,0,-57
6873,0,0,14,0,-14
6874,0,0,3,0,-3
6875,1,1,1372,1810,438
6876,0,0,22,0,-22
6877,1,0,7,0,-7
6878,1,1,449,1935,1486
6879,1,1,454,1496,1042
6880,1,0,28,0,-28
6881,1,0,31,0,-31
6882,1,0,19,0,-19
6883,1,0,24,0,-24
6884,0,0,3,0,-3
6885,1,0,19,0,-19
6886,1,0,70,0,-70
6887,1,0,72,0,-72
6888,1,0,92,0,-92
6889,0,0,441,0,-441
6890,1,0,10,0,-10
6891,0,0,19,0,-19
6892,0,0,34,0,-34
6893,0,0,37,0,-37
6894,1,0,26,0,-26
6895,0,0,13,0,-13
6896,1,1,1358,1409,51
6897,1,1,176,5893,5717
6898,1,0,36,0,-36
6899,1,0,28,0,-28
6900,0,0,44,0,-44
6901,0,0,18,0,-18
6902,1,1,247,1348,1101
6903,1,1,667,2180,1513
6904,1,0,151,0,-151
6905,1,1,290,1641,1351
6906,1,0,37,0,-37
6907,1,1,922,2055,1133
6908,1,1,542,2307,1765
6909,0,0,34,0,-34
6910,0,0,47,0,-47
6911,1,1,623,2002,1379
6912,0,0,70,0,-70
6913,1,1,1058,1306,248
6914,0,0,33,0,-33
6915,1,0,2,0,-2
6916,1,0,8,0,-8
6917,1,0,22,0,-22
6918,0,0,6,0,-6
6919,0,0,37,0,-37
6920,1,1,600,1233,633
6921,0,0,113,0,-113
6922,1,1,416,1329,913
6923,0,0,21,0,-21
6924,0,0,3,0,-3
6925,1,0,47,0,-47
6926,1,0,2,0,-2
6927,1,1,221,1267,1046
6928,1,0,264,0,-264
6929,1,1,1333,1636,303
6930,1,0,55,0,-55
6931,1,0,0,0,0
6932,0,0,37,0,-37
6933,0,0,82,0,-82
6934,0,0,123,0,-123
6935,0,0,46,0,-46
6936,0,0,42,0,-42
6937,1,1,281,1235,954
6938,0,0,32,0,-32
6939,1,0,47,0,-47
6940,0,0,25,0,-25
6941,0,0,24,0,-24
6942,1,1,1233,2067,834
6943,0,0,7,0,-7
6944,0,0,10,0,-10
6945,1,0,17,0,-17
6946,0,0,123,0,-123
6947,1,0,1,0,-1
6948,0,0,45,0,-45
6949,1,0,74,0,-74
6950,1,0,33,0,-33
6951,0,0,17,0,-17
6952,1,0,32,0,-32
6953,1,0,107,0,-107
6954,0,0,32,0,-32
6955,0,0,12,0,-12
6956,1,0,6,0,-6
6957,1,1,271,1210,939
6958,0,0,0,0,0
6959,0,0,72,0,-72
6960,0,0,28,0,-28
6961,1,0,102,0,-102
6962,1,1,108,1433,1325
6963,0,0,4,0,-4
6964,0,0,11,0,-11
6965,0,0,101,0,-101
6966,1,0,24,0,-24
6967,1,0,72,0,-72
6968,0,0,1,0,-1
6969,1,1,383,1274,891
6970,1,1,1678,1222,-456
6971,1,0,94,0,-94
6972,0,0,27,0,-27
6973,0,0,92,0,-92
6974,0,0,11,0,-11
6975,0,0,35,0,-35
6976,1,0,5,0,-5
6977,0,0,52,0,-52
6978,0,0,56,0,-56
6979,0,0,116,0,-116
6980,1,0,28,0,-28
6981,0,0,67,0,-67
6982,0,0,80,0,-80
6983,0,0,7,0,-7
6984,0,0,24,0,-24
6985,0,0,49,0,-49
6986,1,1,85,2055,1970
6987,1,1,58,1299,1241
6988,0,0,3,0,-3
6989,1,0,124,0,-124
6990,0,0,25,0,-25
6991,0,0,143,0,-143
6992,0,0,30,0,-30
6993,0,0,27,0,-27
6994,1,1,915,1648,733
6995,0,0,43,0,-43
6996,1,1,1185,1261,76
6997,1,1,714,1855,1141
6998,1,1,409,1244,835
6999,1,1,594,1203,609
7000,1,0,26,0,-26
7001,1,0,20,0,-20
7002,1,1,779,1845,1066
7003,0,0,130,0,-130
7004,1,0,163,0,-163
7005,1,1,2397,1243,-1154
7006,1,0,92,0,-92
7007,1,1,167,1272,1105
7008,1,0,47,0,-47
7009,1,1,79,1355,1276
7010,0,0,12,0,-12
7011,0,0,51,0,-51
7012,1,1,104,1675,1571
7013,0,0,8,0,-8
7014,0,0,66,0,-66
7015,1,1,716,2458,1742
7016,1,0,45,0,-45
7017,1,0,36,0,-36
7018,1,1,128,1758,1630
7019,1,1,450,2184,1734
7020,0,0,41,0,-41
7021,0,0,42,0,-42
7022,0,0,20,0,-20
7023,1,1,227,1250,1023
7024,1,0,70,0,-70
7025,0,0,0,0,0
7026,1,1,300,1278,978
7027,1,1,339,1339,1000
7028,0,0,23,0,-23
7029,1,0,65,0,-65
7030,0,0,82,0,-82
7031,1,1,156,1410,1254
7032,0,0,26,0,-26
7033,1,1,783,1204,421
7034,1,1,35,1262,1227
7035,0,0,89,0,-89
7036,1,1,1437,2025,588
7037,0,0,98,0,-98
7038,1,0,18,0,-18
7039,0,0,13,0,-13
7040,0,0,5,0,-5
7041,0,0,20,0,-20
7042,1,1,736,1256,520
7043,1,0,72,0,-72
7044,0,0,1,0,-1
7045,0,0,101,0,-101
7046,0,0,24,0,-24
7047,1,1,852,1307,455
7048,1,0,242,0,-242
7049,0,0,39,0,-39
7050,1,0,17,0,-17
7051,1,0,29,0,-29
7052,0,0,50,0,-50
7053,1,1,552,1928,1376
7054,1,0,163,0,-163
7055,1,0,4,0,-4
7056,1,1,87,1258,1171
7057,0,0,0,0,0
7058,1,0,20,0,-20
7059,1,0,15,0,-15
7060,1,1,1234,1281,47
7061,1,1,187,1335,1148
7062,0,0,61,0,-61
7063,1,1,200,1597,1397
7064,1,0,5,0,-5
7065,0,0,2,0,-2
7066,1,0,51,0,-51
7067,1,1,430,1410,980
7068,0,0,37,0,-37
7069,1,1,90,1882,1792
7070,0,0,76,0,-76
7071,0,0,17,0,-17
7072,0,0,2,0,-2
7073,1,0,13,0,-13
7074,1,0,3,0,-3
7075,1,1,290,1317,1027
7076,0,0,25,0,-25
7077,1,0,30,0,-30
7078,0,0,14,0,-14
7079,1,0,16,0,-16
7080,0,0,26,0,-26
7081,1,0,33,0,-33
7082,0,0,65,0,-65
7083,0,0,6,0,-6
7084,1,1,449,1312,863
7085,1,0,5,0,-5
7086,1,1,1042,2146,1104
7087,1,0,113,0,-113
7088,1,1,1433,2013,580
7089,0,0,8,0,-8
7090,1,1,464,1408,944
7091,0,0,83,0,-83
7092,0,0,3,0,-3
7093,0,0,54,0,-54
7094,1,1,559,1572,1013
7095,0,0,3,0,-3
7096,0,0,17,0,-17
7097,1,0,35,0,-35
7098,1,1,353,1604,1251
7099,1,0,26,0,-26
7100,1,0,77,0,-77
7101,1,1,424,1245,821
7102,0,0,22,0,-22
7103,0,0,27,0,-27
7104,0,0,33,0,-33
7105,1,0,60,0,-60
7106,1,1,482,1558,1076
7107,1,1,603,1248,645
7108,1,0,0,0,0
7109,1,0,33,0,-33
7110,0,0,1,0,-1
7111,0,0,19,0,-19
7112,0,0,36,0,-36
7113,0,0,8,0,-8
7114,1,0,35,0,-35
7115,0,0,1,0,-1
7116,0,0,13,0,-13
7117,1,0,68,0,-68
7118,1,0,43,0,-43
7119,1,0,48,0,-48
7120,0,0,26,0,-26
7121,1,1,174,1330,1156
7122,0,0,130,0,-130
7123,0,0,84,0,-84
7124,1,0,100,0,-100
7125,1,1,217,1334,1117
7126,1,1,179,1319,1140
7127,0,0,25,0,-25
7128,1,1,271,1348,1077
7129,1,0,36,0,-36
7130,0,0,4,0,-4
7131,0,0,74,0,-74
7132,0,0,75,0,-75
7133,0,0,4,0,-4
7134,0,0,26,0,-26
7135,1,0,8,0,-8
7136,0,0,26,0,-26
7137,0,0,0,0,0
7138,0,0,45,0,-45
7139,0,0,22,0,-22
7140,0,0,40,0,-40
7141,1,0,210,0,-210
7142,0,0,20,0,-20
7143,0,0,141,0,-141
7144,0,0,104,0,-104
7145,1,1,636,2363,1727
7146,0,0,5,0,-5
7147,1,0,12,0,-12
7148,1,1,64,1290,1226
7149,1,1,674,1725,1051
7150,1,1,88,1336,1248
7151,1,0,10,0,-10
7152,0,0,110,0,-110
7153,1,0,39,0,-39
7154,1,1,900,1773,873
7155,0,0,57,0,-57
7156,0,0,18,0,-18
7157,1,0,223,0,-223
7158,1,1,618,1461,843
7159,1,1,367,1376,1009
7160,1,0,74,0,-74
7161,0,0,34,0,-34
7162,0,0,59,0,-59
7163,1,1,583,1538,955
7164,1,1,185,1407,1222
7165,0,0,73,0,-73
7166,1,1,1010,1569,559
7167,0,0,94,0,-94
7168,1,0,9,0,-9
7169,1,1,68,1607,1539
7170,0,0,4,0,-4
7171,1,0,66,0,-66
7172,1,1,428,1474,1046
7173,1,1,368,1898,1530
7174,0,0,16,0,-16
7175,1,0,49,0,-49
7176,1,1,206,2547,2341
7177,1,0,57,0,-57
7178,1,0,115,0,-115
7179,1,0,40,0,-40
7180,0,0,97,0,-97
7181,1,0,56,0,-56
7182,1,0,15,0,-15
7183,1,0,15,0,-15
7184,1,1,161,2914,2753
7185,1,1,329,1236,907
7186,1,1,789,1525,736
7187,1,0,27,0,-27
7188,1,1,192,1285,1093
7189,1,0,43,0,-43
7190,0,0,17,0,-17
7191,0,0,118,0,-118
7192,1,1,493,1417,924
7193,1,1,525,1219,694
7194,1,1,45,1398,1353
7195,1,1,187,1211,1024
7196,0,0,157,0,-157
7197,1,0,38,0,-38
7198,1,1,577,1752,1175
7199,0,0,50,0,-50
7200,1,1,123,2763,2640
7201,1,0,34,0,-34
7202,0,0,11,0,-11
7203,1,0,22,0,-22
7204,1,1,840,1641,801
7205,1,0,9,0,-9
7206,0,0,42,0,-42
7207,0,0,80,0,-80
7208,0,0,160,0,-160
7209,1,1,844,1510,666
7210,0,0,76,0,-76
7211,0,0,115,0,-115
7212,0,0,39,0,-39
7213,0,0,3,0,-3
7214,0,0,17,0,-17
7215,1,0,26,0,-26
7216,1,1,1865,1557,-308
7217,1,1,1205,1262,57
7218,0,0,42,0,-42
7219,1,0,28,0,-28
7220,0,0,4,0,-4
7221,0,0,10,0,-10
7222,1,0,24,0,-24
7223,1,0,280,0,-280
7224,1,1,658,2040,1382
7225,1,0,84,0,-84
7226,1,1,168,2366,2198
7227,1,1,1058,1399,341
7228,1,0,108,0,-108
7229,1,1,234,1871,1637
7230,1,1,54,1237,1183
7231,1,1,143,1237,1094
7232,1,1,435,1223,788
7233,1,1,565,1314,749
7234,0,0,169,0,-169
7235,1,1,399,1303,904
7236,1,1,1467,1356,-111
7237,1,1,398,1504,1106
7238,1,1,906,1301,395
7239,0,0,42,0,-42
7240,0,0,12,0,-12
7241,1,0,6,0,-6
7242,1,0,39,0,-39
7243,1,0,37,0,-37
7244,0,0,2,0,-2
7245,1,0,14,0,-14
7246,1,1,324,2402,2078
7247,1,0,0,0,0
7248,0,0,67,0,-67
7249,0,0,42,0,-42
7250,1,0,27,0,-27
7251,0,0,61,0,-61
7252,1,0,8,0,-8
7253,0,0,74,0,-74
7254,1,1,149,1313,1164
7255,1,1,906,1280,374
7256,1,0,10,0,-10
7257,0,0,3,0,-3
7258,0,0,38,0,-38
7259,1,1,1046,1202,156
7260,1,0,34,0,-34
7261,1,0,0,0,0
7262,1,1,417,2143,1726
7263,1,0,134,0,-134
7264,1,1,410,3227,2817
7265,1,0,74,0,-74
7266,1,0,25,0,-25
7267,1,1,86,1252,1166
7268,1,0,55,0,-55
7269,1,0,48,0,-48
7270,1,0,2,0,-2
7271,1,0,78,0,-78
7272,0,0,116,0,-116
7273,1,1,838,1342,504
7274,0,0,10,0,-10
7275,1,0,68,0,-68
7276,0,0,61,0,-61
7277,1,0,78,0,-78
7278,0,0,6,0,-6
7279,0,0,128,0,-128
7280,0,0,82,0,-82
7281,1,1,727,1530,803
7282,0,0,4,0,-4
7283,1,1,162,1289,1127
7284,0,0,31,0,-31
7285,0,0,138,0,-138
7286,0,0,131,0,-131
7287,1,0,198,0,-198
7288,1,0,12,0,-12
7289,1,0,3,0,-3
7290,0,0,54,0,-54
7291,0,0,12,0,-12
7292,0,0,53,0,-53
7293,1,1,523,1291,768
7294,0,0,10,0,-10
7295,1,0,5,0,-5
7296,1,0,68,0,-68
7297,1,0,90,0,-90
7298,0,0,131,0,-131
7299,0,0,14,0,-14
7300,1,1,1674,1974,300
7301,1,0,49,0,-49
7302,1,0,30,0,-30
7303,1,0,60,0,-60
7304,1,1,448,2668,2220
7305,1,0,14,0,-14
7306,1,0,150,0,-150
7307,1,1,216,1699,1483
7308,1,1,431,1261,830
7309,0,0,42,0,-42
7310,0,0,25,0,-25
7311,1,1,1655,1506,-149
7312,0,0,54,0,-54
7313,0,0,100,0,-100
7314,1,1,318,1235,917
7315,1,0,41,0,-41
7316,0,0,72,0,-72
7317,1,0,6,0,-6
7318,0,0,15,0,-15
7319,0,0,192,0,-192
7320,0,0,24,0,-24
7321,1,1,303,1402,1099
7322,1,1,920,1212,292
7323,1,0,22,0,-22
7324,1,1,496,1348,852
7325,1,1,423,1387,964
7326,1,1,437,1436,999
7327,1,0,8,0,-8
7328,1,0,20,0,-20
7329,0,0,1,0,-1
7330,0,0,73,0,-73
7331,0,0,24,0,-24
7332,1,1,736,1627,891
7333,1,1,1635,1249,-386
7334,1,0,40,0,-40
7335,1,1,381,1359,978
7336,0,0,3,0,-3
7337,1,1,715,1218,503
7338,1,1,193,2908,2715
7339,1,1,412,1462,1050
7340,1,0,37,0,-37
7341,1,0,28,0,-28
7342,0,0,90,0,-90
7343,0,0,9,0,-9
7344,0,0,22,0,-22
7345,0,0,147,0,-147
7346,1,0,44,0,-44
7347,0,0,12,0,-12
7348,1,1,454,1243,789
7349,1,0,9,0,-9
7350,1,0,117,0,-117
7351,0,0,74,0,-74
7352,1,1,1040,1342,302
7353,0,0,26,0,-26
7354,0,0,3,0,-3
7355,1,1,374,1241,867
7356,0,0,60,0,-60
7357,1,1,428,1371,943
7358,0,0,23,0,-23
7359,0,0,17,0,-17
7360,1,1,693,1520,827
7361,1,0,29,0,-29
7362,1,0,51,0,-51
7363,1,1,1043,1201,158
7364,1,0,0,0,0
7365,1,0,110,0,-110
7366,1,1,894,1472,578
7367,1,1,359,1238,879
7368,0,0,101,0,-101
7369,1,1,302,1292,990
7370,0,0,30,0,-30
7371,0,0,66,0,-66
7372,0,0,32,0,-32
7373,0,0,31,0,-31
7374,1,1,96,1304,1208
7375,0,0,27,0,-27
7376,1,0,11,0,-11
7377,1,1,26,1233,1207
7378,1,1,214,1863,1649
7379,0,0,45,0,-45
7380,1,1,143,1485,1342
7381,1,1,955,1350,395
7382,0,0,28,0,-28
7383,0,0,0,0,0
7384,0,0,85,0,-85
7385,1,0,0,0,0
7386,0,0,149,0,-149
7387,0,0,145,0,-145
7388,1,0,155,0,-155
7389,1,0,53,0,-53
7390,0,0,132,0,-132
7391,0,0,30,0,-30
7392,0,0,8,0,-8
7393,0,0,4,0,-4
7394,0,0,29,0,-29
7395,0,0,99,0,-99
7396,1,0,9,0,-9
7397,1,0,62,0,-62
7398,1,1,572,2669,2097
7399,1,0,78,0,-78
7400,1,1,943,1346,403
7401,1,1,1027,1318,291
7402,0,0,15,0,-15
7403,1,1,222,1603,1381
7404,1,0,13,0,-13
7405,0,0,150,0,-150
7406,1,0,11,0,-11
7407,1,0,76,0,-76
7408,0,0,68,0,-68
7409,1,0,2,0,-2
7410,1,1,308,1366,1058
7411,1,1,681,1340,659
7412,0,0,8,0,-8
7413,1,0,26,0,-26
7414,0,0,45,0,-45
7415,1,0,58,0,-58
7416,1,0,115,0,-115
7417,0,0,18,0,-18
7418,1,1,138,1584,1446
7419,1,0,45,0,-45
7420,1,0,81,0,-81
7421,0,0,12,0,-12
7422,1,0,200,0,-200
7423,1,1,520,2192,1672
7424,1,0,35,0,-35
7425,1,1,105,1409,1304
7426,1,0,0,0,0
7427,1,0,10,0,-10
7428,1,0,87,0,-87
7429,1,1,216,1245,1029
7430,0,0,504,0,-504
7431,0,0,22,0,-22
7432,1,0,4,0,-4
7433,1,0,3,0,-3
7434,0,0,38,0,-38
7435,1,1,814,1413,599
7436,1,0,58,0,-58
7437,0,0,20,0,-20
7438,1,1,268,1288,1020
7439,1,1,93,1306,1213
7440,0,0,2,0,-2
7441,0,0,22,0,-22
7442,1,1,94,1473,1379
7443,1,0,3,0,-3
7444,1,0,96,0,-96
7445,1,0,124,0,-124
7446,1,1,284,1369,1085
7447,1,0,40,0,-40
7448,1,0,16,0,-16
7449,1,1,590,2729,2139
7450,0,0,105,0,-105
7451,0,0,45,0,-45
7452,1,0,38,0,-38
7453,1,1,628,3778,3150
7454,0,0,242,0,-242
7455,1,1,61,2356,2295
7456,1,1,371,1904,1533
7457,0,0,21,0,-21
7458,0,0,10,0,-10
7459,1,1,381,1337,956
7460,1,1,822,1804,982
7461,0,0,166,0,-166
7462,1,0,65,0,-65
7463,0,0,10,0,-10
7464,0,0,19,0,-19
7465,0,0,37,0,-37
7466,1,1,53,1543,1490
7467,0,0,41,0,-41
7468,0,0,19,0,-19
7469,1,0,83,0,-83
7470,0,0,29,0,-29
7471,0,0,27,0,-27
7472,0,0,50,0,-50
7473,1,0,24,0,-24
7474,1,0,34,0,-34
7475,1,1,414,2212,1798
7476,1,0,27,0,-27
7477,0,0,36,0,-36
7478,1,0,52,0,-52
7479,1,1,759,1211,452
7480,1,1,992,1995,1003
7481,1,1,444,1266,822
7482,0,0,115,0,-115
7483,0,0,19,0,-19
7484,1,1,341,1682,1341
7485,1,0,2,0,-2
7486,1,1,936,1346,410
7487,0,0,56,0,-56
7488,0,0,183,0,-183
7489,1,1,88,2487,2399
7490,1,0,88,0,-88
7491,1,1,455,1226,771
7492,0,0,49,0,-49
7493,1,0,31,0,-31
7494,1,1,155,1245,1090
7495,1,0,73,0,-73
7496,1,0,9,0,-9
7497,1,0,13,0,-13
7498,1,0,45,0,-45
7499,0,0,92,0,-92
7500,0,0,2,0,-2
7501,1,1,220,1211,991
7502,1,0,83,0,-83
7503,1,1,28,1206,1178
7504,0,0,88,0,-88
7505,1,1,791,1265,474
7506,0,0,4,0,-4
7507,0,0,22,0,-22
7508,1,1,840,1625,785
7509,1,1,453,2573,2120
7510,1,0,9,0,-9
7511,1,0,9,0,-9
7512,0,0,80,0,-80
7513,1,1,939,1825,886
7514,1,1,1076,1291,215
7515,1,0,54,0,-54
7516,1,1,252,2586,2334
7517,1,1,658,1388,730
7518,1,0,9,0,-9
7519,1,0,51,0,-51
7520,1,1,341,1415,1074
7521,1,1,35,2020,1985
7522,1,1,355,1374,1019
7523,1,0,87,0,-87
7524,1,1,90,2553,2463
7525,0,0,43,0,-43
7526,0,0,40,0,-40
7527,1,1,642,1326,684
7528,0,0,17,0,-17
7529,1,0,88,0,-88
7530,1,0,15,0,-15
7531,0,0,191,0,-191
7532,1,0,2,0,-2
7533,1,1,252,1535,1283
7534,1,0,12,0,-12
7535,1,0,8,0,-8
7536,1,1,745,1259,514
7537,1,0,51,0,-51
7538,1,1,851,1716,865
7539,1,0,15,0,-15
7540,1,1,677,2782,2105
7541,1,0,95,0,-95
7542,1,0,23,0,-23
7543,1,0,133,0,-133
7544,0,0,17,0,-17
7545,0,0,43,0,-43
7546,1,0,13,0,-13
7547,1,0,19,0,-19
7548,1,1,1114,1258,144
7549,0,0,53,0,-53
7550,1,1,479,1679,1200
7551,0,0,77,0,-77
7552,0,0,46,0,-46
7553,1,0,11,0,-11
7554,1,1,288,1326,1038
7555,1,1,185,3481,3296
7556,0,0,6,0,-6
7557,1,0,29,0,-29
7558,1,1,365,1437,1072
7559,0,0,2,0,-2
7560,1,0,50,0,-50
7561,1,1,177,1514,1337
7562,1,1,388,1639,1251
7563,0,0,1,0,-1
7564,1,0,42,0,-42
7565,1,1,123,1625,1502
7566,0,0,41,0,-41
7567,0,0,144,0,-144
7568,1,0,28,0,-28
7569,1,1,47,2748,2701
7570,0,0,10,0,-10
7571,0,0,95,0,-95
7572,1,1,217,2117,1900
7573,0,0,16,0,-16
7574,1,0,113,0,-113
7575,0,0,36,0,-36
7576,0,0,133,0,-133
7577,1,0,17,0,-17
7578,1,0,0,0,0
7579,0,0,12,0,-12
7580,0,0,31,0,-31
7581,0,0,86,0,-86
7582,0,0,96,0,-96
7583,1,1,577,2011,1434
7584,1,0,36,0,-36
7585,0,0,7,0,-7
7586,1,1,202,1291,1089
7587,1,1,104,1268,1164
7588,0,0,42,0,-42
7589,1,1,664,1536,872
7590,1,0,4,0,-4
7591,0,0,3,0,-3
7592,1,0,42,0,-42
7593,1,1,257,2603,2346
7594,1,0,9,0,-9
7595,0,0,78,0,-78
7596,0,0,14,0,-14
7597,0,0,147,0,-147
7598,1,0,127,0,-127
7599,0,0,127,0,-127
7600,0,0,18,0,-18
7601,1,0,11,0,-11
7602,1,0,47,0,-47
7603,1,1,550,1203,653
7604,0,0,34,0,-34
7605,1,0,21,0,-21
7606,0,0,67,0,-67
7607,0,0,8,0,-8
7608,1,1,249,3403,3154
7609,0,0,5,0,-5
7610,1,1,531,1632,1101
7611,0,0,28,0,-28
7612,0,0,2,0,-2
7613,1,0,4,0,-4
7614,1,0,103,0,-103
7615,0,0,3,0,-3
7616,1,1,395,3383,2988
7617,1,1,488,1806,1318
7618,1,0,12,0,-12
7619,1,1,84,1289,1205
7620,0,0,12,0,-12
7621,1,0,166,0,-166
7622,0,0,18,0,-18
7623,1,1,160,2010,1850
7624,1,1,298,1443,1145
7625,1,0,14,0,-14
7626,1,0,24,0,-24
7627,0,0,14,0,-14
7628,0,0,12,0,-12
7629,1,0,5,0,-5
7630,1,0,22,0,-22
7631,1,0,29,0,-29
7632,0,0,12,0,-12
7633,0,0,0,0,0
7634,0,0,7,0,-7
7635,1,1,1070,1591,521
7636,0,0,40,0,-40
7637,1,1,634,1885,1251
7638,1,0,48,0,-48
7639,0,0,37,0,-37
7640,1,1,360,1649,1289
7641,1,1,44,1271,1227
7642,0,0,45,0,-45
7643,1,0,41,0,-41
7644,0,0,9,0,-9
7645,1,0,2,0,-2
7646,1,1,350,1371,1021
7647,1,0,35,0,-35
7648,1,1,505,1451,946
7649,0,0,31,0,-31
7650,1,1,795,1728,933
7651,1,0,115,0,-115
7652,0,0,51,0,-51
7653,0,0,14,0,-14
7654,0,0,19,0,-19
7655,0,0,45,0,-45
7656,0,0,1,0,-1
7657,0,0,13,0,-13
7658,1,1,96,1653,1557
7659,1,0,39,0,-39
7660,1,1,1139,1359,220
7661,1,0,12,0,-12
7662,0,0,7,0,-7
7663,0,0,250,0,-250
7664,1,1,710,1568,858
7665,0,0,56,0,-56
7666,1,0,40,0,-40
7667,1,0,47,0,-47
7668,1,0,46,0,-46
7669,1,1,84,1485,1401
7670,1,1,732,1213,481
7671,0,0,37,0,-37
7672,1,1,956,1946,990
7673,1,1,229,1257,1028
7674,0,0,26,0,-26
7675,1,0,122,0,-122
7676,0,0,80,0,-80
7677,1,1,437,1339,902
7678,0,0,174,0,-174
7679,1,1,187,1378,1191
7680,1,0,2,0,-2
7681,0,0,1,0,-1
7682,1,0,168,0,-168
7683,1,0,21,0,-21
7684,1,1,245,1304,1059
7685,1,1,93,1518,1425
7686,1,0,36,0,-36
7687,0,0,250,0,-250
7688,1,0,78,0,-78
7689,0,0,133,0,-133
7690,1,1,82,1440,1358
7691,1,1,1062,1460,398
7692,0,0,0,0,0
7693,1,1,914,1441,527
7694,0,0,90,0,-90
7695,1,1,362,1717,1355
7696,0,0,123,0,-123
7697,1,1,708,1316,608
7698,1,1,179,1369,1190
7699,0,0,98,0,-98
7700,0,0,11,0,-11
7701,1,0,18,0,-18
7702,1,1,95,1450,1355
7703,0,0,26,0,-26
7704,1,0,102,0,-102
7705,1,1,893,2372,1479
7706,0,0,59,0,-59
7707,0,0,36,0,-36
7708,0,0,1,0,-1
7709,1,1,557,1281,724
7710,0,0,179,0,-179
7711,1,1,196,1307,1111
7712,0,0,62,0,-62
7713,0,0,101,0,-101
7714,0,0,116,0,-116
7715,1,0,11,0,-11
7716,0,0,10,0,-10
7717,1,0,5,0,-5
7718,1,0,9,0,-9
7719,1,1,362,1333,971
7720,1,1,1052,1493,441
7721,0,0,26,0,-26
7722,0,0,3,0,-3
7723,1,0,1,0,-1
7724,0,0,22,0,-22
7725,0,0,67,0,-67
7726,0,0,49,0,-49
7727,0,0,127,0,-127
7728,0,0,59,0,-59
7729,0,0,17,0,-17
7730,0,0,15,0,-15
7731,0,0,37,0,-37
7732,1,1,302,1601,1299
7733,1,0,20,0,-20
7734,0,0,33,0,-33
7735,0,0,37,0,-37
7736,0,0,34,0,-34
7737,0,0,2,0,-2
7738,0,0,0,0,0
7739,1,1,747,1297,550
7740,0,0,25,0,-25
7741,0,0,37,0,-37
7742,1,1,160,1828,1668
7743,1,0,22,0,-22
7744,0,0,33,0,-33
7745,0,0,85,0,-85
7746,0,0,2,0,-2
7747,0,0,5,0,-5
7748,1,0,40,0,-40
7749,1,0,1,0,-1
7750,0,0,8,0,-8
7751,1,1,16,1285,1269
7752,1,1,913,1260,347
7753,0,0,69,0,-69
7754,0,0,8,0,-8
7755,0,0,33,0,-33
7756,0,0,30,0,-30
7757,1,0,22,0,-22
7758,1,1,703,1436,733
7759,1,0,36,0,-36
7760,0,0,32,0,-32
7761,0,0,172,0,-172
7762,1,1,240,1247,1007
7763,0,0,105,0,-105
7764,0,0,17,0,-17
7765,1,1,527,1430,903
7766,0,0,37,0,-37
7767,0,0,12,0,-12
7768,1,0,4,0,-4
7769,1,0,96,0,-96
7770,1,0,40,0,-40
7771,1,0,74,0,-74
7772,1,1,786,1435,649
7773,1,1,504,1215,711
7774,1,0,19,0,-19
7775,1,1,399,1894,1495
7776,1,1,450,1203,753
7777,1,0,19,0,-19
7778,1,0,96,0,-96
7779,1,0,44,0,-44
7780,0,0,60,0,-60
7781,1,1,918,1506,588
7782,1,1,221,4510,4289
7783,1,0,35,0,-35
7784,1,1,354,1388,1034
7785,1,1,441,1410,969
7786,0,0,54,0,-54
7787,1,0,46,0,-46
7788,1,0,78,0,-78
7789,1,0,97,0,-97
7790,0,0,30,0,-30
7791,0,0,69,0,-69
7792,0,0,7,0,-7
7793,0,0,91,0,-91
7794,0,0,5,0,-5
7795,1,1,917,1573,656
7796,1,0,153,0,-153
7797,1,0,88,0,-88
7798,1,0,32,0,-32
7799,1,1,163,1355,1192
7800,1,1,842,1407,565
7801,1,0,94,0,-94
7802,0,0,72,0,-72
7803,0,0,74,0,-74
7804,1,0,78,0,-78
7805,0,0,69,0,-69
7806,1,1,444,1200,756
7807,1,1,196,1292,1096
7808,1,0,30,0,-30
7809,1,1,63,1660,1597
7810,0,0,0,0,0
7811,0,0,31,0,-31
7812,1,1,1209,1335,126
7813,0,0,2,0,-2
7814,1,0,54,0,-54
7815,1,1,888,1259,371
7816,1,0,15,0,-15
7817,1,1,244,1595,1351
7818,0,0,6,0,-6
7819,0,0,84,0,-84
7820,1,0,45,0,-45
7821,1,1,399,1268,869
7822,0,0,5,0,-5
7823,0,0,161,0,-161
7824,0,0,1,0,-1
7825,1,1,829,1251,422
7826,0,0,70,0,-70
7827,1,1,166,2563,2397
7828,0,0,35,0,-35
7829,1,1,726,1438,712
7830,1,1,153,1373,1220
7831,1,1,403,1521,1118
7832,1,0,11,0,-11
7833,1,0,24,0,-24
7834,1,0,22,0,-22
7835,0,0,66,0,-66
7836,1,0,36,0,-36
7837,1,1,653,1288,635
7838,1,1,135,1251,1116
7839,1,1,65,1249,1184
7840,0,0,29,0,-29
7841,1,0,99,0,-99
7842,0,0,60,0,-60
7843,1,1,90,1223,1133
7844,1,1,1606,1792,186
7845,1,1,479,1444,965
7846,1,1,383,1294,911
7847,1,0,36,0,-36
7848,0,0,125,0,-125
7849,0,0,40,0,-40
7850,1,1,160,1390,1230
7851,0,0,25,0,-25
7852,0,0,109,0,-109
7853,1,0,17,0,-17
7854,0,0,78,0,-78
7855,1,1,456,1508,1052
7856,0,0,11,0,-11
7857,1,1,160,2116,1956
7858,1,0,61,0,-61
7859,1,1,167,1240,1073
7860,0,0,189,0,-189
7861,0,0,32,0,-32
7862,1,1,611,2392,1781
7863,1,0,26,0,-26
7864,1,0,63,0,-63
7865,1,0,25,0,-25
7866,1,1,417,1883,1466
7867,1,0,31,0,-31
7868,0,0,21,0,-21
7869,1,0,2,0,-2
7870,1,1,760,1405,645
7871,1,1,118,1636,1518
7872,0,0,52,0,-52
7873,0,0,21,0,-21
7874,0,0,6,0,-6
7875,1,0,41,0,-41
7876,0,0,222,0,-222
7877,1,0,63,0,-63
7878,0,0,35,0,-35
7879,1,0,53,0,-53
7880,1,1,743,1789,1046
7881,0,0,44,0,-44
7882,0,0,183,0,-183
7883,0,0,10,0,-10
7884,1,0,30,0,-30
7885,1,1,171,1629,1458
7886,0,0,23,0,-23
7887,0,0,129,0,-129
7888,0,0,85,0,-85
7889,1,0,39,0,-39
7890,0,0,17,0,-17
7891,0,0,21,0,-21
7892,1,0,2,0,-2
7893,1,0,15,0,-15
7894,0,0,72,0,-72
7895,1,1,408,1822,1414
7896,1,0,66,0,-66
7897,0,0,36,0,-36
7898,1,0,5,0,-5
7899,1,0,152,0,-152
7900,1,1,1734,1445,-289
7901,1,1,217,1969,1752
7902,0,0,36,0,-36
7903,1,1,136,1225,1089
7904,1,1,347,1402,1055
7905,1,1,192,1470,1278
7906,0,0,9,0,-9
7907,1,1,52,1775,1723
7908,1,1,244,2154,1910
7909,1,0,38,0,-38
7910,1,0,177,0,-177
7911,0,0,62,0,-62
7912,1,1,269,1769,1500
7913,1,1,2184,1257,-927
7914,1,1,203,1223,1020
7915,1,1,59,1404,1345
7916,0,0,21,0,-21
7917,1,0,17,0,-17
7918,0,0,148,0,-148
7919,0,0,4,0,-4
7920,0,0,21,0,-21
7921,1,1,861,2058,1197
7922,0,0,111,0,-111
7923,1,0,159,0,-159
7924,1,0,139,0,-139
7925,1,1,668,1473,805
7926,0,0,14,0,-14
7927,1,0,20,0,-20
7928,0,0,65,0,-65
7929,0,0,8,0,-8
7930,1,1,404,1899,1495
7931,1,0,10,0,-10
7932,0,0,7,0,-7
7933,0,0,64,0,-64
7934,0,0,6,0,-6
7935,1,0,159,0,-159
7936,1,0,21,0,-21
7937,0,0,76,0,-76
7938,1,1,65,1407,1342
7939,1,0,53,0,-53
7940,1,0,32,0,-32
7941,1,0,34,0,-34
7942,0,0,82,0,-82
7943,1,1,1015,1271,256
7944,1,1,492,1220,728
7945,0,0,131,0,-131
7946,0,0,2,0,-2
7947,0,0,39,0,-39
7948,1,0,129,0,-129
7949,1,0,16,0,-16
7950,1,0,48,0,-48
7951,1,1,155,2760,2605
7952,0,0,79,0,-79
7953,0,0,35,0,-35
7954,1,0,75,0,-75
7955,1,1,358,1263,905
7956,1,0,11,0,-11
7957,0,0,88,0,-88
7958,0,0,40,0,-40
7959,1,0,189,0,-189
7960,0,0,9,0,-9
7961,1,1,943,1377,434
7962,1,0,5,0,-5
7963,1,0,26,0,-26
7964,1,1,454,1260,806
7965,1,1,376,1240,864
7966,0,0,11,0,-11
7967,0,0,61,0,-61
7968,0,0,166,0,-166
7969,1,1,782,1325,543
7970,0,0,11,0,-11
7971,1,0,162,0,-162
7972,1,1,1218,2020,802
7973,1,1,102,1438,1336
7974,1,1,375,2446,2071
7975,0,0,1,0,-1
7976,0,0,39,0,-39
7977,1,0,18,0,-18
7978,1,1,1088,1468,380
7979,1,1,595,1370,775
7980,0,0,46,0,-46
7981,1,0,43,0,-43
7982,1,1,139,1570,1431
7983,1,0,31,0,-31
7984,1,0,27,0,-27
7985,0,0,49,0,-49
7986,1,1,196,1362,1166
7987,1,0,23,0,-23
7988,1,0,52,0,-52
7989,1,0,26,0,-26
7990,1,1,150,1344,1194
7991,0,0,5,0,-5
7992,0,0,33,0,-33
7993,0,0,166,0,-166
7994,1,1,305,1495,1190
7995,1,0,52,0,-52
7996,1,1,260,1223,963
7997,0,0,24,0,-24
7998,1,0,56,0,-56
7999,1,1,501,1264,763
8000,1,1,607,1309,702
8001,1,0,48,0,-48
8002,0,0,43,0,-43
8003,1,1,153,2180,2027
8004,1,0,118,0,-118
8005,0,0,7,0,-7
8006,1,1,839,1216,377
8007,0,0,7,0,-7
8008,0,0,0,0,0
8009,0,0,100,0,-100
8010,1,0,0,0,0
8011,1,0,1,0,-1
8012,0,0,1,0,-1
8013,1,1,135,2100,1965
8014,1,1,612,1531,919
8015,0,0,13,0,-13
8016,1,1,136,1248,1112
8017,1,1,1802,1559,-243
8018,0,0,107,0,-107
8019,1,0,13,0,-13
8020,0,0,18,0,-18
8021,1,0,10,0,-10
8022,1,0,1,0,-1
8023,1,0,172,0,-172
8024,1,0,55,0,-55
8025,1,0,67,0,-67
8026,1,0,2,0,-2
8027,1,0,15,0,-15
8028,0,0,3,0,-3
8029,1,1,696,1293,597
8030,0,0,6,0,-6
8031,0,0,68,0,-68
8032,1,1,630,1505,875
8033,1,1,30,1325,1295
8034,1,1,117,1205,1088
8035,0,0,9,0,-9
8036,1,0,116,0,-116
8037,0,0,27,0,-27
8038,1,1,624,1202,578
8039,0,0,3,0,-3
8040,0,0,16,0,-16
8041,0,0,36,0,-36
8042,1,1,1134,1861,727
8043,0,0,40,0,-40
8044,0,0,7,0,-7
8045,1,0,143,0,-143
8046,1,1,70,1228,1158
8047,1,0,32,0,-32
8048,1,0,57,0,-57
8049,1,0,6,0,-6
8050,1,1,150,1493,1343
8051,0,0,104,0,-104
8052,1,1,449,3136,2687
8053,1,0,20,0,-20
8054,1,0,23,0,-23
8055,1,0,8,0,-8
8056,1,1,208,1256,1048
8057,1,0,63,0,-63
8058,1,0,12,0,-12
8059,0,0,69,0,-69
8060,0,0,86,0,-86
8061,1,1,558,1300,742
8062,1,0,26,0,-26
8063,0,0,24,0,-24
8064,1,1,183,1691,1508
8065,1,1,580,1728,1148
8066,0,0,18,0,-18
8067,1,0,22,0,-22
8068,0,0,22,0,-22
8069,1,0,12,0,-12
8070,0,0,79,0,-79
8071,1,1,86,1285,1199
8072,0,0,145,0,-145
8073,0,0,82,0,-82
8074,0,0,73,0,-73
8075,0,0,0,0,0
8076,1,0,13,0,-13
8077,1,0,5,0,-5
8078,1,0,15,0,-15
8079,1,0,26,0,-26
8080,1,1,529,1526,997
8081,1,0,72,0,-72
8082,0,0,64,0,-64
8083,1,0,7,0,-7
8084,0,0,47,0,-47
8085,1,0,1,0,-1
8086,0,0,1,0,-1
8087,1,1,1343,2136,793
8088,0,0,41,0,-41
8089,1,0,4,0,-4
8090,1,0,31,0,-31
8091,1,0,79,0,-79
8092,0,0,49,0,-49
8093,1,1,1289,2422,1133
8094,0,0,33,0,-33
8095,1,0,25,0,-25
8096,1,1,443,1408,965
8097,0,0,188,0,-188
8098,1,0,25,0,-25
8099,1,1,122,2965,2843
8100,0,0,12,0,-12
8101,0,0,50,0,-50
8102,1,0,15,0,-15
8103,1,0,33,0,-33
8104,1,0,65,0,-65
8105,0,0,10,0,-10
8106,1,1,256,2534,2278
8107,0,0,18,0,-18
8108,0,0,15,0,-15
8109,1,1,813,1296,483
8110,0,0,22,0,-22
8111,1,1,1027,1361,334
8112,1,0,183,0,-183
8113,0,0,67,0,-67
8114,0,0,13,0,-13
8115,1,1,358,1238,880
8116,0,0,16,0,-16
8117,1,1,143,1227,1084
8118,1,0,22,0,-22
8119,0,0,20,0,-20
8120,1,0,15,0,-15
8121,0,0,1,0,-1
8122,1,1,553,1827,1274
8123,1,0,86,0,-86
8124,1,0,94,0,-94
8125,0,0,69,0,-69
8126,0,0,207,0,-207
8127,1,1,41,1347,1306
8128,0,0,100,0,-100
8129,1,1,461,1238,777
8130,1,0,7,0,-7
8131,0,0,12,0,-12
8132,0,0,55,0,-55
8133,1,0,38,0,-38
8134,1,1,264,2265,2001
8135,1,1,512,1705,1193
8136,0,0,19,0,-19
8137,1,1,69,1360,1291
8138,0,0,11,0,-11
8139,0,0,66,0,-66
8140,1,0,15,0,-15
8141,1,0,6,0,-6
8142,1,0,0,0,0
8143,0,0,114,0,-114
8144,0,0,73,0,-73
8145,1,1,40,1601,1561
8146,1,1,197,2452,2255
8147,1,0,42,0,-42
8148,1,1,1011,1251,240
8149,1,0,9,0,-9
8150,1,0,66,0,-66
8151,1,0,10,0,-10
8152,0,0,44,0,-44
8153,0,0,17,0,-17
8154,1,0,0,0,0
8155,0,0,35,0,-35
8156,1,0,17,0,-17
8157,1,1,138,1253,1115
8158,1,0,74,0,-74
8159,0,0,85,0,-85
8160,0,0,126,0,-126
8161,1,1,897,2299,1402
8162,1,1,633,1301,668
8163,0,0,2,0,-2
8164,1,1,818,1310,492
8165,1,1,550,1596,1046
8166,1,1,758,1255,497
8167,0,0,27,0,-27
8168,1,0,10,0,-10
8169,1,0,120,0,-120
8170,1,0,18,0,-18
8171,0,0,53,0,-53
8172,0,0,81,0,-81
8173,0,0,11,0,-11
8174,0,0,59,0,-59
8175,1,1,765,1228,463
8176,1,1,66,1631,1565
8177,1,1,663,1827,1164
8178,1,0,6,0,-6
8179,0,0,23,0,-23
8180,1,1,164,1637,1473
8181,0,0,30,0,-30
8182,1,0,43,0,-43
8183,0,0,42,0,-42
8184,0,0,36,0,-36
8185,1,1,156,1214,1058
8186,1,0,76,0,-76
8187,1,0,51,0,-51
8188,1,0,42,0,-42
8189,0,0,65,0,-65
8190,0,0,30,0,-30
8191,1,0,61,0,-61
8192,0,0,65,0,-65
8193,1,1,121,1286,1165
8194,0,0,37,0,-37
8195,1,0,66,0,-66
8196,1,0,2,0,-2
8197,1,1,170,2125,1955
8198,1,1,358,1277,919
8199,1,0,0,0,0
8200,0,0,45,0,-45
8201,1,0,9,0,-9
8202,1,1,290,1206,916
8203,1,0,45,0,-45
8204,1,0,178,0,-178
8205,0,0,9,0,-9
8206,1,1,497,2328,1831
8207,1,0,65,0,-65
8208,0,0,19,0,-19
8209,1,0,115,0,-115
8210,1,0,102,0,-102
8211,0,0,80,0,-80
8212,1,1,228,1340,1112
8213,0,0,81,0,-81
8214,1,0,4,0,-4
8215,1,1,24,1289,1265
8216,1,0,94,0,-94
8217,0,0,14,0,-14
8218,1,0,17,0,-17
8219,0,0,0,0,0
8220,1,0,11,0,-11
8221,1,0,54,0,-54
8222,1,0,48,0,-48
8223,1,1,499,2058,1559
8224,0,0,77,0,-77
8225,1,1,271,1266,995
8226,1,0,25,0,-25
8227,0,0,97,0,-97
8228,1,1,1102,2939,1837
8229,0,0,5,0,-5
8230,1,0,33,0,-33
8231,0,0,27,0,-27
8232,1,0,20,0,-20
8233,1,0,12,0,-12
8234,1,1,947,1231,284
8235,0,0,75,0,-75
8236,1,0,39,0,-39
8237,1,0,169,0,-169
8238,1,0,53,0,-53
8239,0,0,37,0,-37
8240,1,0,7,0,-7
8241,1,1,682,1407,725
8242,1,0,19,0,-19
8243,0,0,8,0,-8
8244,1,0,54,0,-54
8245,0,0,38,0,-38
8246,0,0,1,0,-1
8247,1,0,185,0,-185
8248,0,0,2,0,-2
8249,1,0,77,0,-77
8250,1,0,37,0,-37
8251,0,0,2,0,-2
8252,0,0,20,0,-20
8253,0,0,13,0,-13
8254,0,0,5,0,-5
8255,1,1,1586,1239,-347
8256,1,1,376,1284,908
8257,1,1,580,1547,967
8258,1,0,54,0,-54
8259,1,1,762,1383,621
8260,0,0,15,0,-15
8261,1,0,56,0,-56
8262,1,1,131,1213,1082
8263,1,0,28,0,-28
8264,1,0,91,0,-91
8265,1,1,999,1516,517
8266,0,0,72,0,-72
8267,0,0,26,0,-26
8268,1,1,521,1293,772
8269,1,0,67,0,-67
8270,1,0,12,0,-12
8271,0,0,52,0,-52
8272,1,0,45,0,-45
8273,0,0,311,0,-311
8274,1,0,57,0,-57
8275,1,0,57,0,-57
8276,1,1,1029,1317,288
8277,1,1,169,1338,1169
8278,1,0,213,0,-213
8279,1,0,98,0,-98
8280,0,0,18,0,-18
8281,0,0,86,0,-86
8282,0,0,29,0,-29
8283,1,0,13,0,-13
8284,1,0,7,0,-7
8285,1,0,5,0,-5
8286,1,0,21,0,-21
8287,1,0,8,0,-8
8288,1,1,1163,1775,612
8289,0,0,88,0,-88
8290,0,0,39,0,-39
8291,1,1,3274,1407,-1867
8292,1,1,305,1506,1201
8293,1,1,410,1387,977
8294,1,0,19,0,-19
8295,1,1,35,1300,1265
8296,1,0,24,0,-24
8297,1,0,35,0,-35
8298,0,0,9,0,-9
8299,1,0,64,0,-64
8300,1,1,86,1743,1657
8301,0,0,105,0,-105
8302,0,0,83,0,-83
8303,1,0,30,0,-30
8304,1,0,13,0,-13
8305,0,0,101,0,-101
8306,0,0,74,0,-74
8307,1,1,88,1621,1533
8308,0,0,103,0,-103
8309,0,0,35,0,-35
8310,1,0,59,0,-59
8311,0,0,87,0,-87
8312,0,0,33,0,-33
8313,0,0,31,0,-31
8314,1,1,476,1621,1145
8315,1,1,355,1372,1017
8316,1,1,552,1241,689
8317,1,0,74,0,-74
8318,0,0,17,0,-17
8319,1,0,130,0,-130
8320,1,1,640,1371,731
8321,1,1,648,1326,678
8322,1,1,166,2013,1847
8323,1,1,603,2366,1763
8324,0,0,6,0,-6
8325,0,0,14,0,-14
8326,1,1,584,1724,1140
8327,0,0,9,0,-9
8328,1,0,44,0,-44
8329,0,0,18,0,-18
8330,1,0,41,0,-41
8331,0,0,57,0,-57
8332,0,0,0,0,0
8333,1,0,9,0,-9
8334,0,0,4,0,-4
8335,1,1,1215,1686,471
8336,1,0,83,0,-83
8337,0,0,105,0,-105
8338,1,0,26,0,-26
8339,0,0,32,0,-32
8340,1,0,14,0,-14
8341,1,1,25,1803,1778
8342,1,0,4,0,-4
8343,0,0,47,0,-47
8344,1,0,31,0,-31
8345,0,0,44,0,-44
8346,0,0,27,0,-27
8347,1,1,171,1237,1066
8348,1,0,5,0,-5
8349,1,1,113,1649,1536
8350,1,0,33,0,-33
8351,1,1,447,1480,1033
8352,0,0,10,0,-10
8353,0,0,11,0,-11
8354,1,0,85,0,-85
8355,1,0,75,0,-75
8356,1,0,92,0,-92
8357,1,0,110,0,-110
8358,0,0,13,0,-13
8359,0,0,38,0,-38
8360,0,0,18,0,-18
8361,0,0,4,0,-4
8362,0,0,73,0,-73
8363,1,0,57,0,-57
8364,1,0,13,0,-13
8365,0,0,3,0,-3
8366,1,0,107,0,-107
8367,1,0,31,0,-31
8368,1,0,11,0,-11
8369,1,0,18,0,-18
8370,1,1,1015,1331,316
8371,1,1,84,1813,1729
8372,0,0,2,0,-2
8373,0,0,5,0,-5
8374,1,1,374,1366,992
8375,1,1,473,1356,883
8376,1,0,24,0,-24
8377,1,0,7,0,-7
8378,1,1,267,1204,937
8379,1,0,88,0,-88
8380,1,0,62,0,-62
8381,1,0,36,0,-36
8382,0,0,26,0,-26
8383,0,0,17,0,-17
8384,1,0,56,0,-56
8385,0,0,1,0,-1
8386,1,1,47,1955,1908
8387,1,0,7,0,-7
8388,1,1,503,1426,923
8389,1,1,699,1483,784
8390,0,0,42,0,-42
8391,0,0,2,0,-2
8392,0,0,28,0,-28
8393,1,1,1019,1665,646
8394,0,0,35,0,-35
8395,1,0,101,0,-101
8396,1,0,19,0,-19
8397,0,0,26,0,-26
8398,0,0,40,0,-40
8399,0,0,3,0,-3
8400,1,1,267,1351,1084
8401,1,0,18,0,-18
8402,0,0,17,0,-17
8403,1,0,23,0,-23
8404,1,0,60,0,-60
8405,0,0,17,0,-17
8406,0,0,55,0,-55
8407,1,0,10,0,-10
8408,0,0,7,0,-7
8409,1,1,183,2914,2731
8410,0,0,10,0,-10
8411,1,1,251,1377,1126
8412,1,0,185,0,-185
8413,1,0,7,0,-7
8414,0,0,55,0,-55
8415,1,0,10,0,-10
8416,1,0,37,0,-37
8417,1,0,128,0,-128
8418,0,0,73,0,-73
8419,1,1,584,1381,797
8420,0,0,8,0,-8
8421,1,0,18,0,-18
8422,0,0,6,0,-6
8423,1,1,352,1293,941
8424,0,0,26,0,-26
8425,1,0,20,0,-20
8426,0,0,4,0,-4
8427,1,1,226,1580,1354
8428,0,0,74,0,-74
8429,1,1,959,1408,449
8430,1,1,158,1487,1329
8431,1,0,22,0,-22
8432,0,0,45,0,-45
8433,0,0,30,0,-30
8434,1,0,82,0,-82
8435,1,1,131,1419,1288
8436,0,0,21,0,-21
8437,1,0,7,0,-7
8438,1,0,6,0,-6
8439,1,1,247,1287,1040
8440,0,0,77,0,-77
8441,1,1,1822,1245,-577
8442,0,0,4,0,-4
8443,0,0,158,0,-158
8444,1,0,31,0,-31
8445,1,1,308,1791,1483
8446,1,1,209,1566,1357
8447,1,1,203,1228,1025
8448,0,0,138,0,-138
8449,0,0,0,0,0
8450,0,0,52,0,-52
8451,0,0,27,0,-27
8452,0,0,91,0,-91
8453,1,1,912,1532,620
8454,1,0,32,0,-32
8455,1,1,267,1948,1681
8456,0,0,36,0,-36
8457,0,0,112,0,-112
8458,1,0,6,0,-6
8459,0,0,70,0,-70
8460,1,0,2,0,-2
8461,0,0,37,0,-37
8462,1,0,23,0,-23
8463,1,0,75,0,-75
8464,0,0,19,0,-19
8465,1,1,847,1737,890
8466,1,0,37,0,-37
8467,0,0,21,0,-21
8468,1,1,523,1202,679
8469,1,0,55,0,-55
8470,1,1,269,2440,2171
8471,1,0,18,0,-18
8472,1,1,319,1338,1019
8473,0,0,35,0,-35
8474,0,0,20,0,-20
8475,0,0,85,0,-85
8476,0,0,80,0,-80
8477,1,0,11,0,-11
8478,1,0,1,0,-1
8479,1,0,56,0,-56
8480,1,0,7,0,-7
8481,1,1,134,1210,1076
8482,1,1,1384,1476,92
8483,1,0,2,0,-2
8484,0,0,23,0,-23
8485,0,0,80,0,-80
8486,1,0,49,0,-49
8487,1,1,203,1325,1122
8488,1,1,343,1611,1268
8489,1,1,282,1217,935
8490,1,1,2074,1634,-440
8491,1,1,301,1254,953
8492,1,1,168,1281,1113
8493,0,0,153,0,-153
8494,0,0,64,0,-64
8495,0,0,3,0,-3
8496,1,0,76,0,-76
8497,0,0,91,0,-91
8498,1,0,96,0,-96
8499,0,0,73,0,-73
8500,0,0,60,0,-60
8501,0,0,89,0,-89
8502,0,0,2,0,-2
8503,1,1,2782,1249,-1533
8504,1,0,5,0,-5
8505,0,0,50,0,-50
8506,1,0,26,0,-26
8507,1,0,43,0,-43
8508,0,0,38,0,-38
8509,1,0,57,0,-57
8510,0,0,4,0,-4
8511,0,0,77,0,-77
8512,0,0,20,0,-20
8513,0,0,164,0,-164
8514,1,1,75,1343,1268
8515,0,0,14,0,-14
8516,0,0,29,0,-29
8517,0,0,13,0,-13
8518,1,0,33,0,-33
8519,0,0,101,0,-101
8520,1,1,3729,1308,-2421
8521,1,0,86,0,-86
8522,1,1,754,1289,535
8523,1,1,13,1224,1211
8524,1,0,122,0,-122
8525,1,1,205,1640,1435
8526,0,0,238,0,-238
8527,1,1,155,1209,1054
8528,1,1,230,2018,1788
8529,1,1,110,1672,1562
8530,1,1,490,2255,1765
8531,0,0,44,0,-44
8532,1,1,1318,1459,141
8533,1,1,415,1635,1220
8534,1,1,145,1228,1083
8535,1,0,89,0,-89
8536,0,0,74,0,-74
8537,1,1,659,2220,1561
8538,1,0,61,0,-61
8539,1,1,129,1940,1811
8540,1,0,30,0,-30
8541,0,0,39,0,-39
8542,1,1,321,1447,1126
8543,1,1,1473,1213,-260
8544,1,0,1,0,-1
8545,1,0,0,0,0
8546,0,0,6,0,-6
8547,1,0,19,0,-19
8548,0,0,171,0,-171
8549,1,1,652,1414,762
8550,1,1,465,1303,838
8551,1,0,95,0,-95
8552,0,0,22,0,-22
8553,0,0,5,0,-5
8554,1,1,243,1408,1165
8555,1,1,568,1964,1396
8556,1,0,5,0,-5
8557,1,1,1635,1717,82
8558,1,0,31,0,-31
8559,0,0,4,0,-4
8560,1,0,27,0,-27
8561,1,1,188,1293,1105
8562,0,0,4,0,-4
8563,1,1,682,1294,612
8564,0,0,0,0,0
8565,1,1,200,1639,1439
8566,0,0,12,0,-12
8567,1,0,26,0,-26
8568,1,0,20,0,-20
8569,0,0,42,0,-42
8570,1,1,403,1300,897
8571,1,0,111,0,-111
8572,0,0,58,0,-58
8573,0,0,33,0,-33
8574,1,0,124,0,-124
8575,1,0,94,0,-94
8576,0,0,132,0,-132
8577,1,1,743,1394,651
8578,1,1,451,1215,764
8579,1,0,38,0,-38
8580,0,0,1,0,-1
8581,0,0,101,0,-101
8582,0,0,24,0,-24
8583,1,1,358,1374,1016
8584,1,0,63,0,-63
8585,1,0,26,0,-26
8586,1,0,43,0,-43
8587,1,1,187,1298,1111
8588,0,0,45,0,-45
8589,0,0,27,0,-27
8590,0,0,75,0,-75
8591,0,0,28,0,-28
8592,0,0,16,0,-16
8593,1,0,2,0,-2
8594,1,0,60,0,-60
8595,0,0,6,0,-6
8596,1,0,130,0,-130
8597,1,1,142,1514,1372
8598,1,1,980,3814,2834
8599,1,0,25,0,-25
8600,0,0,58,0,-58
8601,1,0,15,0,-15
8602,0,0,34,0,-34
8603,1,1,371,1461,1090
8604,0,0,35,0,-35
8605,1,0,79,0,-79
8606,0,0,27,0,-27
8607,1,0,3,0,-3
8608,1,1,442,1527,1085
8609,0,0,39,0,-39
8610,0,0,18,0,-18
8611,1,1,367,1447,1080
8612,1,0,33,0,-33
8613,0,0,1,0,-1
8614,1,1,738,1633,895
8615,1,1,68,2348,2280
8616,1,0,40,0,-40
8617,1,1,154,1238,1084
8618,1,0,128,0,-128
8619,0,0,51,0,-51
8620,1,1,203,1692,1489
8621,1,0,181,0,-181
8622,0,0,93,0,-93
8623,0,0,54,0,-54
8624,0,0,22,0,-22
8625,0,0,19,0,-19
8626,1,1,701,1214,513
8627,1,0,29,0,-29
8628,1,0,139,0,-139
8629,0,0,15,0,-15
8630,1,1,388,1637,1249
8631,1,0,44,0,-44
8632,1,1,124,1201,1077
8633,1,1,967,1253,286
8634,0,0,9,0,-9
8635,0,0,49,0,-49
8636,1,1,1159,1950,791
8637,0,0,30,0,-30
8638,1,1,941,1395,454
8639,0,0,111,0,-111
8640,1,1,250,1958,1708
8641,1,0,48,0,-48
8642,1,1,547,2203,1656
8643,1,1,1449,1357,-92
8644,1,0,6,0,-6
8645,1,0,35,0,-35
8646,0,0,16,0,-16
8647,1,0,62,0,-62
8648,1,0,56,0,-56
8649,1,1,460,1407,947
8650,1,0,6,0,-6
8651,0,0,19,0,-19
8652,0,0,13,0,-13
8653,0,0,54,0,-54
8654,1,0,30,0,-30
8655,0,0,33,0,-33
8656,1,0,15,0,-15
8657,1,0,67,0,-67
8658,1,1,92,1204,1112
8659,0,0,113,0,-113
8660,1,0,33,0,-33
8661,1,0,73,0,-73
8662,0,0,36,0,-36
8663,1,1,192,1408,1216
8664,0,0,70,0,-70
8665,0,0,177,0,-177
8666,0,0,6,0,-6
8667,1,0,17,0,-17
8668,0,0,30,0,-30
8669,1,1,432,1723,1291
8670,1,0,7,0,-7
8671,1,1,87,1253,1166
8672,1,1,905,1537,632
8673,1,1,271,2192,1921
8674,1,0,34,0,-34
8675,0,0,44,0,-44
8676,1,1,175,2271,2096
8677,1,1,1606,1280,-326
8678,1,0,1,0,-1
8679,0,0,55,0,-55
8680,1,1,352,1212,860
8681,0,0,63,0,-63
8682,1,1,2046,1519,-527
8683,1,1,424,1406,982
8684,1,1,145,1293,1148
8685,1,1,147,1250,1103
8686,0,0,58,0,-58
8687,1,1,623,1402,779
8688,1,1,102,1338,1236
8689,1,1,470,1212,742
8690,0,0,27,0,-27
8691,0,0,51,0,-51
8692,0,0,4,0,-4
8693,1,0,33,0,-33
8694,0,0,4,0,-4
8695,1,1,1756,1210,-546
8696,1,1,621,1422,801
8697,0,0,55,0,-55
8698,0,0,1,0,-1
8699,0,0,38,0,-38
8700,1,1,537,1316,779
8701,1,0,9,0,-9
8702,0,0,55,0,-55
8703,1,1,348,1973,1625
8704,1,0,103,0,-103
8705,0,0,70,0,-70
8706,0,0,96,0,-96
8707,1,1,1969,1701,-268
8708,1,1,65,1305,1240
8709,1,0,53,0,-53
8710,1,0,63,0,-63
8711,0,0,91,0,-91
8712,1,0,29,0,-29
8713,1,1,130,3805,3675
8714,1,0,82,0,-82
8715,0,0,28,0,-28
8716,0,0,28,0,-28
8717,1,1,123,1200,1077
8718,1,1,718,1247,529
8719,1,1,1980,1920,-60
8720,1,1,927,1395,468
8721,1,0,8,0,-8
8722,0,0,15,0,-15
8723,0,0,17,0,-17
8724,0,0,1,0,-1
8725,0,0,97,0,-97
8726,1,1,60,1448,1388
8727,1,0,39,0,-39
8728,0,0,3,0,-3
8729,1,0,23,0,-23
8730,0,0,64,0,-64
8731,1,1,184,2164,1980
8732,0,0,14,0,-14
8733,1,0,4,0,-4
8734,1,0,7,0,-7
8735,1,1,55,1830,1775
8736,1,0,3,0,-3
8737,1,1,142,1797,1655
8738,0,0,177,0,-177
8739,1,0,46,0,-46
8740,1,0,5,0,-5
8741,1,0,66,0,-66
8742,1,1,120,1529,1409
8743,1,1,174,3310,3136
8744,0,0,151,0,-151
8745,1,1,1814,1502,-312
8746,1,1,603,1207,604
8747,1,1,36,1548,1512
8748,0,0,7,0,-7
8749,0,0,66,0,-66
8750,1,1,398,1201,803
8751,0,0,62,0,-62
8752,1,0,91,0,-91
8753,1,1,782,6181,5399
8754,1,1,288,1272,984
8755,1,1,103,1862,1759
8756,0,0,36,0,-36
8757,1,1,284,1908,1624
8758,1,0,44,0,-44
8759,1,1,76,1254,1178
8760,1,1,901,1301,400
8761,1,1,1954,1421,-533
8762,0,0,92,0,-92
8763,1,0,98,0,-98
8764,1,0,21,0,-21
8765,1,1,487,1556,1069
8766,0,0,1,0,-1
8767,0,0,26,0,-26
8768,1,1,58,1674,1616
8769,1,0,85,0,-85
8770,1,0,17,0,-17
8771,1,0,46,0,-46
8772,1,1,1004,1457,453
8773,0,0,60,0,-60
8774,0,0,16,0,-16
8775,1,1,58,1413,1355
8776,1,1,156,1240,1084
8777,1,1,351,1285,934
8778,1,1,1555,1210,-345
8779,0,0,65,0,-65
8780,1,1,518,1980,1462
8781,0,0,19,0,-19
8782,1,0,11,0,-11
8783,0,0,42,0,-42
8784,0,0,52,0,-52
8785,1,1,222,1904,1682
8786,0,0,68,0,-68
8787,0,0,26,0,-26
8788,0,0,25,0,-25
8789,1,1,1130,1374,244
8790,1,1,47,1593,1546
8791,1,0,18,0,-18
8792,1,0,5,0,-5
8793,1,1,922,1623,701
8794,1,1,681,1446,765
8795,1,0,24,0,-24
8796,1,0,7,0,-7
8797,1,0,41,0,-41
8798,0,0,1,0,-1
8799,1,1,2455,1365,-1090
8800,1,0,39,0,-39
8801,1,1,895,1539,644
8802,1,0,32,0,-32
8803,1,0,9,0,-9
8804,1,0,49,0,-49
8805,1,0,18,0,-18
8806,1,1,2054,1649,-405
8807,1,0,7,0,-7
8808,1,0,163,0,-163
8809,0,0,35,0,-35
8810,1,0,61,0,-61
8811,1,0,33,0,-33
8812,0,0,20,0,-20
8813,1,0,72,0,-72
8814,1,1,28,1646,1618
8815,1,1,2239,1208,-1031
8816,1,0,38,0,-38
8817,1,1,636,2458,1822
8818,0,0,16,0,-16
8819,0,0,38,0,-38
8820,1,0,2,0,-2
8821,0,0,0,0,0
8822,0,0,187,0,-187
8823,0,0,49,0,-49
8824,0,0,25,0,-25
8825,0,0,66,0,-66
8826,0,0,19,0,-19
8827,1,0,143,0,-143
8828,0,0,106,0,-106
8829,1,1,323,1202,879
8830,0,0,152,0,-152
8831,0,0,17,0,-17
8832,1,0,2,0,-2
8833,1,1,1340,1410,70
8834,0,0,27,0,-27
8835,0,0,307,0,-307
8836,0,0,5,0,-5
8837,0,0,222,0,-222
8838,1,0,66,0,-66
8839,1,1,414,2523,2109
8840,0,0,25,0,-25
8841,1,0,82,0,-82
8842,0,0,10,0,-10
8843,1,0,62,0,-62
8844,0,0,0,0,0
8845,1,0,39,0,-39
8846,1,1,241,1342,1101
8847,0,0,28,0,-28
8848,0,0,23,0,-23
8849,0,0,21,0,-21
8850,1,0,54,0,-54
8851,1,1,70,1387,1317
8852,1,0,60,0,-60
8853,1,0,27,0,-27
8854,1,0,29,0,-29
8855,1,0,83,0,-83
8856,0,0,114,0,-114
8857,0,0,52,0,-52
8858,0,0,8,0,-8
8859,0,0,2,0,-2
8860,0,0,181,0,-181
8861,1,1,291,1681,1390
8862,0,0,71,0,-71
8863,1,0,13,0,-13
8864,0,0,4,0,-4
8865,1,1,322,1685,1363
8866,1,1,716,1930,1214
8867,0,0,2,0,-2
8868,1,1,187,1387,1200
8869,0,0,197,0,-197
8870,0,0,37,0,-37
8871,1,1,691,2428,1737
8872,0,0,7,0,-7
8873,1,1,148,1209,1061
8874,1,1,1084,1261,177
8875,1,0,10,0,-10
8876,1,1,112,1280,1168
8877,1,0,47,0,-47
8878,0,0,101,0,-101
8879,1,1,383,1269,886
8880,1,0,103,0,-103
8881,0,0,19,0,-19
8882,1,1,1819,1432,-387
8883,0,0,36,0,-36
8884,0,0,6,0,-6
8885,0,0,57,0,-57
8886,0,0,27,0,-27
8887,0,0,67,0,-67
8888,1,1,109,1382,1273
8889,1,0,43,0,-43
8890,1,0,46,0,-46
8891,0,0,25,0,-25
8892,1,0,137,0,-137
8893,0,0,0,0,0
8894,0,0,88,0,-88
8895,1,0,2,0,-2
8896,0,0,86,0,-86
8897,1,1,1223,1941,718
8898,0,0,52,0,-52
8899,0,0,44,0,-44
8900,1,0,26,0,-26
8901,0,0,68,0,-68
8902,0,0,141,0,-141
8903,0,0,50,0,-50
8904,1,0,69,0,-69
8905,1,1,345,1206,861
8906,0,0,19,0,-19
8907,1,0,108,0,-108
8908,1,1,18,1724,1706
8909,0,0,12,0,-12
8910,0,0,68,0,-68
8911,1,1,219,1404,1185
8912,1,0,20,0,-20
8913,1,0,16,0,-16
8914,1,0,94,0,-94
8915,1,1,72,1950,1878
8916,0,0,40,0,-40
8917,1,1,886,1380,494
8918,1,0,18,0,-18
8919,1,0,6,0,-6
8920,0,0,41,0,-41
8921,1,1,100,1306,1206
8922,1,1,30,1928,1898
8923,1,1,2179,1578,-601
8924,1,0,262,0,-262
8925,0,0,57,0,-57
8926,1,1,1882,1815,-67
8927,1,1,466,1578,1112
8928,1,0,152,0,-152
8929,0,0,0,0,0
8930,1,1,406,1395,989
8931,1,0,158,0,-158
8932,0,0,115,0,-115
8933,1,1,194,1240,1046
8934,1,0,9,0,-9
8935,1,0,4,0,-4
8936,0,0,104,0,-104
8937,1,1,257,1415,1158
8938,1,1,594,1273,679
8939,1,1,1125,2916,1791
8940,1,0,9,0,-9
8941,0,0,7,0,-7
8942,1,0,63,0,-63
8943,0,0,74,0,-74
8944,0,0,7,0,-7
8945,1,0,129,0,-129
8946,0,0,21,0,-21
8947,0,0,87,0,-87
8948,1,1,173,1972,1799
8949,0,0,32,0,-32
8950,0,0,1,0,-1
8951,1,0,13,0,-13
8952,1,0,93,0,-93
8953,1,0,11,0,-11
8954,0,0,101,0,-101
8955,0,0,20,0,-20
8956,0,0,4,0,-4
8957,1,0,79,0,-79
8958,0,0,98,0,-98
8959,0,0,17,0,-17
8960,1,0,33,0,-33
8961,0,0,14,0,-14
8962,1,1,1718,1606,-112
8963,1,0,21,0,-21
8964,0,0,90,0,-90
8965,1,1,188,1207,1019
8966,0,0,102,0,-102
8967,1,1,256,1719,1463
8968,1,0,25,0,-25
8969,1,1,15,1333,1318
8970,1,1,40,2099,2059
8971,1,1,1207,1277,70
8972,0,0,5,0,-5
8973,1,0,16,0,-16
8974,1,0,21,0,-21
8975,1,0,53,0,-53
8976,1,1,1204,2352,1148
8977,0,0,91,0,-91
8978,0,0,12,0,-12
8979,1,1,718,1371,653
8980,1,0,5,0,-5
8981,1,1,2114,1216,-898
8982,1,1,791,1447,656
8983,0,0,12,0,-12
8984,0,0,8,0,-8
8985,0,0,9,0,-9
8986,1,1,430,1462,1032
8987,1,1,196,1493,1297
8988,1,0,6,0,-6
8989,0,0,61,0,-61
8990,1,0,65,0,-65
8991,0,0,61,0,-61
8992,0,0,107,0,-107
8993,1,0,0,0,0
8994,0,0,33,0,-33
8995,1,1,1001,1342,341
8996,0,0,7,0,-7
8997,1,1,1344,1284,-60
8998,0,0,79,0,-79
8999,1,0,8,0,-8
9000,1,1,311,1351,1040
9001,1,0,34,0,-34
9002,1,1,391,1526,1135
9003,1,0,89,0,-89
9004,1,0,71,0,-71
9005,1,1,1203,1246,43
9006,1,1,625,2014,1389
9007,1,0,10,0,-10
9008,0,0,5,0,-5
9009,1,1,639,2059,1420
9010,0,0,236,0,-236
9011,1,1,142,1266,1124
9012,1,0,105,0,-105
9013,1,0,28,0,-28
9014,1,0,21,0,-21
9015,1,1,343,1521,1178
9016,1,0,50,0,-50
9017,1,0,37,0,-37
9018,1,0,6,0,-6
9019,0,0,35,0,-35
9020,1,0,109,0,-109
9021,1,1,140,1921,1781
9022,0,0,57,0,-57
9023,0,0,45,0,-45
9024,0,0,30,0,-30
9025,0,0,1,0,-1
9026,1,1,565,1230,665
9027,1,1,81,1365,1284
9028,1,1,296,1880,1584
9029,0,0,25,0,-25
9030,1,0,29,0,-29
9031,1,0,105,0,-105
9032,1,1,309,1674,1365
9033,1,0,61,0,-61
9034,1,1,98,1304,1206
9035,1,0,76,0,-76
9036,1,0,45,0,-45
9037,1,0,77,0,-77
9038,1,1,1154,1253,99
9039,1,1,1126,1922,796
9040,0,0,14,0,-14
9041,1,1,53,1646,1593
9042,1,0,36,0,-36
9043,0,0,2,0,-2
9044,1,0,140,0,-140
9045,0,0,12,0,-12
9046,0,0,3,0,-3
9047,1,1,386,1247,861
9048,1,1,226,1337,1111
9049,0,0,30,0,-30
9050,0,0,22,0,-22
9051,1,1,528,1695,1167
9052,1,0,21,0,-21
9053,0,0,29,0,-29
9054,0,0,5,0,-5
9055,1,1,218,3784,3566
9056,0,0,45,0,-45
9057,1,0,13,0,-13
9058,1,1,373,1489,1116
9059,1,1,215,1245,1030
9060,0,0,80,0,-80
9061,0,0,190,0,-190
9062,0,0,16,0,-16
9063,0,0,21,0,-21
9064,1,1,223,1680,1457
9065,0,0,29,0,-29
9066,1,0,21,0,-21
9067,0,0,125,0,-125
9068,0,0,79,0,-79
9069,1,1,417,2177,1760
9070,1,0,42,0,-42
9071,1,1,940,3312,2372
9072,0,0,4,0,-4
9073,0,0,10,0,-10
9074,1,0,39,0,-39
9075,0,0,75,0,-75
9076,1,1,1103,1471,368
9077,1,0,12,0,-12
9078,1,0,44,0,-44
9079,0,0,0,0,0
9080,0,0,2,0,-2
9081,0,0,147,0,-147
9082,1,0,32,0,-32
9083,0,0,50,0,-50
9084,0,0,34,0,-34
9085,1,1,60,1387,1327
9086,1,1,134,1264,1130
9087,1,1,1432,2244,812
9088,1,0,99,0,-99
9089,0,0,64,0,-64
9090,0,0,26,0,-26
9091,0,0,8,0,-8
9092,1,0,99,0,-99
9093,0,0,20,0,-20
9094,1,1,87,1329,1242
9095,1,0,21,0,-21
9096,0,0,14,0,-14
9097,1,0,10,0,-10
9098,1,1,657,1487,830
9099,1,0,51,0,-51
9100,0,0,34,0,-34
9101,1,0,188,0,-188
9102,1,1,816,1271,455
9103,0,0,27,0,-27
9104,0,0,55,0,-55
9105,1,0,16,0,-16
9106,1,1,56,1228,1172
9107,1,0,37,0,-37
9108,0,0,45,0,-45
9109,1,1,254,1307,1053
9110,1,0,23,0,-23
9111,1,0,18,0,-18
9112,0,0,21,0,-21
9113,1,0,21,0,-21
9114,1,0,19,0,-19
9115,1,0,45,0,-45
9116,0,0,120,0,-120
9117,0,0,8,0,-8
9118,1,1,339,2329,1990
9119,1,0,27,0,-27
9120,1,1,702,1201,499
9121,1,0,54,0,-54
9122,0,0,82,0,-82
9123,1,1,1449,1445,-4
9124,1,1,1110,1229,119
9125,0,0,125,0,-125
9126,0,0,14,0,-14
9127,1,0,22,0,-22
9128,1,0,55,0,-55
9129,0,0,106,0,-106
9130,1,0,198,0,-198
9131,1,1,767,1987,1220
9132,1,1,1055,1315,260
9133,1,1,419,1493,1074
9134,1,0,95,0,-95
9135,1,0,18,0,-18
9136,0,0,54,0,-54
9137,1,1,212,1370,1158
9138,1,1,121,1290,1169
9139,0,0,162,0,-162
9140,0,0,20,0,-20
9141,0,0,301,0,-301
9142,1,0,139,0,-139
9143,0,0,102,0,-102
9144,1,1,379,1336,957
9145,1,1,653,2887,2234
9146,0,0,31,0,-31
9147,1,1,951,1800,849
9148,1,0,2,0,-2
9149,0,0,141,0,-141
9150,0,0,59,0,-59
9151,1,0,63,0,-63
9152,1,0,7,0,-7
9153,0,0,15,0,-15
9154,0,0,31,0,-31
9155,1,1,1312,1206,-106
9156,1,0,26,0,-26
9157,1,0,5,0,-5
9158,1,1,1189,1304,115
9159,0,0,5,0,-5
9160,0,0,62,0,-62
9161,0,0,96,0,-96
9162,1,0,8,0,-8
9163,1,0,4,0,-4
9164,1,1,543,1230,687
9165,0,0,74,0,-74
9166,0,0,51,0,-51
9167,1,0,8,0,-8
9168,1,0,5,0,-5
9169,0,0,30,0,-30
9170,1,1,939,1521,582
9171,1,0,99,0,-99
9172,1,0,33,0,-33
9173,1,0,34,0,-34
9174,1,0,3,0,-3
9175,0,0,45,0,-45
9176,1,0,84,0,-84
9177,0,0,3,0,-3
9178,0,0,61,0,-61
9179,0,0,1,0,-1
9180,1,1,167,1682,1515
9181,1,0,8,0,-8
9182,1,0,27,0,-27
9183,1,1,148,1744,1596
9184,1,0,9,0,-9
9185,1,0,11,0,-11
9186,1,0,131,0,-131
9187,0,0,7,0,-7
9188,1,0,88,0,-88
9189,0,0,273,0,-273
9190,1,1,727,1235,508
9191,1,1,133,2018,1885
9192,1,0,25,0,-25
9193,1,0,53,0,-53
9194,1,1,246,1417,1171
9195,1,0,15,0,-15
9196,0,0,90,0,-90
9197,0,0,66,0,-66
9198,1,0,108,0,-108
9199,1,0,50,0,-50
9200,1,1,476,1249,773
9201,0,0,17,0,-17
9202,0,0,48,0,-48
9203,1,0,1,0,-1
9204,1,1,184,1508,1324
9205,0,0,9,0,-9
9206,0,0,1,0,-1
9207,0,0,79,0,-79
9208,0,0,62,0,-62
9209,1,1,2135,1911,-224
9210,1,0,27,0,-27
9211,0,0,3,0,-3
9212,1,1,466,1614,1148
9213,0,0,53,0,-53
9214,1,0,40,0,-40
9215,1,0,228,0,-228
9216,1,0,17,0,-17
9217,1,0,36,0,-36
9218,1,0,19,0,-19
9219,1,1,555,1437,882
9220,1,1,175,1330,1155
9221,1,1,222,1506,1284
9222,0,0,87,0,-87
9223,0,0,17,0,-17
9224,1,1,979,1363,384
9225,1,0,26,0,-26
9226,0,0,5,0,-5
9227,1,0,24,0,-24
9228,1,0,6,0,-6
9229,1,1,206,2252,2046
9230,1,0,17,0,-17
9231,1,1,539,1511,972
9232,1,1,1404,3175,1771
9233,1,0,33,0,-33
9234,1,0,24,0,-24
9235,1,1,568,1314,746
9236,1,0,110,0,-110
9237,1,0,21,0,-21
9238,1,0,87,0,-87
9239,1,0,109,0,-109
9240,0,0,73,0,-73
9241,1,1,111,1275,1164
9242,1,0,26,0,-26
9243,1,1,2078,2700,622
9244,0,0,152,0,-152
9245,0,0,28,0,-28
9246,0,0,17,0,-17
9247,0,0,45,0,-45
9248,1,1,370,2445,2075
9249,0,0,75,0,-75
9250,1,0,2,0,-2
9251,1,0,15,0,-15
9252,1,1,1053,1588,535
9253,1,0,8,0,-8
9254,0,0,28,0,-28
9255,1,0,136,0,-136
9256,0,0,156,0,-156
9257,1,0,50,0,-50
9258,0,0,19,0,-19
9259,1,0,41,0,-41
9260,1,1,190,1424,1234
9261,1,1,136,1282,1146
9262,1,1,175,1291,1116
9263,1,1,606,1279,673
9264,0,0,163,0,-163
9265,1,0,21,0,-21
9266,0,0,95,0,-95
9267,0,0,54,0,-54
9268,1,1,909,1237,328
9269,1,0,52,0,-52
9270,1,0,13,0,-13
9271,0,0,22,0,-22
9272,1,1,348,1342,994
9273,0,0,38,0,-38
9274,0,0,17,0,-17
9275,1,0,51,0,-51
9276,1,1,265,1266,1001
9277,0,0,36,0,-36
9278,1,0,27,0,-27
9279,1,0,18,0,-18
9280,1,1,223,1934,1711
9281,1,1,499,1503,1004
9282,1,0,0,0,0
9283,1,1,501,1312,811
9284,0,0,81,0,-81
9285,1,0,10,0,-10
9286,1,0,57,0,-57
9287,1,0,19,0,-19
9288,1,0,114,0,-114
9289,1,1,723,1524,801
9290,0,0,32,0,-32
9291,1,1,221,1370,1149
9292,1,0,24,0,-24
9293,1,0,5,0,-5
9294,1,1,153,1839,1686
9295,1,0,41,0,-41
9296,0,0,13,0,-13
9297,1,1,441,1239,798
9298,0,0,4,0,-4
9299,0,0,28,0,-28
9300,1,0,129,0,-129
9301,0,0,152,0,-152
9302,0,0,10,0,-10
9303,0,0,17,0,-17
9304,1,1,657,1201,544
9305,1,1,322,1272,950
9306,1,0,121,0,-121
9307,0,0,87,0,-87
9308,0,0,8,0,-8
9309,1,1,394,1274,880
9310,1,1,498,1266,768
9311,1,0,20,0,-20
9312,0,0,25,0,-25
9313,1,0,57,0,-57
9314,1,0,1,0,-1
9315,0,0,99,0,-99
9316,1,1,780,1596,816
9317,1,1,433,1339,906
9318,0,0,27,0,-27
9319,0,0,43,0,-43
9320,0,0,98,0,-98
9321,1,0,21,0,-21
9322,0,0,19,0,-19
9323,1,1,592,1476,884
9324,0,0,21,0,-21
9325,1,1,880,1253,373
9326,1,0,164,0,-164
9327,1,0,55,0,-55
9328,1,1,100,1620,1520
9329,0,0,15,0,-15
9330,1,1,106,1343,1237
9331,1,0,17,0,-17
9332,0,0,42,0,-42
9333,0,0,65,0,-65
9334,1,1,547,1410,863
9335,1,1,266,1481,1215
9336,1,0,18,0,-18
9337,0,0,9,0,-9
9338,1,0,97,0,-97
9339,1,1,590,2049,1459
9340,1,1,353,1272,919
9341,0,0,108,0,-108
9342,0,0,27,0,-27
9343,1,1,1586,1342,-244
9344,0,0,13,0,-13
9345,0,0,50,0,-50
9346,1,1,739,1802,1063
9347,0,0,46,0,-46
9348,1,0,102,0,-102
9349,1,1,1197,1238,41
9350,1,1,165,1295,1130
9351,1,0,18,0,-18
9352,0,0,196,0,-196
9353,0,0,45,0,-45
9354,1,1,672,1595,923
9355,1,1,1055,1370,315
9356,1,1,523,1454,931
9357,1,1,164,2911,2747
9358,1,0,79,0,-79
9359,1,0,67,0,-67
9360,1,1,218,1269,1051
9361,1,0,37,0,-37
9362,1,0,29,0,-29
9363,1,1,600,1239,639
9364,1,0,21,0,-21
9365,0,0,1,0,-1
9366,0,0,11,0,-11
9367,1,1,582,1366,784
9368,1,1,331,1318,987
9369,0,0,7,0,-7
9370,1,0,121,0,-121
9371,0,0,16,0,-16
9372,1,0,226,0,-226
9373,1,0,72,0,-72
9374,0,0,26,0,-26
9375,1,0,87,0,-87
9376,1,0,2,0,-2
9377,0,0,19,0,-19
9378,1,0,176,0,-176
9379,1,0,8,0,-8
9380,0,0,54,0,-54
9381,1,1,97,1256,1159
9382,0,0,24,0,-24
9383,1,0,23,0,-23
9384,0,0,17,0,-17
9385,1,1,209,1737,1528
9386,0,0,29,0,-29
9387,0,0,22,0,-22
9388,1,0,51,0,-51
9389,0,0,6,0,-6
9390,1,0,10,0,-10
9391,0,0,29,0,-29
9392,0,0,17,0,-17
9393,0,0,88,0,-88
9394,1,0,60,0,-60
9395,0,0,62,0,-62
9396,1,1,800,1280,480
9397,1,0,103,0,-103
9398,0,0,107,0,-107
9399,1,0,3,0,-3
9400,0,0,23,0,-23
9401,1,0,0,0,0
9402,0,0,10,0,-10
9403,0,0,19,0,-19
9404,1,0,26,0,-26
9405,1,1,301,2173,1872
9406,1,0,108,0,-108
9407,1,0,101,0,-101
9408,1,1,509,1805,1296
9409,1,1,641,3197,2556
9410,1,0,11,0,-11
9411,1,0,29,0,-29
9412,0,0,1,0,-1
9413,0,0,3,0,-3
9414,1,0,35,0,-35
9415,1,1,194,1393,1199
9416,1,1,691,1322,631
9417,1,1,611,1317,706
9418,1,1,1077,1243,166
9419,1,0,68,0,-68
9420,0,0,96,0,-96
9421,1,1,86,1729,1643
9422,1,1,737,1252,515
9423,1,1,629,1467,838
9424,0,0,10,0,-10
9425,0,0,34,0,-34
9426,0,0,47,0,-47
9427,1,1,676,2825,2149
9428,0,0,63,0,-63
9429,0,0,1,0,-1
9430,1,1,553,1297,744
9431,1,1,310,1533,1223
9432,0,0,41,0,-41
9433,0,0,44,0,-44
9434,1,0,33,0,-33
9435,1,1,170,3241,3071
9436,1,1,671,1349,678
9437,1,0,19,0,-19
9438,1,1,193,4509,4316
9439,1,0,29,0,-29
9440,0,0,5,0,-5
9441,1,0,25,0,-25
9442,1,0,26,0,-26
9443,1,1,143,1325,1182
9444,1,0,75,0,-75
9445,0,0,102,0,-102
9446,1,1,37,1257,1220
9447,0,0,216,0,-216
9448,1,0,33,0,-33
9449,0,0,64,0,-64
9450,0,0,5,0,-5
9451,1,1,390,1216,826
9452,0,0,2,0,-2
9453,1,1,1708,1204,-504
9454,1,1,360,1280,920
9455,0,0,58,0,-58
9456,1,0,22,0,-22
9457,0,0,58,0,-58
9458,0,0,5,0,-5
9459,1,0,46,0,-46
9460,0,0,2,0,-2
9461,1,0,43,0,-43
9462,1,1,1286,1240,-46
9463,0,0,84,0,-84
9464,1,0,5,0,-5
9465,0,0,2,0,-2
9466,1,0,53,0,-53
9467,1,0,102,0,-102
9468,0,0,51,0,-51
9469,0,0,1,0,-1
9470,1,0,2,0,-2
9471,0,0,35,0,-35
9472,1,1,513,1212,699
9473,0,0,17,0,-17
9474,0,0,2,0,-2
9475,0,0,198,0,-198
9476,1,0,35,0,-35
9477,0,0,90,0,-90
9478,1,1,1007,1374,367
9479,1,0,32,0,-32
9480,1,0,42,0,-42
9481,0,0,7,0,-7
9482,1,0,49,0,-49
9483,0,0,21,0,-21
9484,1,1,148,1514,1366
9485,0,0,33,0,-33
9486,1,1,152,4663,4511
9487,0,0,22,0,-22
9488,0,0,58,0,-58
9489,1,1,80,1686,1606
9490,1,0,7,0,-7
9491,1,0,185,0,-185
9492,0,0,12,0,-12
9493,0,0,68,0,-68
9494,0,0,11,0,-11
9495,0,0,42,0,-42
9496,1,0,5,0,-5
9497,0,0,27,0,-27
9498,0,0,55,0,-55
9499,1,0,78,0,-78
9500,1,0,35,0,-35
9501,0,0,2,0,-2
9502,0,0,40,0,-40
9503,1,0,3,0,-3
9504,1,1,211,1330,1119
9505,1,1,993,1299,306
9506,1,1,434,1679,1245
9507,1,0,48,0,-48
9508,1,0,35,0,-35
9509,1,0,35,0,-35
9510,0,0,5,0,-5
9511,1,1,83,1293,1210
9512,0,0,35,0,-35
9513,1,0,37,0,-37
9514,1,1,295,1391,1096
9515,1,0,108,0,-108
9516,1,1,620,1244,624
9517,1,0,29,0,-29
9518,1,0,4,0,-4
9519,0,0,31,0,-31
9520,1,0,37,0,-37
9521,0,0,41,0,-41
9522,1,1,870,2126,1256
9523,0,0,99,0,-99
9524,1,1,157,1269,1112
9525,1,0,9,0,-9
9526,1,0,44,0,-44
9527,1,0,65,0,-65
9528,1,1,46,1826,1780
9529,1,1,1354,1345,-9
9530,0,0,23,0,-23
9531,0,0,158,0,-158
9532,1,1,326,1216,890
9533,0,0,38,0,-38
9534,1,1,1396,1210,-186
9535,1,0,55,0,-55
9536,0,0,155,0,-155
9537,1,0,9,0,-9
9538,1,0,3,0,-3
9539,0,0,172,0,-172
9540,1,0,7,0,-7
9541,1,1,315,1294,979
9542,1,1,923,1531,608
9543,1,1,377,2038,1661
9544,0,0,36,0,-36
9545,1,1,404,1736,1332
9546,0,0,31,0,-31
9547,1,1,77,1407,1330
9548,1,1,179,1456,1277
9549,1,1,301,1448,1147
9550,1,1,1422,1407,-15
9551,1,0,11,0,-11
9552,1,0,15,0,-15
9553,0,0,0,0,0
9554,1,1,160,1346,1186
9555,0,0,4,0,-4
9556,1,1,336,1297,961
9557,1,0,52,0,-52
9558,0,0,231,0,-231
9559,1,0,41,0,-41
9560,0,0,25,0,-25
9561,0,0,41,0,-41
9562,0,0,24,0,-24
9563,0,0,129,0,-129
9564,1,1,132,1331,1199
9565,1,0,71,0,-71
9566,1,0,27,0,-27
9567,0,0,54,0,-54
9568,0,0,10,0,-10
9569,1,0,23,0,-23
9570,0,0,275,0,-275
9571,1,1,596,1397,801
9572,1,1,279,1595,1316
9573,0,0,60,0,-60
9574,0,0,54,0,-54
9575,0,0,99,0,-99
9576,0,0,8,0,-8
9577,1,0,29,0,-29
9578,0,0,79,0,-79
9579,0,0,3,0,-3
9580,0,0,13,0,-13
9581,1,1,703,1434,731
9582,0,0,15,0,-15
9583,0,0,11,0,-11
9584,1,1,910,1846,936
9585,1,0,135,0,-135
9586,0,0,17,0,-17
9587,1,1,42,1327,1285
9588,0,0,57,0,-57
9589,0,0,176,0,-176
9590,0,0,63,0,-63
9591,1,1,1805,2630,825
9592,0,0,7,0,-7
9593,0,0,12,0,-12
9594,1,0,35,0,-35
9595,0,0,19,0,-19
9596,0,0,51,0,-51
9597,1,0,4,0,-4
9598,1,0,51,0,-51
9599,1,1,637,1435,798
9600,0,0,40,0,-40
9601,0,0,97,0,-97
9602,0,0,120,0,-120
9603,0,0,103,0,-103
9604,0,0,50,0,-50
9605,0,0,123,0,-123
9606,1,0,44,0,-44
9607,1,0,75,0,-75
9608,0,0,13,0,-13
9609,0,0,7,0,-7
9610,1,1,249,1658,1409
9611,1,1,981,1444,463
9612,1,0,51,0,-51
9613,0,0,90,0,-90
9614,1,0,34,0,-34
9615,1,1,63,1216,1153
9616,0,0,105,0,-105
9617,0,0,25,0,-25
9618,1,1,502,1554,1052
9619,1,1,358,1294,936
9620,0,0,85,0,-85
9621,1,0,36,0,-36
9622,0,0,7,0,-7
9623,1,0,168,0,-168
9624,1,1,297,2141,1844
9625,0,0,9,0,-9
9626,0,0,55,0,-55
9627,1,1,1128,2488,1360
9628,1,0,25,0,-25
9629,1,0,154,0,-154
9630,1,0,0,0,0
9631,1,0,16,0,-16
9632,0,0,0,0,0
9633,1,0,16,0,-16
9634,0,0,72,0,-72
9635,1,0,61,0,-61
9636,0,0,6,0,-6
9637,0,0,267,0,-267
9638,1,0,16,0,-16
9639,1,0,163,0,-163
9640,1,0,0,0,0
9641,0,0,49,0,-49
9642,1,0,14,0,-14
9643,0,0,54,0,-54
9644,1,1,237,1337,1100
9645,1,0,68,0,-68
9646,1,1,60,1418,1358
9647,0,0,4,0,-4
9648,1,0,16,0,-16
9649,1,0,26,0,-26
9650,1,1,537,1223,686
9651,1,1,134,1984,1850
9652,0,0,64,0,-64
9653,1,1,218,1348,1130
9654,0,0,26,0,-26
9655,0,0,31,0,-31
9656,0,0,88,0,-88
9657,0,0,119,0,-119
9658,0,0,129,0,-129
9659,1,1,1148,1227,79
9660,1,1,471,1418,947
9661,0,0,1,0,-1
9662,1,0,27,0,-27
9663,0,0,36,0,-36
9664,0,0,43,0,-43
9665,1,1,465,1765,1300
9666,1,1,186,1348,1162
9667,1,1,127,1229,1102
9668,1,1,416,1815,1399
9669,1,0,1,0,-1
9670,1,1,353,1786,1433
9671,1,0,50,0,-50
9672,0,0,41,0,-41
9673,1,0,15,0,-15
9674,0,0,31,0,-31
9675,1,1,221,1474,1253
9676,0,0,52,0,-52
9677,1,1,274,1823,1549
9678,0,0,8,0,-8
9679,0,0,81,0,-81
9680,0,0,93,0,-93
9681,0,0,21,0,-21
9682,1,1,403,2203,1800
9683,0,0,2,0,-2
9684,1,0,48,0,-48
9685,0,0,13,0,-13
9686,1,1,839,1268,429
9687,0,0,54,0,-54
9688,1,0,44,0,-44
9689,0,0,3,0,-3
9690,1,1,716,1430,714
9691,1,0,9,0,-9
9692,1,0,36,0,-36
9693,1,1,72,1483,1411
9694,1,1,1600,1240,-360
9695,1,1,366,1711,1345
9696,0,0,28,0,-28
9697,1,1,804,1225,421
9698,1,0,35,0,-35
9699,0,0,27,0,-27
9700,1,0,70,0,-70
9701,1,0,60,0,-60
9702,0,0,31,0,-31
9703,1,1,196,1303,1107
9704,1,1,238,1481,1243
9705,1,0,65,0,-65
9706,0,0,122,0,-122
9707,0,0,126,0,-126
9708,1,0,52,0,-52
9709,0,0,55,0,-55
9710,0,0,24,0,-24
9711,0,0,29,0,-29
9712,0,0,9,0,-9
9713,0,0,63,0,-63
9714,1,0,20,0,-20
9715,0,0,31,0,-31
9716,1,0,23,0,-23
9717,1,0,46,0,-46
9718,1,1,61,1518,1457
9719,1,0,32,0,-32
9720,1,0,43,0,-43
9721,0,0,26,0,-26
9722,0,0,37,0,-37
9723,0,0,17,0,-17
9724,0,0,78,0,-78
9725,1,0,74,0,-74
9726,1,1,1207,1405,198
9727,1,0,36,0,-36
9728,0,0,8,0,-8
9729,0,0,1,0,-1
9730,1,0,7,0,-7
9731,0,0,30,0,-30
9732,0,0,15,0,-15
9733,0,0,29,0,-29
9734,1,1,116,1309,1193
9735,1,1,1042,1420,378
9736,1,0,24,0,-24
9737,1,0,41,0,-41
9738,0,0,14,0,-14
9739,0,0,50,0,-50
9740,1,1,196,1482,1286
9741,1,0,39,0,-39
9742,0,0,191,0,-191
9743,1,0,106,0,-106
9744,1,1,169,1287,1118
9745,0,0,35,0,-35
9746,0,0,61,0,-61
9747,0,0,91,0,-91
9748,0,0,2,0,-2
9749,1,0,155,0,-155
9750,1,0,9,0,-9
9751,0,0,62,0,-62
9752,0,0,77,0,-77
9753,1,0,12,0,-12
9754,1,1,574,2564,1990
9755,1,1,2106,1834,-272
9756,1,1,1764,1324,-440
9757,1,0,103,0,-103
9758,1,0,21,0,-21
9759,0,0,21,0,-21
9760,1,1,634,1460,826
9761,0,0,161,0,-161
9762,1,1,359,1314,955
9763,1,0,50,0,-50
9764,1,1,241,1264,1023
9765,1,1,1676,1389,-287
9766,1,0,30,0,-30
9767,1,1,473,1230,757
9768,0,0,77,0,-77
9769,1,0,11,0,-11
9770,1,1,485,1722,1237
9771,1,0,42,0,-42
9772,1,1,533,1285,752
9773,1,0,62,0,-62
9774,1,1,319,2196,1877
9775,1,0,13,0,-13
9776,0,0,40,0,-40
9777,1,1,579,1470,891
9778,1,1,218,1333,1115
9779,1,1,354,1220,866
9780,1,1,318,2546,2228
9781,1,0,99,0,-99
9782,1,1,509,1517,1008
9783,1,0,11,0,-11
9784,0,0,34,0,-34
9785,0,0,10,0,-10
9786,1,1,805,1745,940
9787,0,0,130,0,-130
9788,0,0,14,0,-14
9789,1,0,106,0,-106
9790,0,0,29,0,-29
9791,1,1,1486,1297,-189
9792,0,0,3,0,-3
9793,1,1,764,1334,570
9794,1,1,383,1298,915
9795,0,0,77,0,-77
9796,1,1,1095,1303,208
9797,0,0,19,0,-19
9798,1,0,36,0,-36
9799,0,0,169,0,-169
9800,1,1,196,1431,1235
9801,0,0,42,0,-42
9802,1,0,40,0,-40
9803,1,0,48,0,-48
9804,1,1,1211,1441,230
9805,1,0,61,0,-61
9806,1,0,16,0,-16
9807,1,0,40,0,-40
9808,0,0,46,0,-46
9809,1,0,78,0,-78
9810,1,1,689,1238,549
9811,1,0,104,0,-104
9812,1,1,254,1315,1061
9813,1,1,584,1496,912
9814,1,0,123,0,-123
9815,0,0,52,0,-52
9816,0,0,36,0,-36
9817,0,0,20,0,-20
9818,1,0,1,0,-1
9819,0,0,9,0,-9
9820,0,0,194,0,-194
9821,0,0,45,0,-45
9822,1,1,397,1332,935
9823,0,0,57,0,-57
9824,1,1,432,1385,953
9825,1,1,169,1386,1217
9826,1,0,61,0,-61
9827,1,1,168,1941,1773
9828,0,0,7,0,-7
9829,0,0,11,0,-11
9830,1,1,584,1349,765
9831,0,0,113,0,-113
9832,1,1,294,1382,1088
9833,1,0,2,0,-2
9834,1,0,1,0,-1
9835,1,0,4,0,-4
9836,1,1,273,1277,1004
9837,0,0,34,0,-34
9838,1,0,121,0,-121
9839,0,0,46,0,-46
9840,1,1,227,1675,1448
9841,0,0,177,0,-177
9842,0,0,13,0,-13
9843,0,0,143,0,-143
9844,1,0,151,0,-151
9845,0,0,17,0,-17
9846,0,0,73,0,-73
9847,0,0,70,0,-70
9848,0,0,60,0,-60
9849,1,0,57,0,-57
9850,1,0,95,0,-95
9851,1,1,105,1550,1445
9852,1,0,32,0,-32
9853,1,0,16,0,-16
9854,0,0,22,0,-22
9855,0,0,44,0,-44
9856,1,0,11,0,-11
9857,1,1,233,1307,1074
9858,1,0,78,0,-78
9859,1,0,29,0,-29
9860,0,0,18,0,-18
9861,1,1,210,1542,1332
9862,0,0,25,0,-25
9863,1,0,25,0,-25
9864,1,1,526,1467,941
9865,0,0,2,0,-2
9866,0,0,30,0,-30
9867,0,0,23,0,-23
9868,0,0,72,0,-72
9869,1,0,9,0,-9
9870,0,0,136,0,-136
9871,0,0,31,0,-31
9872,0,0,14,0,-14
9873,1,0,14,0,-14
9874,0,0,34,0,-34
9875,1,1,770,1214,444
9876,1,1,176,2560,2384
9877,1,0,91,0,-91
9878,1,1,814,1434,620
9879,0,0,9,0,-9
9880,0,0,24,0,-24
9881,1,0,15,0,-15
9882,0,0,4,0,-4
9883,0,0,30,0,-30
9884,1,1,269,1236,967
9885,0,0,26,0,-26
9886,0,0,77,0,-77
9887,0,0,48,0,-48
9888,1,0,49,0,-49
9889,0,0,103,0,-103
9890,1,1,738,1969,1231
9891,0,0,28,0,-28
9892,0,0,3,0,-3
9893,1,0,52,0,-52
9894,0,0,0,0,0
9895,1,1,95,1222,1127
9896,1,0,9,0,-9
9897,1,1,106,1571,1465
9898,0,0,46,0,-46
9899,0,0,3,0,-3
9900,0,0,21,0,-21
9901,1,0,128,0,-128
9902,1,0,42,0,-42
9903,1,0,6,0,-6
9904,0,0,78,0,-78
9905,1,0,3,0,-3
9906,1,0,56,0,-56
9907,1,0,55,0,-55
9908,0,0,76,0,-76
9909,1,1,953,1355,402
9910,1,0,25,0,-25
9911,1,1,222,1551,1329
9912,1,0,123,0,-123
9913,0,0,61,0,-61
9914,0,0,3,0,-3
9915,0,0,24,0,-24
9916,1,1,398,1301,903
9917,0,0,276,0,-276
9918,1,0,33,0,-33
9919,1,0,105,0,-105
9920,1,1,2857,1361,-1496
9921,1,0,14,0,-14
9922,1,1,273,1208,935
9923,1,1,47,1208,1161
9924,1,0,97,0,-97
9925,0,0,57,0,-57
9926,1,0,64,0,-64
9927,1,0,34,0,-34
9928,1,1,38,1570,1532
9929,0,0,52,0,-52
9930,0,0,1,0,-1
9931,1,1,452,1387,935
9932,0,0,24,0,-24
9933,1,0,8,0,-8
9934,1,0,10,0,-10
9935,1,1,514,1950,1436
9936,1,1,275,1724,1449
9937,1,0,105,0,-105
9938,0,0,93,0,-93
9939,0,0,20,0,-20
9940,1,1,250,1300,1050
9941,1,1,2260,1510,-750
9942,1,1,1133,1609,476
9943,1,1,1404,1373,-31
9944,1,0,114,0,-114
9945,0,0,3,0,-3
9946,1,1,101,1507,1406
9947,0,0,46,0,-46
9948,0,0,25,0,-25
9949,1,1,87,1271,1184
9950,1,1,418,1496,1078
9951,1,1,262,2044,1782
9952,0,0,3,0,-3
9953,1,1,558,2245,1687
9954,1,0,178,0,-178
9955,1,0,13,0,-13
9956,0,0,28,0,-28
9957,0,0,21,0,-21
9958,1,1,295,1302,1007
9959,1,1,1106,1487,381
9960,1,1,123,1905,1782
9961,0,0,21,0,-21
9962,1,0,23,0,-23
9963,1,1,438,2601,2163
9964,0,0,15,0,-15
9965,1,1,1067,1218,151
9966,1,0,15,0,-15
9967,1,0,42,0,-42
9968,0,0,29,0,-29
9969,1,0,60,0,-60
9970,1,1,2070,1305,-765
9971,0,0,0,0,0
9972,0,0,12,0,-12
9973,0,0,62,0,-62
9974,0,0,107,0,-107
9975,0,0,11,0,-11
9976,1,0,20,0,-20
9977,1,1,210,1324,1114
9978,1,1,676,1346,670
9979,0,0,79,0,-79
9980,1,1,376,1859,1483
9981,0,0,47,0,-47
9982,1,0,9,0,-9
9983,1,1,181,1671,1490
9984,1,1,777,1314,537
9985,1,1,510,2088,1578
9986,0,0,218,0,-218
9987,0,0,51,0,-51
9988,0,0,2,0,-2
9989,1,0,37,0,-37
9990,1,0,58,0,-58
9991,1,0,10,0,-10
9992,0,0,19,0,-19
9993,1,1,416,1282,866
9994,0,0,39,0,-39
9995,1,1,380,1629,1249
9996,0,0,36,0,-36
9997,0,0,33,0,-33
9998,0,0,61,0,-61
9999,0,0,24,0,-24
10000,1,0,45,0,-45
10001,0,0,2,0,-2
10002,1,0,1,0,-1
10003,0,0,81,0,-81
10004,1,0,9,0,-9
10005,0,0,35,0,-35
10006,0,0,46,0,-46
10007,1,1,464,1455,991
10008,0,0,10,0,-10
10009,0,0,20,0,-20
10010,1,0,89,0,-89
10011,1,1,440,1536,1096
10012,1,1,298,1408,1110
10013,0,0,10,0,-10
10014,0,0,18,0,-18
10015,0,0,60,0,-60
10016,1,0,1,0,-1
10017,1,1,314,1440,1126
10018,0,0,15,0,-15
10019,0,0,157,0,-157
10020,1,0,51,0,-51
10021,1,1,589,2027,1438
10022,1,1,688,1231,543
10023,0,0,138,0,-138
10024,1,0,5,0,-5
10025,0,0,59,0,-59
10026,1,1,407,1507,1100
10027,1,0,82,0,-82
10028,0,0,45,0,-45
10029,0,0,4,0,-4
10030,0,0,32,0,-32
10031,1,1,461,1314,853
10032,1,1,225,2068,1843
10033,1,1,930,1254,324
10034,1,0,93,0,-93
10035,0,0,35,0,-35
10036,0,0,5,0,-5
10037,1,1,96,1400,1304
10038,1,1,550,1440,890
10039,1,0,149,0,-149
10040,0,0,34,0,-34
10041,0,0,9,0,-9
10042,0,0,198,0,-198
10043,0,0,6,0,-6
10044,0,0,12,0,-12
10045,0,0,2,0,-2
10046,0,0,96,0,-96
10047,0,0,7,0,-7
10048,1,1,707,1596,889
10049,1,0,1,0,-1
10050,1,1,348,1837,1489
10051,0,0,73,0,-73
10052,1,0,17,0,-17
10053,0,0,43,0,-43
10054,0,0,66,0,-66
10055,0,0,11,0,-11
10056,1,1,511,1715,1204
10057,0,0,36,0,-36
10058,1,0,131,0,-131
10059,0,0,59,0,-59
10060,1,0,3,0,-3
10061,1,1,539,1477,938
10062,0,0,1,0,-1
10063,0,0,25,0,-25
10064,1,1,374,2503,2129
10065,0,0,104,0,-104
10066,1,1,890,1285,395
10067,0,0,120,0,-120
10068,1,1,418,1216,798
10069,1,1,580,2362,1782
10070,1,1,215,1297,1082
10071,1,1,695,1638,943
10072,1,0,30,0,-30
10073,1,0,9,0,-9
10074,1,1,1133,1401,268
10075,1,1,288,1722,1434
10076,0,0,59,0,-59
10077,1,1,532,1200,668
10078,1,1,491,1315,824
10079,0,0,21,0,-21
10080,1,0,44,0,-44
10081,0,0,24,0,-24
10082,1,0,60,0,-60
10083,1,0,27,0,-27
10084,1,0,4,0,-4
10085,0,0,27,0,-27
10086,1,1,256,1439,1183
10087,1,0,8,0,-8
10088,1,0,96,0,-96
10089,0,0,39,0,-39
10090,1,0,100,0,-100
10091,1,1,129,1226,1097
10092,0,0,107,0,-107
10093,1,0,102,0,-102
10094,1,0,53,0,-53
10095,0,0,13,0,-13
10096,1,0,26,0,-26
10097,0,0,24,0,-24
10098,0,0,269,0,-269
10099,0,0,31,0,-31
10100,1,1,576,1792,1216
10101,1,0,26,0,-26
10102,0,0,29,0,-29
10103,1,1,389,1628,1239
10104,0,0,98,0,-98
10105,0,0,11,0,-11
10106,1,1,549,1316,767
10107,1,1,73,1253,1180
10108,0,0,42,0,-42
10109,1,0,7,0,-7
10110,0,0,4,0,-4
10111,1,0,54,0,-54
10112,1,0,119,0,-119
10113,1,1,1855,1308,-547
10114,0,0,34,0,-34
10115,1,0,113,0,-113
10116,0,0,25,0,-25
10117,1,1,625,1827,1202
10118,1,0,80,0,-80
10119,0,0,23,0,-23
10120,0,0,23,0,-23
10121,1,0,51,0,-51
10122,1,1,465,1690,1225
10123,1,0,14,0,-14
10124,1,1,51,1585,1534
10125,0,0,28,0,-28
10126,0,0,15,0,-15
10127,1,1,81,1413,1332
10128,1,0,7,0,-7
10129,1,1,764,1233,469
10130,1,1,342,1233,891
10131,1,1,436,2522,2086
10132,1,1,261,1369,1108
10133,1,0,39,0,-39
10134,0,0,71,0,-71
10135,0,0,55,0,-55
10136,1,1,112,1266,1154
10137,1,1,36,1348,1312
10138,1,1,986,1545,559
10139,0,0,127,0,-127
10140,1,1,253,1258,1005
10141,0,0,41,0,-41
10142,0,0,95,0,-95
10143,1,0,52,0,-52
10144,1,0,205,0,-205
10145,1,0,24,0,-24
10146,0,0,4,0,-4
10147,1,0,29,0,-29
10148,1,1,165,1236,1071
10149,0,0,46,0,-46
10150,0,0,42,0,-42
10151,1,1,377,1906,1529
10152,1,1,667,1253,586
10153,1,0,40,0,-40
10154,0,0,107,0,-107
10155,1,1,1324,2035,711
10156,1,1,218,1421,1203
10157,0,0,2,0,-2
10158,1,1,218,1277,1059
10159,0,0,13,0,-13
10160,0,0,110,0,-110
10161,1,1,512,1529,1017
10162,0,0,4,0,-4
10163,1,1,240,1563,1323
10164,1,1,46,1622,1576
10165,0,0,146,0,-146
10166,0,0,80,0,-80
10167,0,0,23,0,-23
10168,0,0,34,0,-34
10169,1,1,249,1782,1533
10170,0,0,68,0,-68
10171,0,0,23,0,-23
10172,1,0,123,0,-123
10173,1,1,71,2620,2549
10174,1,0,59,0,-59
10175,1,0,244,0,-244
10176,1,1,1085,1697,612
10177,1,0,10,0,-10
10178,1,1,103,1241,1138
10179,1,0,83,0,-83
10180,0,0,163,0,-163
10181,1,0,42,0,-42
10182,0,0,71,0,-71
10183,0,0,8,0,-8
10184,0,0,65,0,-65
10185,1,0,43,0,-43
10186,1,1,870,1212,342
10187,1,0,28,0,-28
10188,0,0,24,0,-24
10189,1,0,116,0,-116
10190,1,0,85,0,-85
10191,0,0,19,0,-19
10192,1,0,14,0,-14
10193,1,0,58,0,-58
10194,1,1,164,1292,1128
10195,1,0,5,0,-5
10196,1,0,47,0,-47
10197,1,0,0,0,0
10198,1,1,674,1657,983
10199,1,1,537,1234,697
10200,1,1,70,1550,1480
10201,1,1,578,1293,715
10202,1,0,116,0,-116
10203,1,1,631,1629,998
10204,0,0,38,0,-38
10205,0,0,5,0,-5
10206,0,0,34,0,-34
10207,0,0,85,0,-85
10208,1,1,2069,3261,1192
10209,0,0,15,0,-15
10210,1,0,17,0,-17
10211,1,1,538,1308,770
10212,0,0,94,0,-94
10213,0,0,74,0,-74
10214,1,0,30,0,-30
10215,0,0,41,0,-41
10216,0,0,11,0,-11
10217,0,0,8,0,-8
10218,1,0,12,0,-12
10219,1,0,82,0,-82
10220,0,0,60,0,-60
10221,0,0,11,0,-11
10222,1,1,211,1375,1164
10223,1,0,21,0,-21
10224,1,0,40,0,-40
10225,0,0,119,0,-119
10226,1,1,178,1443,1265
10227,1,1,353,1463,1110
10228,0,0,53,0,-53
10229,0,0,6,0,-6
10230,1,0,19,0,-19
10231,1,0,83,0,-83
10232,0,0,23,0,-23
10233,0,0,102,0,-102
10234,1,0,17,0,-17
10235,1,0,7,0,-7
10236,1,1,647,2175,1528
10237,1,1,164,1395,1231
10238,1,1,241,1263,1022
10239,0,0,16,0,-16
10240,1,1,244,1906,1662
10241,1,1,426,1210,784
10242,1,1,2639,1521,-1118
10243,0,0,24,0,-24
10244,1,0,5,0,-5
10245,0,0,60,0,-60
10246,0,0,7,0,-7
10247,0,0,63,0,-63
10248,0,0,14,0,-14
10249,1,1,808,2392,1584
10250,1,1,512,1345,833
10251,1,1,513,1287,774
10252,1,1,128,1529,1401
10253,1,1,777,1267,490
10254,0,0,51,0,-51
10255,1,0,80,0,-80
10256,1,0,30,0,-30
10257,1,0,121,0,-121
10258,1,1,879,1710,831
10259,1,1,577,2524,1947
10260,0,0,74,0,-74
10261,0,0,13,0,-13
10262,1,1,370,2530,2160
10263,1,0,71,0,-71
10264,1,0,43,0,-43
10265,0,0,33,0,-33
10266,0,0,11,0,-11
10267,1,0,8,0,-8
10268,0,0,6,0,-6
10269,1,0,17,0,-17
10270,1,0,155,0,-155
10271,0,0,106,0,-106
10272,1,0,31,0,-31
10273,0,0,61,0,-61
10274,0,0,28,0,-28
10275,1,1,131,1211,1080
10276,1,0,29,0,-29
10277,0,0,123,0,-123
10278,1,0,12,0,-12
10279,0,0,165,0,-165
10280,1,0,10,0,-10
10281,1,1,75,1287,1212
10282,0,0,55,0,-55
10283,1,1,474,1380,906
10284,0,0,9,0,-9
10285,1,0,64,0,-64
10286,0,0,87,0,-87
10287,1,0,8,0,-8
10288,1,0,28,0,-28
10289,0,0,20,0,-20
10290,0,0,1,0,-1
10291,1,1,508,1373,865
10292,1,1,142,2564,2422
10293,0,0,45,0,-45
10294,1,1,952,1338,386
10295,1,0,21,0,-21
10296,1,1,1170,2089,919
10297,0,0,25,0,-25
10298,1,1,1230,1567,337
10299,1,0,8,0,-8
10300,0,0,72,0,-72
10301,1,1,457,2261,1804
10302,1,0,23,0,-23
10303,0,0,47,0,-47
10304,1,0,31,0,-31
10305,1,1,1151,1245,94
10306,1,0,121,0,-121
10307,0,0,33,0,-33
10308,1,1,536,1381,845
10309,1,0,19,0,-19
10310,1,0,17,0,-17
10311,1,0,17,0,-17
10312,1,0,3,0,-3
10313,1,0,47,0,-47
10314,0,0,53,0,-53
10315,0,0,57,0,-57
10316,0,0,52,0,-52
10317,0,0,67,0,-67
10318,0,0,41,0,-41
10319,1,0,17,0,-17
10320,1,0,59,0,-59
10321,0,0,14,0,-14
10322,1,0,57,0,-57
10323,0,0,39,0,-39
10324,1,1,766,2332,1566
10325,1,1,60,1393,1333
10326,0,0,63,0,-63
10327,1,0,34,0,-34
10328,1,1,504,1398,894
10329,1,1,1129,1233,104
10330,1,0,11,0,-11
10331,0,0,42,0,-42
10332,1,0,98,0,-98
10333,0,0,0,0,0
10334,1,1,375,1305,930
10335,0,0,55,0,-55
10336,1,1,473,1209,736
10337,1,1,472,1427,955
10338,1,1,88,1453,1365
10339,1,0,23,0,-23
10340,1,0,61,0,-61
10341,0,0,7,0,-7
10342,1,0,6,0,-6
10343,0,0,11,0,-11
10344,1,0,83,0,-83
10345,0,0,6,0,-6
10346,1,0,13,0,-13
10347,1,0,38,0,-38
10348,0,0,32,0,-32
10349,1,0,42,0,-42
10350,1,1,187,1328,1141
10351,0,0,35,0,-35
10352,1,0,14,0,-14
10353,0,0,10,0,-10
10354,0,0,15,0,-15
10355,1,0,91,0,-91
10356,0,0,14,0,-14
10357,0,0,121,0,-121
10358,0,0,2,0,-2
10359,0,0,46,0,-46
10360,0,0,57,0,-57
10361,0,0,7,0,-7
10362,1,0,318,0,-318
10363,1,1,59,3194,3135
10364,1,0,10,0,-10
10365,0,0,6,0,-6
10366,1,0,86,0,-86
10367,1,1,36,1275,1239
10368,0,0,16,0,-16
10369,1,1,94,1206,1112
10370,1,0,5,0,-5
10371,0,0,7,0,-7
10372,1,1,598,1269,671
10373,1,0,28,0,-28
10374,0,0,67,0,-67
10375,0,0,8,0,-8
10376,1,1,585,1269,684
10377,0,0,78,0,-78
10378,1,0,7,0,-7
10379,1,0,139,0,-139
10380,1,1,100,1252,1152
10381,1,0,4,0,-4
10382,0,0,161,0,-161
10383,0,0,65,0,-65
10384,0,0,22,0,-22
10385,0,0,9,0,-9
10386,1,1,1992,1477,-515
10387,0,0,5,0,-5
10388,1,0,17,0,-17
10389,1,1,52,1269,1217
10390,0,0,79,0,-79
10391,1,1,325,1313,988
10392,0,0,2,0,-2
10393,0,0,39,0,-39
10394,1,1,859,1413,554
10395,1,0,50,0,-50
10396,0,0,11,0,-11
10397,1,0,15,0,-15
10398,0,0,44,0,-44
10399,0,0,0,0,0
10400,1,0,8,0,-8
10401,1,0,40,0,-40
10402,1,1,360,1285,925
10403,1,0,8,0,-8
10404,1,0,16,0,-16
10405,1,0,35,0,-35
10406,1,1,500,1598,1098
10407,1,0,22,0,-22
10408,0,0,90,0,-90
10409,1,0,161,0,-161
10410,0,0,22,0,-22
10411,1,0,58,0,-58
10412,1,1,536,1299,763
10413,0,0,74,0,-74
10414,1,1,433,1332,899
10415,0,0,39,0,-39
10416,1,1,244,1212,968
10417,0,0,21,0,-21
10418,1,0,39,0,-39
10419,0,0,47,0,-47
10420,1,1,839,1690,851
10421,1,1,112,1619,1507
10422,1,1,602,1359,757
10423,1,0,10,0,-10
10424,1,0,51,0,-51
10425,0,0,29,0,-29
10426,0,0,92,0,-92
10427,1,0,13,0,-13
10428,0,0,69,0,-69
10429,0,0,32,0,-32
10430,1,0,4,0,-4
10431,1,0,1,0,-1
10432,1,1,833,1467,634
10433,1,1,73,1512,1439
10434,1,1,178,2797,2619
10435,1,1,477,1438,961
10436,1,0,4,0,-4
10437,1,0,8,0,-8
10438,1,1,217,1980,1763
10439,1,1,256,1206,950
10440,0,0,14,0,-14
10441,1,0,14,0,-14
10442,1,1,477,1636,1159
10443,0,0,0,0,0
10444,1,1,251,1488,1237
10445,1,0,55,0,-55
10446,0,0,64,0,-64
10447,1,0,49,0,-49
10448,1,0,210,0,-210
10449,0,0,13,0,-13
10450,1,0,7,0,-7
10451,1,1,160,1233,1073
10452,1,1,366,1680,1314
10453,1,1,477,1221,744
10454,0,0,46,0,-46
10455,1,0,58,0,-58
10456,0,0,0,0,0
10457,1,0,28,0,-28
10458,0,0,23,0,-23
10459,1,1,697,1380,683
10460,1,1,2152,1463,-689
10461,1,0,29,0,-29
10462,1,0,39,0,-39
10463,0,0,63,0,-63
10464,1,0,28,0,-28
10465,1,0,1,0,-1
10466,0,0,11,0,-11
10467,0,0,1,0,-1
10468,1,1,878,1466,588
10469,1,1,1552,1499,-53
10470,0,0,4,0,-4
10471,0,0,207,0,-207
10472,1,0,23,0,-23
10473,1,1,858,1202,344
10474,1,0,31,0,-31
10475,1,1,562,1756,1194
10476,1,1,1794,1499,-295
10477,1,1,51,2249,2198
10478,0,0,18,0,-18
10479,1,0,55,0,-55
10480,1,1,210,1226,1016
10481,0,0,28,0,-28
10482,1,0,95,0,-95
10483,0,0,155,0,-155
10484,0,0,50,0,-50
10485,1,1,34,1230,1196
10486,1,1,1630,1263,-367
10487,1,1,590,1365,775
10488,0,0,48,0,-48
10489,0,0,31,0,-31
10490,0,0,43,0,-43
10491,1,0,39,0,-39
10492,1,1,687,1592,905
10493,1,0,13,0,-13
10494,0,0,42,0,-42
10495,1,1,559,1655,1096
10496,1,1,117,2011,1894
10497,1,1,396,2072,1676
10498,1,0,32,0,-32
10499,0,0,6,0,-6
10500,1,0,49,0,-49
10501,1,1,848,1214,366
10502,0,0,30,0,-30
10503,1,1,169,1467,1298
10504,1,0,7,0,-7
10505,1,1,627,1270,643
10506,1,1,334,1281,947
10507,0,0,21,0,-21
10508,1,1,446,1258,812
10509,1,0,153,0,-153
10510,0,0,193,0,-193
10511,1,1,40,1351,1311
10512,1,1,106,1247,1141
10513,1,1,335,1662,1327
10514,1,0,4,0,-4
10515,1,0,17,0,-17
10516,0,0,58,0,-58
10517,0,0,43,0,-43
10518,1,1,80,2002,1922
10519,0,0,16,0,-16
10520,1,1,1419,1542,123
10521,1,1,1588,2152,564
10522,1,0,33,0,-33
10523,0,0,4,0,-4
10524,1,1,726,1436,710
10525,0,0,51,0,-51
10526,1,1,133,1248,1115
10527,1,0,149,0,-149
10528,0,0,61,0,-61
10529,1,0,36,0,-36
10530,1,0,28,0,-28
10531,0,0,80,0,-80
10532,1,0,24,0,-24
10533,0,0,26,0,-26
10534,1,0,90,0,-90
10535,1,1,634,1438,804
10536,0,0,11,0,-11
10537,1,1,2012,1395,-617
10538,0,0,5,0,-5
10539,0,0,10,0,-10
10540,1,0,1,0,-1
10541,1,0,60,0,-60
10542,0,0,14,0,-14
10543,0,0,41,0,-41
10544,0,0,9,0,-9
10545,1,1,188,1222,1034
10546,1,0,40,0,-40
10547,0,0,273,0,-273
10548,1,0,15,0,-15
10549,1,1,314,1264,950
10550,0,0,78,0,-78
10551,0,0,45,0,-45
10552,1,1,92,1550,1458
10553,0,0,182,0,-182
10554,1,0,34,0,-34
10555,1,0,188,0,-188
10556,1,1,313,1407,1094
10557,1,1,203,1250,1047
10558,1,0,50,0,-50
10559,0,0,27,0,-27
10560,0,0,32,0,-32
10561,1,0,97,0,-97
10562,1,1,1258,1309,51
10563,1,0,7,0,-7
10564,1,0,122,0,-122
10565,0,0,70,0,-70
10566,1,0,2,0,-2
10567,1,1,68,1271,1203
10568,0,0,94,0,-94
10569,0,0,100,0,-100
10570,1,0,3,0,-3
10571,1,0,44,0,-44
10572,1,1,93,1236,1143
10573,0,0,5,0,-5
10574,1,0,74,0,-74
10575,0,0,17,0,-17
10576,1,0,15,0,-15
10577,1,0,70,0,-70
10578,0,0,64,0,-64
10579,0,0,10,0,-10
10580,0,0,40,0,-40
10581,0,0,44,0,-44
10582,1,1,149,1397,1248
10583,1,0,3,0,-3
10584,0,0,20,0,-20
10585,1,0,53,0,-53
10586,1,0,31,0,-31
10587,0,0,42,0,-42
10588,1,1,530,1313,783
10589,1,1,820,1344,524
10590,1,1,408,1446,1038
10591,1,0,55,0,-55
10592,1,1,56,1371,1315
10593,1,0,47,0,-47
10594,1,0,0,0,0
10595,1,1,1864,1397,-467
10596,1,0,13,0,-13
10597,1,1,179,1303,1124
10598,0,0,45,0,-45
10599,1,0,14,0,-14
10600,1,0,57,0,-57
10601,1,0,161,0,-161
10602,1,1,229,2132,1903
10603,1,0,25,0,-25
10604,0,0,24,0,-24
10605,1,0,36,0,-36
10606,1,0,56,0,-56
10607,0,0,60,0,-60
10608,1,0,10,0,-10
10609,0,0,3,0,-3
10610,1,0,5,0,-5
10611,0,0,18,0,-18
10612,1,0,23,0,-23
10613,0,0,53,0,-53
10614,0,0,8,0,-8
10615,1,0,10,0,-10
10616,0,0,30,0,-30
10617,0,0,16,0,-16
10618,1,0,3,0,-3
10619,1,1,122,1337,1215
10620,0,0,51,0,-51
10621,1,1,466,1339,873
10622,0,0,65,0,-65
10623,0,0,13,0,-13
10624,1,0,24,0,-24
10625,0,0,26,0,-26
10626,1,0,11,0,-11
10627,1,1,247,1604,1357
10628,1,1,274,1613,1339
10629,1,1,138,1456,1318
10630,0,0,10,0,-10
10631,1,1,1650,1415,-235
10632,0,0,255,0,-255
10633,1,0,6,0,-6
10634,0,0,54,0,-54
10635,1,1,1698,1321,-377
10636,1,0,17,0,-17
10637,1,0,53,0,-53
10638,1,0,16,0,-16
10639,0,0,22,0,-22
10640,0,0,9,0,-9
10641,1,0,15,0,-15
10642,1,0,46,0,-46
10643,0,0,2,0,-2
10644,1,1,343,2243,1900
10645,1,1,430,1313,883
10646,0,0,24,0,-24
10647,1,0,21,0,-21
10648,0,0,82,0,-82
10649,1,1,1022,1532,510
10650,0,0,8,0,-8
10651,1,1,1099,1259,160
10652,0,0,9,0,-9
10653,1,1,236,1353,1117
10654,1,1,586,1679,1093
10655,0,0,32,0,-32
10656,0,0,60,0,-60
10657,1,0,34,0,-34
10658,0,0,12,0,-12
10659,1,0,24,0,-24
10660,0,0,98,0,-98
10661,0,0,23,0,-23
10662,1,0,15,0,-15
10663,1,0,32,0,-32
10664,0,0,48,0,-48
10665,1,1,215,1245,1030
10666,0,0,5,0,-5
10667,1,0,98,0,-98
10668,1,1,272,1316,1044
10669,1,1,998,1829,831
10670,1,1,159,1751,1592
10671,1,1,2048,1550,-498
10672,0,0,69,0,-69
10673,0,0,45,0,-45
10674,1,0,204,0,-204
10675,1,0,42,0,-42
10676,1,1,327,1391,1064
10677,0,0,68,0,-68
10678,1,0,16,0,-16
10679,1,1,276,1549,1273
10680,1,0,11,0,-11
10681,1,0,5,0,-5
10682,0,0,0,0,0
10683,0,0,107,0,-107
10684,1,0,13,0,-13
10685,1,1,136,1377,1241
10686,1,0,3,0,-3
10687,1,1,266,1211,945
10688,1,0,148,0,-148
10689,1,0,60,0,-60
10690,0,0,1,0,-1
10691,1,1,1190,1287,97
10692,0,0,73,0,-73
10693,0,0,30,0,-30
10694,0,0,3,0,-3
10695,0,0,50,0,-50
10696,1,1,2059,1670,-389
10697,1,1,800,2399,1599
10698,1,1,839,1450,611
10699,1,0,19,0,-19
10700,0,0,32,0,-32
10701,1,0,46,0,-46
10702,1,0,67,0,-67
10703,0,0,39,0,-39
10704,1,1,63,1215,1152
10705,1,0,15,0,-15
10706,1,0,48,0,-48
10707,1,0,38,0,-38
10708,0,0,43,0,-43
10709,0,0,148,0,-148
10710,0,0,87,0,-87
10711,1,1,334,1302,968
10712,1,0,53,0,-53
10713,1,1,108,1782,1674
10714,1,0,82,0,-82
10715,0,0,32,0,-32
10716,1,1,366,1247,881
10717,1,1,276,1313,1037
10718,0,0,100,0,-100
10719,0,0,8,0,-8
10720,0,0,20,0,-20
10721,1,1,14,2110,2096
10722,0,0,58,0,-58
10723,1,0,44,0,-44
10724,1,1,238,1690,1452
10725,1,0,52,0,-52
10726,1,0,153,0,-153
10727,1,1,563,1400,837
10728,1,1,30,1877,1847
10729,1,1,689,1392,703
10730,1,0,12,0,-12
10731,1,0,44,0,-44
10732,1,1,674,1267,593
10733,1,0,65,0,-65
10734,0,0,25,0,-25
10735,0,0,83,0,-83
10736,1,0,21,0,-21
10737,1,0,295,0,-295
10738,0,0,43,0,-43
10739,1,0,19,0,-19
10740,0,0,11,0,-11
10741,1,1,325,1451,1126
10742,1,0,162,0,-162
10743,0,0,6,0,-6
10744,0,0,49,0,-49
10745,1,1,525,1249,724
10746,1,0,39,0,-39
10747,1,0,24,0,-24
10748,1,1,49,1364,1315
10749,1,1,189,1294,1105
10750,1,1,240,1470,1230
10751,1,1,1032,1237,205
10752,1,1,132,1726,1594
10753,1,1,352,2472,2120
10754,0,0,4,0,-4
10755,1,1,1337,1405,68
10756,1,0,103,0,-103
10757,1,1,2092,2050,-42
10758,0,0,17,0,-17
10759,0,0,21,0,-21
10760,1,1,241,1498,1257
10761,0,0,14,0,-14
10762,1,0,87,0,-87
10763,0,0,55,0,-55
10764,0,0,32,0,-32
10765,0,0,1,0,-1
10766,0,0,120,0,-120
10767,1,1,447,2205,1758
10768,0,0,9,0,-9
10769,1,0,60,0,-60
10770,1,1,189,1371,1182
10771,1,1,740,1295,555
10772,0,0,18,0,-18
10773,0,0,57,0,-57
10774,1,0,31,0,-31
10775,0,0,18,0,-18
10776,1,0,6,0,-6
10777,0,0,27,0,-27
10778,1,1,690,1767,1077
10779,0,0,48,0,-48
10780,0,0,15,0,-15
10781,0,0,38,0,-38
10782,1,0,30,0,-30
10783,1,1,296,1599,1303
10784,0,0,18,0,-18
10785,1,1,1030,2252,1222
10786,0,0,9,0,-9
10787,1,1,1058,1407,349
10788,1,0,134,0,-134
10789,0,0,121,0,-121
10790,1,1,356,1355,999
10791,1,1,134,1279,1145
10792,0,0,47,0,-47
10793,0,0,54,0,-54
10794,0,0,7,0,-7
10795,0,0,102,0,-102
10796,0,0,42,0,-42
10797,0,0,40,0,-40
10798,1,1,589,1705,1116
10799,1,0,6,0,-6
10800,1,1,305,1490,1185
10801,0,0,44,0,-44
10802,0,0,36,0,-36
10803,0,0,39,0,-39
10804,0,0,49,0,-49
10805,0,0,135,0,-135
10806,0,0,4,0,-4
10807,1,1,185,1504,1319
10808,1,1,698,1665,967
10809,0,0,15,0,-15
10810,0,0,10,0,-10
10811,0,0,133,0,-133
10812,1,0,76,0,-76
10813,0,0,28,0,-28
10814,1,0,43,0,-43
10815,0,0,106,0,-106
10816,1,0,0,0,0
10817,0,0,11,0,-11
10818,1,1,154,1212,1058
10819,1,1,1037,1341,304
10820,1,1,58,1236,1178
10821,1,0,30,0,-30
10822,0,0,141,0,-141
10823,1,0,35,0,-35
10824,1,0,65,0,-65
10825,1,1,236,2002,1766
10826,1,0,8,0,-8
10827,1,1,183,2419,2236
10828,0,0,42,0,-42
10829,1,0,9,0,-9
10830,0,0,125,0,-125
10831,0,0,177,0,-177
10832,1,1,525,1634,1109
10833,1,0,2,0,-2
10834,0,0,10,0,-10
10835,1,0,18,0,-18
10836,1,0,38,0,-38
10837,0,0,77,0,-77
10838,0,0,16,0,-16
10839,1,1,432,1359,927
10840,0,0,61,0,-61
10841,1,1,111,1916,1805
10842,1,1,1039,1207,168
10843,1,1,196,2635,2439
10844,0,0,211,0,-211
10845,1,1,1302,1501,199
10846,0,0,70,0,-70
10847,0,0,72,0,-72
10848,1,1,323,1480,1157
10849,1,1,192,1440,1248
10850,0,0,23,0,-23
10851,1,0,76,0,-76
10852,1,0,18,0,-18
10853,1,1,350,1961,1611
10854,0,0,4,0,-4
10855,1,0,28,0,-28
10856,1,1,554,1496,942
10857,1,0,82,0,-82
10858,0,0,63,0,-63
10859,0,0,7,0,-7
10860,1,1,648,1677,1029
10861,1,0,7,0,-7
10862,0,0,0,0,0
10863,1,0,141,0,-141
10864,1,0,34,0,-34
10865,0,0,68,0,-68
10866,1,0,53,0,-53
10867,1,1,1027,3700,2673
10868,1,1,1563,2120,557
10869,1,1,134,6710,6576
10870,0,0,4,0,-4
10871,0,0,42,0,-42
10872,0,0,100,0,-100
10873,1,0,7,0,-7
10874,0,0,8,0,-8
10875,1,1,92,2084,1992
10876,1,0,57,0,-57
10877,0,0,56,0,-56
10878,0,0,339,0,-339
10879,0,0,13,0,-13
10880,1,0,189,0,-189
10881,0,0,189,0,-189
10882,0,0,10,0,-10
10883,1,0,87,0,-87
10884,0,0,11,0,-11
10885,0,0,91,0,-91
10886,1,0,171,0,-171
10887,1,0,40,0,-40
10888,0,0,103,0,-103
10889,1,0,20,0,-20
10890,1,1,182,1614,1432
10891,0,0,3,0,-3
10892,1,1,1434,1209,-225
10893,1,1,299,1259,960
10894,1,0,17,0,-17
10895,1,0,27,0,-27
10896,1,0,47,0,-47
10897,0,0,20,0,-20
10898,1,0,11,0,-11
10899,0,0,60,0,-60
10900,0,0,30,0,-30
10901,1,1,377,1362,985
10902,1,0,8,0,-8
10903,0,0,125,0,-125
10904,0,0,72,0,-72
10905,1,1,124,1312,1188
10906,1,0,31,0,-31
10907,0,0,25,0,-25
10908,1,1,236,1660,1424
10909,1,1,188,1886,1698
10910,0,0,104,0,-104
10911,0,0,51,0,-51
10912,1,1,938,1274,336
10913,1,1,359,1512,1153
10914,0,0,11,0,-11
10915,0,0,61,0,-61
10916,1,1,75,1350,1275
10917,0,0,86,0,-86
10918,1,0,133,0,-133
10919,1,1,150,1281,1131
10920,0,0,134,0,-134
10921,1,1,147,1309,1162
10922,1,0,6,0,-6
10923,1,1,146,1236,1090
10924,1,0,24,0,-24
10925,1,0,6,0,-6
10926,0,0,87,0,-87
10927,0,0,12,0,-12
10928,0,0,72,0,-72
10929,1,1,179,1402,1223
10930,1,0,25,0,-25
10931,1,1,741,1471,730
10932,1,1,1614,1549,-65
10933,1,0,93,0,-93
10934,1,0,50,0,-50
10935,0,0,2,0,-2
10936,1,0,52,0,-52
10937,0,0,43,0,-43
10938,1,0,19,0,-19
10939,0,0,43,0,-43
10940,1,1,604,1391,787
10941,0,0,41,0,-41
10942,1,0,68,0,-68
10943,1,0,20,0,-20
10944,0,0,16,0,-16
10945,1,1,294,1491,1197
10946,0,0,68,0,-68
10947,1,1,187,1265,1078
10948,0,0,111,0,-111
10949,0,0,33,0,-33
10950,1,0,78,0,-78
10951,1,1,621,3638,3017
10952,1,1,231,1226,995
10953,1,1,793,1241,448
10954,0,0,34,0,-34
10955,1,0,16,0,-16
10956,0,0,22,0,-22
10957,1,0,28,0,-28
10958,0,0,131,0,-131
10959,1,1,551,1242,691
10960,1,1,826,1277,451
10961,1,0,2,0,-2
10962,1,0,2,0,-2
10963,0,0,28,0,-28
10964,1,0,7,0,-7
10965,0,0,14,0,-14
10966,0,0,1,0,-1
10967,0,0,38,0,-38
10968,0,0,13,0,-13
10969,1,1,133,1292,1159
10970,0,0,71,0,-71
10971,1,1,1330,2005,675
10972,0,0,92,0,-92
10973,0,0,101,0,-101
10974,1,0,38,0,-38
10975,0,0,18,0,-18
10976,0,0,4,0,-4
10977,1,1,363,2091,1728
10978,1,0,81,0,-81
10979,0,0,82,0,-82
10980,1,1,264,1238,974
10981,1,1,10,1302,1292
10982,1,0,34,0,-34
10983,1,1,599,1217,618
10984,0,0,26,0,-26
10985,0,0,39,0,-39
10986,1,0,6,0,-6
10987,0,0,78,0,-78
10988,0,0,38,0,-38
10989,1,0,15,0,-15
10990,1,1,2801,1428,-1373
10991,0,0,16,0,-16
10992,1,0,0,0,0
10993,0,0,79,0,-79
10994,1,0,92,0,-92
10995,1,1,166,1328,1162
10996,1,0,79,0,-79
10997,1,1,391,1274,883
10998,0,0,26,0,-26
10999,1,0,15,0,-15
11000,1,1,1084,2098,1014
11001,0,0,56,0,-56
11002,1,1,57,3040,2983
11003,1,0,10,0,-10
11004,1,0,36,0,-36
11005,0,0,4,0,-4
11006,1,1,68,1374,1306
11007,0,0,26,0,-26
11008,0,0,24,0,-24
11009,1,1,581,1342,761
11010,1,0,219,0,-219
11011,0,0,268,0,-268
11012,1,0,33,0,-33
11013,0,0,89,0,-89
11014,0,0,3,0,-3
11015,0,0,184,0,-184
11016,1,1,423,1227,804
11017,1,1,329,1490,1161
11018,1,0,90,0,-90
11019,0,0,33,0,-33
11020,0,0,87,0,-87
11021,0,0,54,0,-54
11022,1,1,313,1231,918
11023,1,1,1685,1297,-388
11024,1,1,381,1263,882
11025,1,0,25,0,-25
11026,0,0,95,0,-95
11027,1,0,127,0,-127
11028,0,0,38,0,-38
11029,1,0,43,0,-43
11030,0,0,7,0,-7
11031,1,1,147,1703,1556
11032,1,1,159,1234,1075
11033,1,1,454,1575,1121
11034,1,1,191,1366,1175
11035,0,0,35,0,-35
11036,0,0,32,0,-32
11037,1,1,445,1373,928
11038,1,0,12,0,-12
11039,1,1,57,1801,1744
11040,0,0,35,0,-35
11041,1,0,19,0,-19
11042,0,0,18,0,-18
11043,0,0,113,0,-113
11044,1,0,48,0,-48
11045,1,1,208,1437,1229
11046,0,0,22,0,-22
11047,1,0,100,0,-100
11048,1,0,13,0,-13
11049,0,0,24,0,-24
11050,1,1,275,1384,1109
11051,1,1,295,1221,926
11052,0,0,152,0,-152
11053,1,1,1507,1681,174
11054,0,0,28,0,-28
11055,0,0,5,0,-5
11056,0,0,23,0,-23
11057,1,0,40,0,-40
11058,1,1,191,1238,1047
11059,0,0,33,0,-33
11060,1,0,25,0,-25
11061,1,1,86,1503,1417
11062,1,1,1222,1515,293
11063,1,1,305,1325,1020
11064,1,0,65,0,-65
11065,0,0,60,0,-60
11066,1,0,12,0,-12
11067,0,0,0,0,0
11068,1,0,54,0,-54
11069,0,0,24,0,-24
11070,1,0,32,0,-32
11071,0,0,20,0,-20
11072,0,0,91,0,-91
11073,1,1,276,1485,1209
11074,0,0,12,0,-12
11075,1,1,186,1476,1290
11076,1,0,20,0,-20
11077,1,0,72,0,-72
11078,1,1,130,1341,1211
11079,0,0,17,0,-17
11080,1,0,55,0,-55
11081,0,0,53,0,-53
11082,0,0,105,0,-105
11083,1,0,94,0,-94
11084,1,1,800,1783,983
11085,1,1,98,1490,1392
11086,1,0,69,0,-69
11087,1,1,1384,3404,2020
11088,1,1,434,1489,1055
11089,1,1,433,1244,811
11090,1,1,638,1609,971
11091,1,0,25,0,-25
11092,1,1,177,1508,1331
11093,0,0,30,0,-30
11094,1,0,5,0,-5
11095,0,0,89,0,-89
11096,1,1,147,1537,1390
11097,1,0,113,0,-113
11098,1,0,29,0,-29
11099,1,0,41,0,-41
11100,0,0,4,0,-4
11101,0,0,33,0,-33
11102,0,0,4,0,-4
11103,0,0,2,0,-2
11104,0,0,53,0,-53
11105,1,1,171,1927,1756
11106,1,0,20,0,-20
11107,0,0,23,0,-23
11108,1,1,2146,1301,-845
11109,0,0,7,0,-7
11110,1,0,30,0,-30
11111,0,0,268,0,-268
11112,1,1,271,1396,1125
11113,0,0,58,0,-58
11114,1,0,219,0,-219
11115,0,0,69,0,-69
11116,1,0,12,0,-12
11117,1,0,23,0,-23
11118,1,1,2551,1320,-1231
11119,0,0,43,0,-43
11120,0,0,0,0,0
11121,1,1,220,2018,1798
11122,0,0,123,0,-123
11123,1,1,476,1299,823
11124,1,0,43,0,-43
11125,1,1,127,1340,1213
11126,0,0,28,0,-28
11127,1,0,25,0,-25
11128,1,0,31,0,-31
11129,1,1,42,1369,1327
11130,1,1,287,1333,1046
11131,1,1,82,1240,1158
11132,0,0,56,0,-56
11133,0,0,82,0,-82
11134,1,1,780,2209,1429
11135,1,1,585,1364,779
11136,1,0,131,0,-131
11137,0,0,11,0,-11
11138,1,0,117,0,-117
11139,1,0,19,0,-19
11140,0,0,19,0,-19
11141,1,1,112,1564,1452
11142,1,1,45,1559,1514
11143,1,0,145,0,-145
11144,1,0,49,0,-49
11145,1,0,22,0,-22
11146,1,1,350,1582,1232
11147,1,0,1,0,-1
11148,0,0,100,0,-100
11149,0,0,37,0,-37
11150,1,1,223,1601,1378
11151,1,0,125,0,-125
11152,1,1,1100,1215,115
11153,0,0,43,0,-43
11154,0,0,39,0,-39
11155,1,0,21,0,-21
11156,1,1,1005,1317,312
11157,0,0,6,0,-6
11158,0,0,68,0,-68
11159,1,0,41,0,-41
11160,1,0,61,0,-61
11161,0,0,52,0,-52
11162,1,0,49,0,-49
11163,1,1,55,1294,1239
11164,1,0,6,0,-6
11165,1,1,402,2364,1962
11166,1,0,1,0,-1
11167,0,0,10,0,-10
11168,1,1,579,1252,673
11169,0,0,61,0,-61
11170,0,0,65,0,-65
11171,1,0,5,0,-5
11172,0,0,11,0,-11
11173,1,0,23,0,-23
11174,1,1,82,1313,1231
11175,0,0,61,0,-61
11176,0,0,23,0,-23
11177,1,1,221,1294,1073
11178,1,0,175,0,-175
11179,0,0,8,0,-8
11180,1,0,51,0,-51
11181,0,0,75,0,-75
11182,0,0,121,0,-121
11183,1,1,52,1212,1160
11184,1,1,1038,1307,269
11185,0,0,8,0,-8
11186,1,0,5,0,-5
11187,1,0,56,0,-56
11188,0,0,18,0,-18
11189,1,1,1789,1854,65
11190,1,0,13,0,-13
11191,0,0,22,0,-22
11192,1,1,111,1408,1297
11193,0,0,94,0,-94
11194,1,1,743,1252,509
11195,1,1,1557,1317,-240
11196,0,0,39,0,-39
11197,0,0,2,0,-2
11198,0,0,62,0,-62
11199,1,1,1555,1423,-132
11200,0,0,63,0,-63
11201,0,0,52,0,-52
11202,0,0,5,0,-5
11203,1,0,0,0,0
11204,1,1,601,1761,1160
11205,0,0,60,0,-60
11206,1,1,458,1745,1287
11207,1,0,50,0,-50
11208,1,0,59,0,-59
11209,0,0,111,0,-111
11210,0,0,45,0,-45
11211,0,0,93,0,-93
11212,1,1,1171,1669,498
11213,0,0,13,0,-13
11214,1,0,44,0,-44
11215,0,0,35,0,-35
11216,1,0,11,0,-11
11217,1,1,2186,1388,-798
11218,0,0,36,0,-36
11219,0,0,128,0,-128
11220,1,0,41,0,-41
11221,0,0,4,0,-4
11222,1,1,200,1408,1208
11223,0,0,3,0,-3
11224,1,0,7,0,-7
11225,0,0,7,0,-7
11226,0,0,26,0,-26
11227,1,0,50,0,-50
11228,0,0,117,0,-117
11229,1,1,492,1631,1139
11230,0,0,54,0,-54
11231,0,0,51,0,-51
11232,1,0,21,0,-21
11233,1,0,48,0,-48
11234,1,0,4,0,-4
11235,0,0,30,0,-30
11236,1,1,107,1953,1846
11237,0,0,248,0,-248
11238,0,0,47,0,-47
11239,1,0,20,0,-20
11240,0,0,56,0,-56
11241,1,1,1022,4467,3445
11242,1,0,23,0,-23
11243,1,1,917,1214,297
11244,0,0,95,0,-95
11245,1,1,210,1235,1025
11246,1,0,84,0,-84
11247,1,0,65,0,-65
11248,1,0,64,0,-64
11249,0,0,75,0,-75
11250,0,0,116,0,-116
11251,1,0,0,0,0
11252,1,0,79,0,-79
11253,1,1,1366,1514,148
11254,1,1,484,1215,731
11255,1,1,956,1406,450
11256,1,0,57,0,-57
11257,0,0,62,0,-62
11258,0,0,1,0,-1
11259,1,0,30,0,-30
11260,0,0,18,0,-18
11261,0,0,40,0,-40
11262,0,0,51,0,-51
11263,1,0,47,0,-47
11264,0,0,7,0,-7
11265,1,0,31,0,-31
11266,1,0,0,0,0
11267,0,0,36,0,-36
11268,1,0,111,0,-111
11269,0,0,98,0,-98
11270,0,0,178,0,-178
11271,0,0,3,0,-3
11272,1,0,35,0,-35
11273,0,0,3,0,-3
11274,0,0,3,0,-3
11275,1,1,1598,1309,-289
11276,0,0,41,0,-41
11277,0,0,93,0,-93
11278,1,1,863,1405,542
11279,1,0,69,0,-69
11280,1,0,11,0,-11
11281,0,0,21,0,-21
11282,0,0,18,0,-18
11283,1,0,35,0,-35
11284,0,0,16,0,-16
11285,1,1,1026,1583,557
11286,1,1,281,1413,1132
11287,1,0,58,0,-58
11288,0,0,149,0,-149
11289,1,0,46,0,-46
11290,0,0,6,0,-6
11291,1,0,6,0,-6
11292,1,1,795,1360,565
11293,0,0,32,0,-32
11294,1,1,183,1385,1202
11295,1,0,0,0,0
11296,1,1,335,1705,1370
11297,0,0,3,0,-3
11298,0,0,37,0,-37
11299,1,0,77,0,-77
11300,1,1,184,1406,1222
11301,1,1,150,2036,1886
11302,0,0,24,0,-24
11303,1,0,29,0,-29
11304,0,0,24,0,-24
11305,1,1,1539,1556,17
11306,1,1,126,1724,1598
11307,1,1,684,1652,968
11308,1,0,335,0,-335
11309,1,1,423,3126,2703
11310,1,1,350,1654,1304
11311,0,0,37,0,-37
11312,0,0,56,0,-56
11313,0,0,16,0,-16
11314,1,0,19,0,-19
11315,0,0,152,0,-152
11316,1,1,405,2220,1815
11317,0,0,24,0,-24
11318,1,1,213,1302,1089
11319,1,0,34,0,-34
11320,1,0,148,0,-148
11321,1,1,20,2488,2468
11322,1,0,29,0,-29
11323,1,1,794,1446,652
11324,1,0,2,0,-2
11325,0,0,0,0,0
11326,0,0,81,0,-81
11327,0,0,100,0,-100
11328,0,0,3,0,-3
11329,0,0,72,0,-72
11330,1,1,61,1265,1204
11331,1,0,59,0,-59
11332,0,0,6,0,-6
11333,1,0,170,0,-170
11334,0,0,211,0,-211
11335,1,0,64,0,-64
11336,0,0,129,0,-129
11337,0,0,4,0,-4
11338,1,0,57,0,-57
11339,1,1,689,1442,753
11340,1,0,2,0,-2
11341,1,0,297,0,-297
11342,1,1,326,1230,904
11343,0,0,15,0,-15
11344,0,0,132,0,-132
11345,1,0,34,0,-34
11346,0,0,17,0,-17
11347,1,1,145,1289,1144
11348,1,0,28,0,-28
11349,0,0,51,0,-51
11350,1,0,0,0,0
11351,0,0,52,0,-52
11352,1,0,20,0,-20
11353,1,0,89,0,-89
11354,0,0,30,0,-30
11355,1,1,152,2411,2259
11356,1,0,31,0,-31
11357,0,0,54,0,-54
11358,1,0,3,0,-3
11359,0,0,2,0,-2
11360,1,0,6,0,-6
11361,1,1,291,1243,952
11362,1,0,4,0,-4
11363,1,1,998,1283,285
11364,0,0,123,0,-123
11365,0,0,30,0,-30
11366,0,0,48,0,-48
11367,0,0,41,0,-41
11368,1,1,125,1667,1542
11369,1,1,244,1255,1011
11370,1,1,70,1839,1769
11371,1,1,320,1327,1007
11372,0,0,7,0,-7
11373,1,0,22,0,-22
11374,1,1,175,1588,1413
11375,0,0,63,0,-63
11376,1,0,24,0,-24
11377,1,0,56,0,-56
11378,0,0,91,0,-91
11379,0,0,3,0,-3
11380,1,0,10,0,-10
11381,1,1,1575,1227,-348
11382,1,1,292,1565,1273
11383,1,1,44,2232,2188
11384,1,1,192,1509,1317
11385,0,0,2,0,-2
11386,1,1,365,1284,919
11387,1,0,35,0,-35
11388,0,0,7,0,-7
11389,0,0,19,0,-19
11390,0,0,80,0,-80
11391,1,1,986,1293,307
11392,0,0,43,0,-43
11393,1,1,249,1352,1103
11394,1,0,6,0,-6
11395,0,0,4,0,-4
11396,1,1,31,2539,2508
11397,0,0,35,0,-35
11398,0,0,37,0,-37
11399,1,0,151,0,-151
11400,0,0,15,0,-15
11401,0,0,186,0,-186
11402,1,0,28,0,-28
11403,0,0,43,0,-43
11404,1,0,79,0,-79
11405,0,0,1,0,-1
11406,1,1,896,1256,360
11407,1,1,709,2186,1477
11408,1,0,43,0,-43
11409,1,0,9,0,-9
11410,1,1,259,1261,1002
11411,1,1,800,1286,486
11412,0,0,32,0,-32
11413,0,0,79,0,-79
11414,0,0,2,0,-2
11415,0,0,3,0,-3
11416,1,0,16,0,-16
11417,0,0,1,0,-1
11418,0,0,58,0,-58
11419,0,0,150,0,-150
11420,1,1,692,1746,1054
11421,0,0,20,0,-20
11422,1,0,39,0,-39
11423,1,1,632,1274,642
11424,1,1,401,2210,1809
11425,0,0,73,0,-73
11426,1,1,84,1585,1501
11427,1,0,17,0,-17
11428,1,0,6,0,-6
11429,0,0,9,0,-9
11430,0,0,6,0,-6
11431,1,1,158,1201,1043
11432,1,1,406,1457,1051
11433,1,0,9,0,-9
11434,0,0,14,0,-14
11435,1,0,52,0,-52
11436,1,0,30,0,-30
11437,1,1,1188,1628,440
11438,0,0,6,0,-6
11439,1,0,244,0,-244
11440,1,1,211,1218,1007
11441,0,0,80,0,-80
11442,0,0,3,0,-3
11443,0,0,1,0,-1
11444,1,0,104,0,-104
11445,1,0,56,0,-56
11446,1,0,54,0,-54
11447,1,1,673,1981,1308
11448,1,0,109,0,-109
11449,0,0,156,0,-156
11450,0,0,38,0,-38
11451,0,0,32,0,-32
11452,1,1,421,1343,922
11453,0,0,52,0,-52
11454,0,0,27,0,-27
11455,1,0,3,0,-3
11456,0,0,38,0,-38
11457,1,0,25,0,-25
11458,1,1,375,1965,1590
11459,1,0,2,0,-2
11460,1,1,282,1225,943
11461,0,0,1,0,-1
11462,0,0,8,0,-8
11463,1,0,26,0,-26
11464,1,1,383,1212,829
11465,0,0,24,0,-24
11466,1,0,109,0,-109
11467,1,0,71,0,-71
11468,1,0,72,0,-72
11469,0,0,10,0,-10
11470,1,1,316,1421,1105
11471,1,1,425,2629,2204
11472,0,0,37,0,-37
11473,0,0,25,0,-25
11474,1,1,945,1376,431
11475,1,1,942,1428,486
11476,0,0,90,0,-90
11477,1,1,620,1623,1003
11478,1,1,256,1346,1090
11479,1,0,85,0,-85
11480,0,0,196,0,-196
11481,1,1,1510,1255,-255
11482,1,0,118,0,-118
11483,1,1,139,1700,1561
11484,0,0,100,0,-100
11485,0,0,16,0,-16
11486,0,0,212,0,-212
11487,1,0,63,0,-63
11488,0,0,4,0,-4
11489,1,0,39,0,-39
11490,1,1,434,1752,1318
11491,1,0,46,0,-46
11492,1,1,94,2553,2459
11493,1,0,142,0,-142
11494,0,0,46,0,-46
11495,1,1,230,1245,1015
11496,1,0,13,0,-13
11497,0,0,150,0,-150
11498,1,1,96,1760,1664
11499,1,0,39,0,-39
11500,0,0,78,0,-78
11501,0,0,131,0,-131
11502,0,0,84,0,-84
11503,0,0,34,0,-34
11504,0,0,48,0,-48
11505,1,1,72,1331,1259
11506,0,0,20,0,-20
11507,1,0,6,0,-6
11508,1,1,854,1366,512
11509,1,1,382,1935,1553
11510,0,0,30,0,-30
11511,1,1,203,1437,1234
11512,1,1,128,1923,1795
11513,1,0,60,0,-60
11514,1,1,265,1882,1617
11515,0,0,7,0,-7
11516,0,0,129,0,-129
11517,1,1,484,1597,1113
11518,0,0,20,0,-20
11519,0,0,2,0,-2
11520,0,0,28,0,-28
11521,0,0,30,0,-30
11522,1,0,53,0,-53
11523,0,0,33,0,-33
11524,1,1,443,1238,795
11525,1,0,28,0,-28
11526,0,0,6,0,-6
11527,0,0,45,0,-45
11528,1,1,1521,1209,-312
11529,1,0,7,0,-7
11530,1,1,1403,1311,-92
11531,1,0,18,0,-18
11532,0,0,138,0,-138
11533,1,0,1,0,-1
11534,1,0,76,0,-76
11535,0,0,29,0,-29
11536,1,1,81,1677,1596
11537,0,0,7,0,-7
11538,1,0,13,0,-13
11539,0,0,148,0,-148
11540,1,0,14,0,-14
11541,0,0,42,0,-42
11542,1,1,230,2067,1837
11543,1,0,20,0,-20
11544,0,0,159,0,-159
11545,1,0,18,0,-18
11546,1,1,714,1382,668
11547,0,0,148,0,-148
11548,1,1,1074,1463,389
11549,0,0,21,0,-21
11550,0,0,4,0,-4
11551,0,0,2,0,-2
11552,0,0,9,0,-9
11553,1,1,338,1439,1101
11554,1,1,447,1544,1097
11555,1,0,149,0,-149
11556,0,0,20,0,-20
11557,1,0,47,0,-47
11558,1,0,8,0,-8
11559,0,0,50,0,-50
11560,1,1,545,2112,1567
11561,1,0,7,0,-7
11562,1,0,42,0,-42
11563,0,0,98,0,-98
11564,1,1,850,1622,772
11565,1,1,527,1250,723
11566,1,0,53,0,-53
11567,1,0,42,0,-42
11568,1,1,196,1219,1023
11569,1,1,250,1936,1686
11570,0,0,0,0,0
11571,0,0,14,0,-14
11572,1,1,1873,1280,-593
11573,1,0,192,0,-192
11574,1,1,208,1217,1009
11575,0,0,50,0,-50
11576,0,0,28,0,-28
11577,1,1,442,1553,1111
11578,0,0,11,0,-11
11579,1,0,75,0,-75
11580,0,0,113,0,-113
11581,1,0,54,0,-54
11582,1,1,399,1549,1150
11583,0,0,62,0,-62
11584,1,0,109,0,-109
11585,1,1,225,1356,1131
11586,0,0,11,0,-11
11587,1,0,129,0,-129
11588,1,0,18,0,-18
11589,1,1,894,1784,890
11590,0,0,36,0,-36
11591,1,1,1549,1233,-316
11592,0,0,12,0,-12
11593,0,0,190,0,-190
11594,1,1,1382,1600,218
11595,1,1,65,1980,1915
11596,0,0,96,0,-96
11597,1,1,1047,2158,1111
11598,0,0,144,0,-144
11599,1,0,82,0,-82
11600,0,0,16,0,-16
11601,0,0,26,0,-26
11602,1,1,118,1440,1322
11603,0,0,71,0,-71
11604,0,0,59,0,-59
11605,0,0,52,0,-52
11606,1,1,721,1411,690
11607,0,0,22,0,-22
11608,1,1,1083,1543,460
11609,1,1,602,1276,674
11610,1,1,642,5130,4488
11611,1,1,709,1496,787
11612,0,0,9,0,-9
11613,0,0,24,0,-24
11614,1,0,143,0,-143
11615,1,1,846,1555,709
11616,1,1,382,1212,830
11617,1,1,208,1568,1360
11618,1,0,2,0,-2
11619,1,1,1123,1617,494
11620,0,0,16,0,-16
11621,1,0,113,0,-113
11622,1,0,1,0,-1
11623,1,1,447,1597,1150
11624,1,1,602,3615,3013
11625,0,0,10,0,-10
11626,1,1,1066,2344,1278
11627,1,0,8,0,-8
11628,0,0,38,0,-38
11629,1,1,809,1404,595
11630,1,0,30,0,-30
11631,1,1,258,1365,1107
11632,1,1,366,1288,922
11633,1,0,29,0,-29
11634,0,0,18,0,-18
11635,0,0,39,0,-39
11636,1,1,157,1546,1389
11637,1,1,1168,1422,254
11638,1,0,7,0,-7
11639,1,1,420,1572,1152
11640,0,0,63,0,-63
11641,1,1,833,2422,1589
11642,1,1,731,1783,1052
11643,0,0,48,0,-48
11644,1,1,267,1894,1627
11645,0,0,57,0,-57
11646,1,1,544,1617,1073
11647,0,0,120,0,-120
11648,1,0,8,0,-8
11649,0,0,42,0,-42
11650,1,1,181,1503,1322
11651,1,1,536,1282,746
11652,1,0,59,0,-59
11653,0,0,74,0,-74
11654,1,1,911,1287,376
11655,0,0,112,0,-112
11656,1,0,11,0,-11
11657,0,0,39,0,-39
11658,1,0,14,0,-14
11659,1,0,110,0,-110
11660,1,0,31,0,-31
11661,1,0,2,0,-2
11662,1,1,1310,1739,429
11663,1,1,372,1282,910
11664,0,0,63,0,-63
11665,1,1,285,1665,1380
11666,0,0,96,0,-96
11667,1,0,41,0,-41
11668,0,0,111,0,-111
11669,1,0,2,0,-2
11670,1,1,449,1972,1523
11671,1,1,471,1389,918
11672,1,0,11,0,-11
11673,0,0,80,0,-80
11674,1,1,931,1475,544
11675,0,0,32,0,-32
11676,1,1,910,1494,584
11677,1,0,49,0,-49
11678,0,0,152,0,-152
11679,1,1,469,1314,845
11680,0,0,17,0,-17
11681,1,0,39,0,-39
11682,1,0,13,0,-13
11683,0,0,2,0,-2
11684,0,0,66,0,-66
11685,0,0,86,0,-86
11686,0,0,115,0,-115
11687,0,0,48,0,-48
11688,1,1,175,1242,1067
11689,0,0,50,0,-50
11690,0,0,41,0,-41
11691,0,0,28,0,-28
11692,1,0,2,0,-2
11693,1,1,274,1269,995
11694,1,1,466,1405,939
11695,1,1,616,2619,2003
11696,0,0,5,0,-5
11697,1,1,1291,1478,187
11698,1,1,180,1959,1779
11699,1,0,52,0,-52
11700,0,0,56,0,-56
11701,1,1,522,1481,959
11702,1,0,65,0,-65
11703,0,0,18,0,-18
11704,1,0,32,0,-32
11705,1,1,1171,1422,251
11706,1,0,22,0,-22
11707,0,0,9,0,-9
11708,0,0,17,0,-17
11709,0,0,44,0,-44
11710,1,0,69,0,-69
11711,1,1,42,1219,1177
11712,1,0,39,0,-39
11713,1,0,107,0,-107
11714,0,0,8,0,-8
11715,0,0,63,0,-63
11716,0,0,10,0,-10
11717,0,0,1,0,-1
11718,1,0,6,0,-6
11719,0,0,31,0,-31
11720,0,0,20,0,-20
11721,1,1,47,1258,1211
11722,1,1,1568,1320,-248
11723,1,0,42,0,-42
11724,1,1,180,1439,1259
11725,1,0,57,0,-57
11726,1,0,24,0,-24
11727,1,0,1,0,-1
11728,0,0,75,0,-75
11729,1,0,61,0,-61
11730,0,0,17,0,-17
11731,0,0,57,0,-57
11732,1,1,721,1285,564
11733,1,1,800,1286,486
11734,1,0,42,0,-42
11735,0,0,151,0,-151
11736,1,1,485,1314,829
11737,1,0,73,0,-73
11738,1,0,127,0,-127
11739,1,1,751,1549,798
11740,1,1,131,1281,1150
11741,1,0,24,0,-24
11742,0,0,62,0,-62
11743,0,0,7,0,-7
11744,0,0,10,0,-10
11745,1,1,178,1751,1573
11746,0,0,8,0,-8
11747,0,0,137,0,-137
11748,1,1,575,1375,800
11749,1,1,767,1752,985
11750,1,1,737,1794,1057
11751,0,0,18,0,-18
11752,1,0,6,0,-6
11753,0,0,7,0,-7
11754,1,1,3372,1335,-2037
11755,0,0,97,0,-97
11756,0,0,25,0,-25
11757,0,0,23,0,-23
11758,1,0,46,0,-46
11759,1,1,304,1446,1142
11760,1,1,97,1246,1149
11761,0,0,15,0,-15
11762,1,1,916,1989,1073
11763,0,0,109,0,-109
11764,1,0,195,0,-195
11765,0,0,4,0,-4
11766,0,0,34,0,-34
11767,0,0,18,0,-18
11768,1,1,332,1351,1019
11769,0,0,15,0,-15
11770,1,0,60,0,-60
11771,0,0,98,0,-98
11772,1,0,1,0,-1
11773,1,0,87,0,-87
11774,0,0,61,0,-61
11775,1,1,158,1483,1325
11776,0,0,3,0,-3
11777,1,1,314,1328,1014
11778,0,0,113,0,-113
11779,1,1,38,1419,1381
11780,1,0,96,0,-96
11781,1,0,17,0,-17
11782,1,1,817,2015,1198
11783,0,0,78,0,-78
11784,1,1,15,1328,1313
11785,0,0,80,0,-80
11786,1,0,49,0,-49
11787,1,0,22,0,-22
11788,1,0,42,0,-42
11789,1,1,326,1295,969
11790,1,0,60,0,-60
11791,0,0,24,0,-24
11792,0,0,9,0,-9
11793,1,1,78,2786,2708
11794,1,0,58,0,-58
11795,1,1,1167,2099,932
11796,1,1,883,1330,447
11797,1,0,18,0,-18
11798,1,1,802,1630,828
11799,1,1,192,1343,1151
11800,0,0,2,0,-2
11801,1,0,100,0,-100
11802,0,0,41,0,-41
11803,1,1,604,1217,613
11804,1,1,676,1296,620
11805,1,1,549,1522,973
11806,0,0,22,0,-22
11807,1,0,43,0,-43
11808,0,0,62,0,-62
11809,0,0,61,0,-61
11810,1,0,9,0,-9
11811,0,0,50,0,-50
11812,0,0,29,0,-29
11813,1,0,31,0,-31
11814,0,0,32,0,-32
11815,1,0,24,0,-24
11816,0,0,29,0,-29
11817,0,0,66,0,-66
11818,0,0,44,0,-44
11819,1,1,791,1393,602
11820,1,1,921,2232,1311
11821,1,0,7,0,-7
11822,1,0,95,0,-95
11823,1,0,32,0,-32
11824,1,0,35,0,-35
11825,0,0,35,0,-35
11826,0,0,72,0,-72
11827,1,0,14,0,-14
11828,1,1,773,1866,1093
11829,1,0,90,0,-90
11830,0,0,21,0,-21
11831,0,0,28,0,-28
11832,1,0,48,0,-48
11833,0,0,44,0,-44
11834,0,0,34,0,-34
11835,0,0,14,0,-14
11836,1,1,60,1733,1673
11837,1,0,56,0,-56
11838,1,1,264,1984,1720
11839,0,0,24,0,-24
11840,1,0,5,0,-5
11841,1,1,487,1213,726
11842,1,0,57,0,-57
11843,1,0,48,0,-48
11844,1,0,44,0,-44
11845,1,1,416,1245,829
11846,1,1,56,1223,1167
11847,0,0,97,0,-97
11848,1,0,0,0,0
11849,0,0,116,0,-116
11850,1,1,75,1354,1279
11851,1,1,228,1220,992
11852,1,0,53,0,-53
11853,1,0,0,0,0
11854,1,1,509,1584,1075
11855,0,0,1,0,-1
11856,1,0,34,0,-34
11857,0,0,4,0,-4
11858,1,1,489,1256,767
11859,1,0,56,0,-56
11860,1,0,31,0,-31
11861,0,0,51,0,-51
11862,1,0,62,0,-62
11863,1,0,149,0,-149
11864,1,1,61,1308,1247
11865,0,0,84,0,-84
11866,1,0,13,0,-13
11867,1,0,24,0,-24
11868,1,0,5,0,-5
11869,1,0,88,0,-88
11870,1,1,35,1403,1368
11871,1,0,87,0,-87
11872,1,0,23,0,-23
11873,0,0,44,0,-44
11874,0,0,37,0,-37
11875,0,0,98,0,-98
11876,1,1,98,1907,1809
11877,1,1,51,1692,1641
11878,1,0,15,0,-15
11879,1,0,15,0,-15
11880,0,0,7,0,-7
11881,1,0,1,0,-1
11882,1,0,181,0,-181
11883,1,1,93,1404,1311
11884,1,0,128,0,-128
11885,1,1,2532,1963,-569
11886,0,0,39,0,-39
11887,0,0,11,0,-11
11888,0,0,75,0,-75
11889,1,1,888,2392,1504
11890,1,0,30,0,-30
11891,0,0,68,0,-68
11892,1,1,762,1914,1152
11893,1,0,16,0,-16
11894,1,1,141,1392,1251
11895,0,0,72,0,-72
11896,0,0,139,0,-139
11897,1,1,107,1406,1299
11898,1,1,1098,1321,223
11899,0,0,28,0,-28
11900,1,0,86,0,-86
11901,1,1,775,1291,516
11902,1,0,115,0,-115
11903,1,0,67,0,-67
11904,1,0,44,0,-44
11905,1,0,49,0,-49
11906,1,0,17,0,-17
11907,1,1,1510,1971,461
11908,0,0,55,0,-55
11909,0,0,27,0,-27
11910,1,1,650,1353,703
11911,0,0,6,0,-6
11912,1,0,14,0,-14
11913,0,0,61,0,-61
11914,1,1,1055,1220,165
11915,0,0,80,0,-80
11916,0,0,15,0,-15
11917,0,0,57,0,-57
11918,0,0,48,0,-48
11919,1,0,133,0,-133
11920,1,1,232,1214,982
11921,0,0,17,0,-17
11922,0,0,58,0,-58
11923,0,0,76,0,-76
11924,0,0,3,0,-3
11925,0,0,7,0,-7
11926,0,0,32,0,-32
11927,0,0,4,0,-4
11928,1,0,43,0,-43
11929,1,0,0,0,0
11930,1,0,53,0,-53
11931,1,1,595,1591,996
11932,0,0,58,0,-58
11933,1,1,496,1395,899
11934,1,0,13,0,-13
11935,0,0,8,0,-8
11936,1,1,181,1699,1518
11937,1,1,598,1399,801
11938,1,1,976,1410,434
11939,1,1,440,1360,920
11940,1,0,1,0,-1
11941,1,1,194,1575,1381
11942,1,0,44,0,-44
11943,1,0,77,0,-77
11944,0,0,146,0,-146
11945,0,0,11,0,-11
11946,1,1,1065,2168,1103
11947,1,1,614,1525,911
11948,1,1,334,1212,878
11949,0,0,11,0,-11
11950,0,0,23,0,-23
11951,1,0,31,0,-31
11952,1,1,698,1312,614
11953,0,0,102,0,-102
11954,0,0,7,0,-7
11955,1,0,6,0,-6
11956,1,1,1365,1669,304
11957,1,1,235,1491,1256
11958,1,0,95,0,-95
11959,1,1,323,1536,1213
11960,0,0,76,0,-76
11961,1,1,488,1403,915
11962,0,0,54,0,-54
11963,1,1,378,1892,1514
11964,1,0,0,0,0
11965,0,0,66,0,-66
11966,1,0,98,0,-98
11967,1,1,293,1328,1035
11968,0,0,19,0,-19
11969,1,0,73,0,-73
11970,0,0,92,0,-92
11971,1,1,567,1722,1155
11972,0,0,38,0,-38
11973,0,0,156,0,-156
11974,1,0,118,0,-118
11975,0,0,112,0,-112
11976,1,0,9,0,-9
11977,0,0,8,0,-8
11978,1,1,1559,1275,-284
11979,1,1,358,2457,2099
11980,1,1,211,1259,1048
11981,0,0,34,0,-34
11982,0,0,13,0,-13
11983,1,1,57,1510,1453
11984,1,1,19,2383,2364
11985,1,1,193,1431,1238
11986,0,0,39,0,-39
11987,0,0,58,0,-58
11988,1,0,21,0,-21
11989,0,0,13,0,-13
11990,1,0,3,0,-3
11991,0,0,192,0,-192
11992,1,1,36,1529,1493
11993,0,0,1,0,-1
11994,1,1,797,1387,590
11995,0,0,64,0,-64
11996,1,1,217,1281,1064
11997,1,0,16,0,-16
11998,1,0,22,0,-22
11999,1,0,35,0,-35
12000,1,1,1639,1830,191
12001,0,0,154,0,-154
12002,0,0,1,0,-1
12003,0,0,98,0,-98
12004,1,0,4,0,-4
12005,1,0,100,0,-100
12006,0,0,0,0,0
12007,1,1,303,1278,975
12008,1,0,154,0,-154
12009,1,1,1138,1274,136
12010,1,1,789,1224,435
12011,1,0,68,0,-68
12012,0,0,71,0,-71
12013,1,0,9,0,-9
12014,0,0,12,0,-12
12015,1,0,7,0,-7
12016,1,0,175,0,-175
12017,1,0,149,0,-149
12018,1,1,383,1321,938
12019,0,0,1,0,-1
12020,1,1,788,1298,510
12021,0,0,20,0,-20
12022,0,0,24,0,-24
12023,1,0,39,0,-39
12024,0,0,3,0,-3
12025,1,1,237,1336,1099
12026,1,0,48,0,-48
12027,1,0,9,0,-9
12028,0,0,58,0,-58
12029,0,0,56,0,-56
12030,1,1,924,1847,923
12031,1,1,31,1308,1277
12032,0,0,8,0,-8
12033,1,0,194,0,-194
12034,0,0,123,0,-123
12035,0,0,49,0,-49
12036,0,0,11,0,-11
12037,1,1,673,1343,670
12038,0,0,103,0,-103
12039,1,1,390,1354,964
12040,0,0,49,0,-49
12041,1,1,148,1261,1113
12042,0,0,7,0,-7
12043,1,1,188,1332,1144
12044,1,0,64,0,-64
12045,1,0,71,0,-71
12046,0,0,25,0,-25
12047,1,0,65,0,-65
12048,0,0,13,0,-13
12049,1,0,5,0,-5
12050,0,0,17,0,-17
12051,0,0,35,0,-35
12052,1,0,14,0,-14
12053,1,0,42,0,-42
12054,0,0,13,0,-13
12055,1,1,994,2042,1048
12056,1,1,579,5584,5005
12057,1,1,538,1275,737
12058,0,0,75,0,-75
12059,0,0,77,0,-77
12060,0,0,26,0,-26
12061,1,1,77,1276,1199
12062,1,1,1539,1215,-324
12063,0,0,16,0,-16
12064,0,0,4,0,-4
12065,1,0,9,0,-9
12066,1,0,27,0,-27
12067,1,0,32,0,-32
12068,1,0,11,0,-11
12069,0,0,16,0,-16
12070,0,0,138,0,-138
12071,0,0,38,0,-38
12072,0,0,47,0,-47
12073,0,0,22,0,-22
12074,1,0,70,0,-70
12075,1,1,97,1906,1809
12076,1,0,10,0,-10
12077,1,0,82,0,-82
12078,1,1,379,1381,1002
12079,0,0,65,0,-65
12080,1,0,47,0,-47
12081,0,0,45,0,-45
12082,1,0,67,0,-67
12083,0,0,35,0,-35
12084,0,0,0,0,0
12085,0,0,62,0,-62
12086,0,0,24,0,-24
12087,1,0,99,0,-99
12088,0,0,1,0,-1
12089,0,0,15,0,-15
12090,1,0,13,0,-13
12091,1,1,64,1233,1169
12092,1,1,337,2893,2556
12093,1,0,3,0,-3
12094,0,0,45,0,-45
12095,0,0,96,0,-96
12096,0,0,16,0,-16
12097,0,0,47,0,-47
12098,1,0,67,0,-67
12099,1,0,8,0,-8
12100,0,0,26,0,-26
12101,1,0,74,0,-74
12102,1,1,67,2738,2671
12103,1,0,50,0,-50
12104,1,1,553,1703,1150
12105,1,0,94,0,-94
12106,1,0,34,0,-34
12107,1,0,44,0,-44
12108,1,1,884,1251,367
12109,1,0,10,0,-10
12110,1,1,197,1423,1226
12111,1,1,308,2056,1748
12112,1,1,656,1251,595
12113,1,0,113,0,-113
12114,1,1,377,1304,927
12115,1,0,147,0,-147
12116,1,0,35,0,-35
12117,1,1,619,1487,868
12118,0,0,39,0,-39
12119,1,1,117,1210,1093
12120,0,0,71,0,-71
12121,0,0,43,0,-43
12122,1,0,100,0,-100
12123,1,0,54,0,-54
12124,0,0,126,0,-126
12125,0,0,120,0,-120
12126,0,0,32,0,-32
12127,1,0,72,0,-72
12128,0,0,25,0,-25
12129,0,0,55,0,-55
12130,1,0,156,0,-156
12131,1,1,456,1455,999
12132,0,0,25,0,-25
12133,1,0,1,0,-1
12134,0,0,117,0,-117
12135,1,1,784,1682,898
12136,1,1,731,1909,1178
12137,0,0,8,0,-8
12138,0,0,119,0,-119
12139,0,0,14,0,-14
12140,0,0,0,0,0
12141,0,0,18,0,-18
12142,0,0,32,0,-32
12143,1,1,215,1486,1271
12144,1,1,2255,1201,-1054
12145,1,1,181,1441,1260
12146,1,0,35,0,-35
12147,1,0,109,0,-109
12148,1,0,2,0,-2
12149,0,0,1,0,-1
12150,1,0,27,0,-27
12151,1,0,33,0,-33
12152,0,0,53,0,-53
12153,1,0,64,0,-64
12154,1,0,27,0,-27
12155,1,0,30,0,-30
12156,0,0,43,0,-43
12157,1,0,26,0,-26
12158,1,1,311,1826,1515
12159,1,0,20,0,-20
12160,1,1,961,1284,323
12161,1,1,240,1205,965
12162,1,1,241,1916,1675
12163,0,0,11,0,-11
12164,1,0,103,0,-103
12165,0,0,143,0,-143
12166,0,0,32,0,-32
12167,0,0,22,0,-22
12168,0,0,52,0,-52
12169,1,1,2525,1306,-1219
12170,0,0,62,0,-62
12171,1,1,259,1491,1232
12172,1,1,382,1310,928
12173,1,1,108,1568,1460
12174,1,1,525,1351,826
12175,0,0,29,0,-29
12176,0,0,49,0,-49
12177,1,1,190,1435,1245
12178,0,0,50,0,-50
12179,0,0,51,0,-51
12180,0,0,42,0,-42
12181,0,0,41,0,-41
12182,0,0,28,0,-28
12183,1,0,39,0,-39
12184,1,0,5,0,-5
12185,0,0,32,0,-32
12186,1,1,935,1293,358
12187,1,1,453,2030,1577
12188,1,1,368,1525,1157
12189,1,0,20,0,-20
12190,0,0,72,0,-72
12191,1,1,1315,1245,-70
12192,0,0,24,0,-24
12193,1,1,206,1630,1424
12194,0,0,86,0,-86
12195,0,0,46,0,-46
12196,1,1,60,3799,3739
12197,0,0,27,0,-27
12198,1,0,66,0,-66
12199,1,0,20,0,-20
12200,1,0,22,0,-22
12201,1,1,51,1274,1223
12202,0,0,1,0,-1
12203,1,0,27,0,-27
12204,1,1,508,1275,767
12205,1,0,185,0,-185
12206,1,0,49,0,-49
12207,1,0,16,0,-16
12208,1,0,12,0,-12
12209,1,0,30,0,-30
12210,0,0,45,0,-45
12211,0,0,0,0,0
12212,1,1,833,1847,1014
12213,0,0,34,0,-34
12214,0,0,38,0,-38
12215,1,0,8,0,-8
12216,1,1,135,1741,1606
12217,1,0,51,0,-51
12218,1,0,34,0,-34
12219,1,1,209,1444,1235
12220,0,0,158,0,-158
12221,0,0,7,0,-7
12222,0,0,15,0,-15
12223,0,0,20,0,-20
12224,1,0,58,0,-58
12225,1,0,68,0,-68
12226,1,0,10,0,-10
12227,1,1,1599,1600,1
12228,0,0,62,0,-62
12229,0,0,71,0,-71
12230,0,0,23,0,-23
12231,1,0,3,0,-3
12232,1,0,11,0,-11
12233,1,0,142,0,-142
12234,1,1,611,1218,607
12235,1,0,25,0,-25
12236,1,1,217,1931,1714
12237,1,1,219,1229,1010
12238,1,1,375,1236,861
12239,0,0,40,0,-40
12240,1,1,50,1225,1175
12241,1,0,30,0,-30
12242,0,0,0,0,0
12243,1,1,321,1476,1155
12244,1,0,7,0,-7
12245,1,0,160,0,-160
12246,1,1,449,1819,1370
12247,0,0,6,0,-6
12248,1,0,27,0,-27
12249,1,1,519,1306,787
12250,0,0,121,0,-121
12251,0,0,39,0,-39
12252,1,1,1865,1285,-580
12253,0,0,12,0,-12
12254,1,0,2,0,-2
12255,0,0,61,0,-61
12256,1,1,402,1218,816
12257,0,0,199,0,-199
12258,0,0,79,0,-79
12259,1,0,22,0,-22
12260,1,0,42,0,-42
12261,1,1,195,1567,1372
12262,0,0,3,0,-3
12263,1,1,1068,1431,363
12264,1,1,687,1725,1038
12265,0,0,37,0,-37
12266,1,0,13,0,-13
12267,1,0,40,0,-40
12268,1,1,694,1473,779
12269,0,0,152,0,-152
12270,0,0,26,0,-26
12271,0,0,44,0,-44
12272,0,0,68,0,-68
12273,1,1,370,1323,953
12274,0,0,76,0,-76
12275,1,0,73,0,-73
12276,1,1,213,1622,1409
12277,0,0,125,0,-125
12278,1,1,569,1733,1164
12279,1,0,85,0,-85
12280,0,0,10,0,-10
12281,1,1,383,1336,953
12282,1,1,319,1985,1666
12283,0,0,47,0,-47
12284,0,0,16,0,-16
12285,1,0,51,0,-51
12286,0,0,28,0,-28
12287,0,0,3,0,-3
12288,0,0,31,0,-31
12289,0,0,20,0,-20
12290,1,1,140,1466,1326
12291,0,0,29,0,-29
12292,0,0,56,0,-56
12293,0,0,44,0,-44
12294,0,0,27,0,-27
12295,1,0,59,0,-59
12296,1,0,52,0,-52
12297,1,1,416,1348,932
12298,0,0,106,0,-106
12299,1,0,59,0,-59
12300,0,0,2,0,-2
12301,1,0,103,0,-103
12302,1,0,115,0,-115
12303,1,0,38,0,-38
12304,1,1,181,1801,1620
12305,1,1,2094,1212,-882
12306,1,1,241,1226,985
12307,1,1,46,1512,1466
12308,1,1,179,1413,1234
12309,1,1,133,1266,1133
12310,0,0,226,0,-226
12311,1,0,176,0,-176
12312,1,0,97,0,-97
12313,1,0,27,0,-27
12314,1,1,1027,1620,593
12315,1,1,316,1223,907
12316,1,1,249,1952,1703
12317,0,0,15,0,-15
12318,1,1,650,2600,1950
12319,0,0,13,0,-13
12320,1,1,318,1417,1099
12321,1,1,112,1280,1168
12322,1,0,32,0,-32
12323,0,0,27,0,-27
12324,1,0,3,0,-3
12325,1,1,199,1334,1135
12326,0,0,144,0,-144
12327,0,0,53,0,-53
12328,0,0,78,0,-78
12329,0,0,83,0,-83
12330,0,0,36,0,-36
12331,0,0,140,0,-140
12332,0,0,41,0,-41
12333,1,0,83,0,-83
12334,1,0,22,0,-22
12335,1,0,84,0,-84
12336,0,0,3,0,-3
12337,0,0,26,0,-26
12338,1,0,6,0,-6
12339,1,0,34,0,-34
12340,0,0,30,0,-30
12341,1,1,726,1400,674
12342,0,0,23,0,-23
12343,1,1,1401,1983,582
12344,1,0,2,0,-2
12345,1,0,72,0,-72
12346,0,0,23,0,-23
12347,0,0,41,0,-41
12348,0,0,53,0,-53
12349,1,0,17,0,-17
12350,0,0,47,0,-47
12351,1,0,6,0,-6
12352,1,1,1393,1762,369
12353,0,0,74,0,-74
12354,1,1,985,1288,303
12355,0,0,64,0,-64
12356,1,1,549,1262,713
12357,1,0,102,0,-102
12358,1,0,37,0,-37
12359,1,0,32,0,-32
12360,1,0,49,0,-49
12361,0,0,5,0,-5
12362,1,0,36,0,-36
12363,1,1,880,1648,768
12364,1,0,127,0,-127
12365,1,0,34,0,-34
12366,1,1,2514,1674,-840
12367,0,0,89,0,-89
12368,1,1,256,1693,1437
12369,0,0,96,0,-96
12370,1,1,756,1442,686
12371,0,0,66,0,-66
12372,0,0,59,0,-59
12373,0,0,36,0,-36
12374,1,1,744,2509,1765
12375,1,1,423,2166,1743
12376,0,0,106,0,-106
12377,0,0,61,0,-61
12378,1,0,67,0,-67
12379,1,0,48,0,-48
12380,1,0,8,0,-8
12381,1,1,1625,1615,-10
12382,1,0,24,0,-24
12383,0,0,94,0,-94
12384,1,0,33,0,-33
12385,1,1,1795,1235,-560
12386,1,1,197,1264,1067
12387,1,0,101,0,-101
12388,1,1,1384,2050,666
12389,1,1,749,1276,527
12390,1,1,641,1424,783
12391,0,0,151,0,-151
12392,1,0,38,0,-38
12393,1,0,92,0,-92
12394,1,0,17,0,-17
12395,1,0,9,0,-9
12396,1,1,86,1924,1838
12397,1,0,1,0,-1
12398,1,0,60,0,-60
12399,0,0,45,0,-45
12400,0,0,24,0,-24
12401,0,0,5,0,-5
12402,1,1,634,2248,1614
12403,1,1,44,2013,1969
12404,0,0,94,0,-94
12405,1,0,12,0,-12
12406,1,0,0,0,0
12407,1,1,441,1388,947
12408,1,0,22,0,-22
12409,1,1,151,1220,1069
12410,0,0,50,0,-50
12411,1,0,73,0,-73
12412,0,0,17,0,-17
12413,1,1,309,1482,1173
12414,1,0,15,0,-15
12415,1,1,314,1512,1198
12416,1,0,77,0,-77
12417,0,0,30,0,-30
12418,1,1,521,1722,1201
12419,1,0,99,0,-99
12420,1,0,47,0,-47
12421,0,0,91,0,-91
12422,0,0,46,0,-46
12423,1,1,256,1342,1086
12424,0,0,89,0,-89
12425,1,1,59,1339,1280
12426,1,1,412,1200,788
12427,1,0,135,0,-135
12428,1,0,134,0,-134
12429,0,0,1,0,-1
12430,1,1,234,1366,1132
12431,0,0,26,0,-26
12432,0,0,36,0,-36
12433,0,0,51,0,-51
12434,0,0,90,0,-90
12435,1,0,30,0,-30
12436,1,1,722,1357,635
12437,1,0,16,0,-16
12438,1,0,11,0,-11
12439,1,0,33,0,-33
12440,1,0,38,0,-38
12441,0,0,42,0,-42
12442,0,0,28,0,-28
12443,0,0,9,0,-9
12444,1,1,1405,1372,-33
12445,1,1,307,2308,2001
12446,1,0,17,0,-17
12447,1,0,118,0,-118
12448,0,0,108,0,-108
12449,1,1,667,1264,597
12450,0,0,19,0,-19
12451,1,1,522,1634,1112
12452,1,1,84,1204,1120
12453,1,1,290,1205,915
12454,0,0,92,0,-92
12455,1,0,40,0,-40
12456,0,0,3,0,-3
12457,1,1,265,1407,1142
12458,1,1,221,1286,1065
12459,0,0,104,0,-104
12460,1,1,851,1436,585
12461,1,0,40,0,-40
12462,0,0,41,0,-41
12463,1,0,138,0,-138
12464,1,0,26,0,-26
12465,0,0,78,0,-78
12466,1,0,9,0,-9
12467,0,0,36,0,-36
12468,0,0,214,0,-214
12469,1,0,11,0,-11
12470,0,0,42,0,-42
12471,0,0,66,0,-66
12472,0,0,20,0,-20
12473,0,0,27,0,-27
12474,1,0,37,0,-37
12475,1,0,9,0,-9
12476,1,1,1032,1398,366
12477,1,1,579,1295,716
12478,1,1,330,1508,1178
12479,0,0,214,0,-214
12480,1,1,729,1422,693
12481,1,0,13,0,-13
12482,1,1,288,1470,1182
12483,1,0,20,0,-20
12484,0,0,46,0,-46
12485,0,0,129,0,-129
12486,1,0,4,0,-4
12487,0,0,11,0,-11
12488,1,0,25,0,-25
12489,1,1,459,1690,1231
12490,0,0,35,0,-35
12491,1,1,49,1617,1568
12492,0,0,75,0,-75
12493,0,0,39,0,-39
12494,0,0,138,0,-138
12495,1,1,241,1202,961
12496,0,0,39,0,-39
12497,1,0,15,0,-15
12498,1,1,232,1352,1120
12499,0,0,40,0,-40
12500,1,1,421,1815,1394
12501,1,0,15,0,-15
12502,1,0,0,0,0
12503,0,0,169,0,-169
12504,1,1,147,1468,1321
12505,0,0,37,0,-37
12506,1,0,2,0,-2
12507,1,1,63,1211,1148
12508,1,0,32,0,-32
12509,1,1,146,1528,1382
12510,1,0,1,0,-1
12511,1,0,10,0,-10
12512,0,0,38,0,-38
12513,1,1,575,1571,996
12514,1,0,85,0,-85
12515,0,0,12,0,-12
12516,1,1,821,1556,735
12517,1,0,30,0,-30
12518,0,0,0,0,0
12519,1,1,615,1342,727
12520,1,0,14,0,-14
12521,0,0,3,0,-3
12522,0,0,4,0,-4
12523,1,0,6,0,-6
12524,0,0,13,0,-13
12525,1,0,31,0,-31
12526,0,0,167,0,-167
12527,1,1,1326,1252,-74
12528,0,0,8,0,-8
12529,1,1,121,1326,1205
12530,1,0,107,0,-107
12531,0,0,41,0,-41
12532,0,0,8,0,-8
12533,0,0,90,0,-90
12534,1,0,9,0,-9
12535,0,0,67,0,-67
12536,1,0,7,0,-7
12537,1,1,167,1201,1034
12538,0,0,6,0,-6
12539,0,0,89,0,-89
12540,0,0,150,0,-150
12541,1,0,1,0,-1
12542,1,0,30,0,-30
12543,1,1,604,1612,1008
12544,1,0,12,0,-12
12545,1,0,44,0,-44
12546,0,0,1,0,-1
12547,1,0,27,0,-27
12548,1,1,3401,1782,-1619
12549,1,1,176,1322,1146
12550,1,0,48,0,-48
12551,0,0,82,0,-82
12552,1,0,31,0,-31
12553,1,0,75,0,-75
12554,1,1,300,1235,935
12555,1,1,924,1647,723
12556,1,0,1,0,-1
12557,1,1,942,1301,359
12558,0,0,7,0,-7
12559,1,0,1,0,-1
12560,1,1,716,1320,604
12561,1,0,8,0,-8
12562,0,0,6,0,-6
12563,0,0,46,0,-46
12564,1,1,401,1458,1057
12565,1,1,219,1394,1175
12566,0,0,21,0,-21
12567,1,0,8,0,-8
12568,1,0,117,0,-117
12569,1,1,317,1591,1274
12570,1,0,27,0,-27
12571,0,0,48,0,-48
12572,1,1,755,1449,694
12573,1,0,39,0,-39
12574,0,0,61,0,-61
12575,1,1,126,1353,1227
12576,1,1,585,1218,633
12577,0,0,27,0,-27
12578,1,1,520,1477,957
12579,1,1,2298,1255,-1043
12580,0,0,78,0,-78
12581,1,0,23,0,-23
12582,0,0,18,0,-18
12583,0,0,248,0,-248
12584,1,0,277,0,-277
12585,1,1,784,1244,460
12586,0,0,88,0,-88
12587,1,1,797,1359,562
12588,1,0,2,0,-2
12589,1,1,822,1236,414
12590,1,1,562,1503,941
12591,1,1,473,1785,1312
12592,1,0,28,0,-28
12593,0,0,19,0,-19
12594,0,0,58,0,-58
12595,1,0,127,0,-127
12596,1,1,183,1259,1076
12597,0,0,8,0,-8
12598,1,1,372,1349,977
12599,0,0,9,0,-9
12600,0,0,71,0,-71
12601,1,0,2,0,-2
12602,0,0,51,0,-51
12603,0,0,30,0,-30
12604,0,0,185,0,-185
12605,1,0,16,0,-16
12606,0,0,16,0,-16
12607,1,1,714,1470,756
12608,0,0,81,0,-81
12609,1,1,36,1869,1833
12610,1,0,6,0,-6
12611,1,0,86,0,-86
12612,0,0,51,0,-51
12613,1,0,87,0,-87
12614,1,1,87,1506,1419
12615,1,1,1130,1252,122
12616,0,0,199,0,-199
12617,0,0,101,0,-101
12618,0,0,91,0,-91
12619,1,1,437,1241,804
12620,0,0,17,0,-17
12621,0,0,27,0,-27
12622,0,0,42,0,-42
12623,1,0,12,0,-12
12624,0,0,112,0,-112
12625,1,0,9,0,-9
12626,1,1,974,1269,295
12627,0,0,4,0,-4
12628,0,0,56,0,-56
12629,0,0,6,0,-6
12630,1,0,42,0,-42
12631,1,0,31,0,-31
12632,1,0,144,0,-144
12633,0,0,20,0,-20
12634,1,0,68,0,-68
12635,1,1,503,1319,816
12636,0,0,41,0,-41
12637,0,0,57,0,-57
12638,1,0,16,0,-16
12639,1,0,3,0,-3
12640,0,0,9,0,-9
12641,1,0,32,0,-32
12642,1,0,115,0,-115
12643,1,1,34,1433,1399
12644,1,0,95,0,-95
12645,1,1,790,1886,1096
12646,1,0,7,0,-7
12647,1,0,46,0,-46
12648,1,1,221,1366,1145
12649,0,0,68,0,-68
12650,1,0,21,0,-21
12651,0,0,25,0,-25
12652,1,0,16,0,-16
12653,0,0,71,0,-71
12654,1,1,1044,1235,191
12655,0,0,52,0,-52
12656,0,0,160,0,-160
12657,1,0,10,0,-10
12658,1,1,912,1216,304
12659,1,0,64,0,-64
12660,0,0,132,0,-132
12661,1,0,73,0,-73
12662,1,1,229,1740,1511
12663,0,0,24,0,-24
12664,1,1,546,1457,911
12665,0,0,62,0,-62
12666,1,1,314,1435,1121
12667,1,1,774,1230,456
12668,1,1,897,1267,370
12669,1,0,6,0,-6
12670,0,0,40,0,-40
12671,0,0,11,0,-11
12672,1,0,2,0,-2
12673,1,1,188,1227,1039
12674,1,1,88,2519,2431
12675,1,0,14,0,-14
12676,0,0,12,0,-12
12677,0,0,40,0,-40
12678,0,0,87,0,-87
12679,1,1,984,1614,630
12680,0,0,75,0,-75
12681,0,0,19,0,-19
12682,1,1,163,1624,1461
12683,0,0,37,0,-37
12684,1,0,22,0,-22
12685,0,0,56,0,-56
12686,0,0,97,0,-97
12687,0,0,49,0,-49
12688,0,0,9,0,-9
12689,1,1,330,3014,2684
12690,1,1,766,1747,981
12691,0,0,67,0,-67
12692,0,0,12,0,-12
12693,0,0,59,0,-59
12694,1,0,44,0,-44
12695,1,1,236,1455,1219
12696,0,0,42,0,-42
12697,0,0,27,0,-27
12698,1,0,126,0,-126
12699,0,0,19,0,-19
12700,1,1,525,1524,999
12701,0,0,22,0,-22
12702,1,1,333,1929,1596
12703,1,1,2213,1480,-733
12704,1,0,6,0,-6
12705,1,1,295,1636,1341
12706,0,0,16,0,-16
12707,1,0,76,0,-76
12708,1,1,1096,2082,986
12709,1,0,14,0,-14
12710,1,1,2144,1410,-734
12711,0,0,4,0,-4
12712,1,1,471,1409,938
12713,1,0,82,0,-82
12714,1,1,193,1202,1009
12715,1,0,12,0,-12
12716,0,0,18,0,-18
12717,1,0,12,0,-12
12718,1,0,57,0,-57
12719,1,1,993,1882,889
12720,0,0,4,0,-4
12721,1,0,50,0,-50
12722,1,1,515,2582,2067
12723,1,1,709,1474,765
12724,1,1,1419,1906,487
12725,0,0,73,0,-73
12726,0,0,24,0,-24
12727,0,0,26,0,-26
12728,1,0,46,0,-46
12729,0,0,56,0,-56
12730,1,0,21,0,-21
12731,1,1,701,1770,1069
12732,1,0,1,0,-1
12733,1,1,175,1656,1481
12734,0,0,51,0,-51
12735,0,0,0,0,0
12736,0,0,75,0,-75
12737,1,0,18,0,-18
12738,0,0,210,0,-210
12739,1,1,329,1307,978
12740,0,0,2,0,-2
12741,1,1,651,1307,656
12742,0,0,3,0,-3
12743,1,1,1481,1694,213
12744,0,0,59,0,-59
12745,1,0,160,0,-160
12746,0,0,79,0,-79
12747,1,0,23,0,-23
12748,1,1,662,1236,574
12749,1,0,74,0,-74
12750,1,0,43,0,-43
12751,1,1,663,1256,593
12752,0,0,71,0,-71
12753,0,0,27,0,-27
12754,1,1,330,1298,968
12755,0,0,88,0,-88
12756,1,0,158,0,-158
12757,0,0,73,0,-73
12758,0,0,25,0,-25
12759,0,0,2,0,-2
12760,1,0,127,0,-127
12761,1,0,5,0,-5
12762,0,0,25,0,-25
12763,1,1,1824,1235,-589
12764,0,0,34,0,-34
12765,1,0,72,0,-72
12766,0,0,2,0,-2
12767,1,0,82,0,-82
12768,1,0,86,0,-86
12769,0,0,6,0,-6
12770,1,1,363,2672,2309
12771,0,0,31,0,-31
12772,1,0,113,0,-113
12773,0,0,11,0,-11
12774,0,0,3,0,-3
12775,1,1,423,1523,1100
12776,0,0,12,0,-12
12777,1,0,1,0,-1
12778,1,1,1632,2126,494
12779,1,1,425,1295,870
12780,0,0,15,0,-15
12781,1,1,175,2303,2128
12782,0,0,55,0,-55
12783,1,1,229,1249,1020
12784,1,1,1417,1253,-164
12785,1,1,798,1397,599
12786,1,0,13,0,-13
12787,1,0,138,0,-138
12788,0,0,85,0,-85
12789,1,0,24,0,-24
12790,1,0,12,0,-12
12791,1,0,42,0,-42
12792,0,0,45,0,-45
12793,0,0,34,0,-34
12794,1,1,228,1338,1110
12795,0,0,19,0,-19
12796,1,1,607,1336,729
12797,1,1,483,1249,766
12798,0,0,110,0,-110
12799,1,1,110,1316,1206
12800,1,1,2216,1220,-996
12801,0,0,92,0,-92
12802,1,1,910,2186,1276
12803,0,0,80,0,-80
12804,1,1,489,1248,759
12805,0,0,64,0,-64
12806,1,0,3,0,-3
12807,0,0,28,0,-28
12808,0,0,16,0,-16
12809,0,0,21,0,-21
12810,0,0,129,0,-129
12811,0,0,36,0,-36
12812,1,1,895,1200,305
12813,0,0,2,0,-2
12814,0,0,8,0,-8
12815,1,0,26,0,-26
12816,1,0,90,0,-90
12817,0,0,57,0,-57
12818,1,0,21,0,-21
12819,0,0,31,0,-31
12820,1,1,39,1350,1311
12821,1,1,317,1578,1261
12822,1,0,7,0,-7
12823,1,0,47,0,-47
12824,1,1,6,1213,1207
12825,1,0,3,0,-3
12826,0,0,3,0,-3
12827,1,1,1019,1221,202
12828,0,0,5,0,-5
12829,1,1,184,1450,1266
12830,1,1,513,1323,810
12831,1,1,136,1233,1097
12832,1,0,124,0,-124
12833,1,1,283,1438,1155
12834,0,0,171,0,-171
12835,0,0,53,0,-53
12836,0,0,33,0,-33
12837,0,0,23,0,-23
12838,1,0,115,0,-115
12839,0,0,23,0,-23
12840,1,1,444,1440,996
12841,1,0,9,0,-9
12842,1,1,214,2970,2756
12843,1,1,418,1761,1343
12844,1,1,1258,1700,442
12845,0,0,52,0,-52
12846,1,1,744,1515,771
12847,1,1,444,1573,1129
12848,1,0,32,0,-32
12849,1,0,36,0,-36
12850,0,0,42,0,-42
12851,1,1,963,1274,311
12852,0,0,56,0,-56
12853,1,0,18,0,-18
12854,1,0,106,0,-106
12855,1,0,10,0,-10
12856,1,0,2,0,-2
12857,1,1,520,1525,1005
12858,0,0,32,0,-32
12859,0,0,44,0,-44
12860,0,0,18,0,-18
12861,1,1,25,1684,1659
12862,0,0,38,0,-38
12863,1,0,40,0,-40
12864,0,0,38,0,-38
12865,1,1,22,1375,1353
12866,1,1,296,1679,1383
12867,0,0,77,0,-77
12868,1,1,162,1985,1823
12869,0,0,50,0,-50
12870,0,0,86,0,-86
12871,1,1,1576,1554,-22
12872,1,0,15,0,-15
12873,1,1,107,1886,1779
12874,1,1,539,2088,1549
12875,0,0,53,0,-53
12876,0,0,50,0,-50
12877,1,1,1503,1406,-97
12878,1,1,832,1716,884
12879,1,0,62,0,-62
12880,0,0,104,0,-104
12881,0,0,4,0,-4
12882,0,0,68,0,-68
12883,0,0,35,0,-35
12884,1,0,94,0,-94
12885,0,0,3,0,-3
12886,1,1,254,1233,979
12887,1,0,157,0,-157
12888,0,0,75,0,-75
12889,1,1,139,1651,1512
12890,1,1,1633,1687,54
12891,1,0,28,0,-28
12892,1,0,140,0,-140
12893,0,0,18,0,-18
12894,0,0,64,0,-64
12895,0,0,6,0,-6
12896,0,0,99,0,-99
12897,0,0,34,0,-34
12898,0,0,35,0,-35
12899,1,1,33,1343,1310
12900,0,0,15,0,-15
12901,1,1,2128,2918,790
12902,0,0,58,0,-58
12903,1,1,545,1497,952
12904,1,1,639,1292,653
12905,1,0,58,0,-58
12906,0,0,73,0,-73
12907,0,0,73,0,-73
12908,0,0,66,0,-66
12909,1,0,1,0,-1
12910,0,0,1,0,-1
12911,0,0,2,0,-2
12912,0,0,216,0,-216
12913,1,1,161,1311,1150
12914,1,1,407,1237,830
12915,0,0,1,0,-1
12916,1,0,51,0,-51
12917,1,1,623,1277,654
12918,0,0,7,0,-7
12919,1,1,234,2509,2275
12920,1,1,674,1529,855
12921,1,1,1536,1214,-322
12922,1,0,53,0,-53
12923,0,0,75,0,-75
12924,1,0,82,0,-82
12925,1,0,11,0,-11
12926,1,1,461,1292,831
12927,0,0,25,0,-25
12928,1,1,130,1384,1254
12929,0,0,28,0,-28
12930,1,0,31,0,-31
12931,1,0,44,0,-44
12932,1,1,1889,1490,-399
12933,1,0,52,0,-52
12934,0,0,12,0,-12
12935,1,1,66,1218,1152
12936,1,0,56,0,-56
12937,1,1,444,1285,841
12938,1,0,7,0,-7
12939,0,0,24,0,-24
12940,1,0,16,0,-16
12941,1,0,164,0,-164
12942,1,0,5,0,-5
12943,0,0,147,0,-147
12944,0,0,69,0,-69
12945,1,0,23,0,-23
12946,0,0,25,0,-25
12947,1,0,1,0,-1
12948,1,0,10,0,-10
12949,1,0,47,0,-47
12950,1,1,659,1277,618
12951,1,0,23,0,-23
12952,1,0,44,0,-44
12953,1,0,148,0,-148
12954,1,0,8,0,-8
12955,0,0,2,0,-2
12956,1,1,381,2035,1654
12957,1,0,37,0,-37
12958,1,0,44,0,-44
12959,0,0,200,0,-200
12960,0,0,92,0,-92
12961,0,0,173,0,-173
12962,0,0,42,0,-42
12963,1,0,12,0,-12
12964,1,0,25,0,-25
12965,1,0,5,0,-5
12966,0,0,15,0,-15
12967,0,0,16,0,-16
12968,1,1,502,1225,723
12969,1,1,861,1235,374
12970,1,1,382,1790,1408
12971,1,1,453,1276,823
12972,1,0,2,0,-2
12973,0,0,93,0,-93
12974,1,0,13,0,-13
12975,0,0,0,0,0
12976,0,0,75,0,-75
12977,0,0,25,0,-25
12978,1,1,447,1230,783
12979,0,0,5,0,-5
12980,1,0,26,0,-26
12981,1,0,56,0,-56
12982,1,1,535,1378,843
12983,1,1,1413,1348,-65
12984,1,1,566,1652,1086
12985,1,1,60,1375,1315
12986,1,1,331,1488,1157
12987,0,0,41,0,-41
12988,1,1,145,1856,1711
12989,1,0,62,0,-62
12990,0,0,48,0,-48
12991,1,0,1,0,-1
12992,0,0,76,0,-76
12993,0,0,296,0,-296
12994,0,0,86,0,-86
12995,0,0,55,0,-55
12996,0,0,41,0,-41
12997,1,1,748,1525,777
12998,1,0,20,0,-20
12999,0,0,180,0,-180
13000,0,0,72,0,-72
13001,1,0,88,0,-88
13002,1,0,37,0,-37
13003,0,0,33,0,-33
13004,1,0,83,0,-83
13005,1,0,67,0,-67
13006,0,0,116,0,-116
13007,1,0,2,0,-2
13008,0,0,49,0,-49
13009,0,0,10,0,-10
13010,1,0,16,0,-16
13011,1,1,1865,1645,-220
13012,1,0,43,0,-43
13013,1,0,92,0,-92
13014,0,0,16,0,-16
13015,0,0,4,0,-4
13016,1,0,15,0,-15
13017,0,0,30,0,-30
13018,1,0,20,0,-20
13019,1,0,85,0,-85
13020,1,0,1,0,-1
13021,1,0,204,0,-204
13022,0,0,57,0,-57
13023,0,0,59,0,-59
13024,0,0,64,0,-64
13025,1,0,18,0,-18
13026,0,0,5,0,-5
13027,1,0,15,0,-15
13028,0,0,0,0,0
13029,0,0,3,0,-3
13030,0,0,24,0,-24
13031,0,0,11,0,-11
13032,1,1,388,1263,875
13033,1,1,683,1273,590
13034,1,0,100,0,-100
13035,1,0,48,0,-48
13036,0,0,20,0,-20
13037,1,0,58,0,-58
13038,1,0,3,0,-3
13039,1,0,315,0,-315
13040,1,0,53,0,-53
13041,1,0,44,0,-44
13042,1,0,40,0,-40
13043,0,0,1,0,-1
13044,0,0,27,0,-27
13045,1,0,13,0,-13
13046,1,1,395,1253,858
13047,1,0,4,0,-4
13048,0,0,4,0,-4
13049,1,0,16,0,-16
13050,0,0,17,0,-17
13051,1,1,178,1226,1048
13052,0,0,29,0,-29
13053,1,0,88,0,-88
13054,0,0,48,0,-48
13055,1,0,144,0,-144
13056,1,1,753,1408,655
13057,0,0,37,0,-37
13058,0,0,47,0,-47
13059,1,1,339,1338,999
13060,1,1,1106,1215,109
13061,1,0,61,0,-61
13062,1,0,71,0,-71
13063,0,0,94,0,-94
13064,1,1,262,1808,1546
13065,1,0,30,0,-30
13066,1,0,45,0,-45
13067,1,0,172,0,-172
13068,1,0,157,0,-157
13069,0,0,27,0,-27
13070,1,1,799,1277,478
13071,1,0,19,0,-19
13072,0,0,4,0,-4
13073,1,1,621,1247,626
13074,0,0,44,0,-44
13075,1,0,83,0,-83
13076,0,0,19,0,-19
13077,1,0,4,0,-4
13078,0,0,11,0,-11
13079,1,1,765,1204,439
13080,1,0,14,0,-14
13081,1,1,175,1202,1027
13082,0,0,34,0,-34
13083,1,1,289,1626,1337
13084,1,1,93,2237,2144
13085,0,0,4,0,-4
13086,1,0,88,0,-88
13087,0,0,64,0,-64
13088,1,0,101,0,-101
13089,1,0,58,0,-58
13090,0,0,124,0,-124
13091,1,0,54,0,-54
13092,0,0,26,0,-26
13093,1,0,23,0,-23
13094,1,0,19,0,-19
13095,0,0,8,0,-8
13096,1,1,1024,1207,183
13097,1,1,494,1311,817
13098,1,0,54,0,-54
13099,1,0,38,0,-38
13100,1,1,435,1290,855
13101,0,0,132,0,-132
13102,0,0,15,0,-15
13103,1,0,35,0,-35
13104,0,0,42,0,-42
13105,1,1,236,1453,1217
13106,1,0,16,0,-16
13107,0,0,15,0,-15
13108,1,1,761,1766,1005
13109,1,1,133,1859,1726
13110,1,1,452,1665,1213
13111,0,0,4,0,-4
13112,1,1,629,1400,771
13113,0,0,29,0,-29
13114,0,0,9,0,-9
13115,1,1,2033,1809,-224
13116,1,0,39,0,-39
13117,1,1,384,1238,854
13118,1,0,43,0,-43
13119,1,1,549,2159,1610
13120,1,1,1082,1295,213
13121,1,1,1848,1231,-617
13122,0,0,14,0,-14
13123,1,1,938,1201,263
13124,1,0,5,0,-5
13125,1,1,617,1366,749
13126,0,0,83,0,-83
13127,1,0,11,0,-11
13128,1,1,166,1297,1131
13129,0,0,17,0,-17
13130,0,0,161,0,-161
13131,1,0,82,0,-82
13132,0,0,38,0,-38
13133,0,0,7,0,-7
13134,1,0,5,0,-5
13135,0,0,2,0,-2
13136,0,0,17,0,-17
13137,1,1,218,1229,1011
13138,0,0,0,0,0
13139,1,0,15,0,-15
13140,0,0,20,0,-20
13141,0,0,0,0,0
13142,1,0,35,0,-35
13143,1,0,183,0,-183
13144,1,1,2035,2690,655
13145,1,1,383,1233,850
13146,1,0,34,0,-34
13147,1,1,313,1601,1288
13148,0,0,17,0,-17
13149,0,0,166,0,-166
13150,1,0,53,0,-53
13151,0,0,4,0,-4
13152,0,0,62,0,-62
13153,1,1,1693,1362,-331
13154,0,0,199,0,-199
13155,0,0,5,0,-5
13156,1,0,74,0,-74
13157,0,0,28,0,-28
13158,0,0,56,0,-56
13159,0,0,4,0,-4
13160,1,1,70,2200,2130
13161,1,0,10,0,-10
13162,1,1,451,1292,841
13163,1,1,1027,1220,193
13164,1,0,21,0,-21
13165,1,1,285,1586,1301
13166,0,0,49,0,-49
13167,0,0,38,0,-38
13168,1,0,8,0,-8
13169,1,1,481,1579,1098
13170,1,0,40,0,-40
13171,0,0,11,0,-11
13172,1,0,80,0,-80
13173,0,0,56,0,-56
13174,0,0,47,0,-47
13175,1,1,678,1467,789
13176,1,0,21,0,-21
13177,1,0,132,0,-132
13178,1,1,861,1375,514
13179,1,1,861,1227,366
13180,1,1,120,1276,1156
13181,1,1,574,1313,739
13182,0,0,54,0,-54
13183,0,0,38,0,-38
13184,1,1,278,1302,1024
13185,1,0,60,0,-60
13186,1,0,6,0,-6
13187,0,0,2,0,-2
13188,1,1,859,1249,390
13189,0,0,21,0,-21
13190,1,0,16,0,-16
13191,1,1,148,2829,2681
13192,1,0,40,0,-40
13193,1,0,73,0,-73
13194,0,0,9,0,-9
13195,1,1,241,1348,1107
13196,0,0,6,0,-6
13197,1,1,1355,2832,1477
13198,0,0,104,0,-104
13199,0,0,82,0,-82
13200,1,1,677,1479,802
13201,1,1,66,2277,2211
13202,1,0,46,0,-46
13203,1,1,369,2659,2290
13204,1,1,1078,1286,208
13205,1,1,634,2326,1692
13206,1,0,71,0,-71
13207,0,0,8,0,-8
13208,0,0,13,0,-13
13209,1,0,75,0,-75
13210,1,0,38,0,-38
13211,1,0,6,0,-6
13212,0,0,224,0,-224
13213,1,0,4,0,-4
13214,0,0,22,0,-22
13215,1,0,37,0,-37
13216,1,1,204,1470,1266
13217,1,0,75,0,-75
13218,1,0,67,0,-67
13219,0,0,105,0,-105
13220,1,0,77,0,-77
13221,1,0,0,0,0
13222,0,0,112,0,-112
13223,1,0,177,0,-177
13224,0,0,40,0,-40
13225,1,0,72,0,-72
13226,1,1,814,1279,465
13227,1,0,17,0,-17
13228,0,0,108,0,-108
13229,1,0,95,0,-95
13230,1,0,49,0,-49
13231,1,1,42,2196,2154
13232,0,0,14,0,-14
13233,1,1,435,1662,1227
13234,0,0,45,0,-45
13235,0,0,26,0,-26
13236,0,0,7,0,-7
13237,1,1,112,1257,1145
13238,0,0,11,0,-11
13239,1,0,13,0,-13
13240,1,0,6,0,-6
13241,1,1,78,1280,1202
13242,0,0,25,0,-25
13243,1,1,1227,1298,71
13244,0,0,51,0,-51
13245,1,1,1914,1519,-395
13246,1,0,9,0,-9
13247,1,0,143,0,-143
13248,0,0,8,0,-8
13249,0,0,106,0,-106
13250,1,1,305,1251,946
13251,1,0,7,0,-7
13252,1,1,1318,1532,214
13253,0,0,11,0,-11
13254,1,1,158,1235,1077
13255,0,0,10,0,-10
13256,1,1,871,1563,692
13257,1,0,7,0,-7
13258,0,0,24,0,-24
13259,1,0,62,0,-62
13260,0,0,22,0,-22
13261,1,0,61,0,-61
13262,1,1,310,1243,933
13263,0,0,19,0,-19
13264,0,0,106,0,-106
13265,0,0,0,0,0
13266,1,1,1922,1222,-700
13267,0,0,113,0,-113
13268,1,1,137,1301,1164
13269,1,1,1228,1317,89
13270,1,1,96,1250,1154
13271,0,0,192,0,-192
13272,1,1,536,1288,752
13273,0,0,154,0,-154
13274,1,1,2359,1678,-681
13275,1,0,72,0,-72
13276,0,0,94,0,-94
13277,0,0,70,0,-70
13278,1,0,174,0,-174
13279,0,0,40,0,-40
13280,1,1,473,1206,733
13281,0,0,97,0,-97
13282,0,0,42,0,-42
13283,1,0,106,0,-106
13284,1,0,47,0,-47
13285,1,1,239,1373,1134
13286,1,0,2,0,-2
13287,1,1,225,2148,1923
13288,1,1,402,1314,912
13289,1,1,329,1251,922
13290,1,0,62,0,-62
13291,1,1,30,1212,1182
13292,0,0,83,0,-83
13293,0,0,68,0,-68
13294,1,1,562,1302,740
13295,1,1,161,1405,1244
13296,1,1,768,1415,647
13297,1,0,240,0,-240
13298,1,0,25,0,-25
13299,1,0,21,0,-21
13300,0,0,7,0,-7
13301,0,0,16,0,-16
13302,1,1,493,1253,760
13303,1,0,1,0,-1
13304,0,0,51,0,-51
13305,1,0,13,0,-13
13306,1,0,8,0,-8
13307,0,0,60,0,-60
13308,1,1,954,2519,1565
13309,1,1,148,1204,1056
13310,0,0,70,0,-70
13311,0,0,74,0,-74
13312,0,0,63,0,-63
13313,0,0,11,0,-11
13314,1,0,9,0,-9
13315,1,0,13,0,-13
13316,1,1,108,1937,1829
13317,1,0,28,0,-28
13318,1,0,129,0,-129
13319,0,0,115,0,-115
13320,1,0,41,0,-41
13321,1,1,23,1540,1517
13322,1,0,89,0,-89
13323,1,0,10,0,-10
13324,0,0,21,0,-21
13325,1,1,244,1758,1514
13326,1,0,43,0,-43
13327,1,0,191,0,-191
13328,0,0,4,0,-4
13329,0,0,7,0,-7
13330,1,0,236,0,-236
13331,1,0,86,0,-86
13332,0,0,22,0,-22
13333,0,0,9,0,-9
13334,0,0,39,0,-39
13335,1,1,163,3024,2861
13336,1,0,47,0,-47
13337,0,0,12,0,-12
13338,0,0,65,0,-65
13339,1,0,34,0,-34
13340,1,1,605,1930,1325
13341,0,0,1,0,-1
13342,1,0,30,0,-30
13343,1,0,5,0,-5
13344,1,0,90,0,-90
13345,1,0,36,0,-36
13346,1,1,793,1339,546
13347,0,0,103,0,-103
13348,0,0,31,0,-31
13349,1,1,239,1201,962
13350,0,0,9,0,-9
13351,1,1,317,1605,1288
13352,1,0,6,0,-6
13353,1,0,26,0,-26
13354,1,0,16,0,-16
13355,0,0,140,0,-140
13356,0,0,14,0,-14
13357,0,0,14,0,-14
13358,0,0,0,0,0
13359,0,0,67,0,-67
13360,1,0,92,0,-92
13361,0,0,3,0,-3
13362,1,1,497,4200,3703
13363,1,0,143,0,-143
13364,1,0,87,0,-87
13365,1,1,31,1275,1244
13366,0,0,23,0,-23
13367,0,0,41,0,-41
13368,1,1,1273,2029,756
13369,0,0,70,0,-70
13370,0,0,43,0,-43
13371,1,1,195,1269,1074
13372,1,0,54,0,-54
13373,1,0,17,0,-17
13374,0,0,30,0,-30
13375,0,0,30,0,-30
13376,0,0,67,0,-67
13377,1,0,21,0,-21
13378,1,1,308,1918,1610
13379,0,0,63,0,-63
13380,0,0,114,0,-114
13381,1,0,5,0,-5
13382,1,1,194,1326,1132
13383,1,1,84,1385,1301
13384,1,1,212,1214,1002
13385,0,0,94,0,-94
13386,1,1,244,1697,1453
13387,1,1,107,1275,1168
13388,1,0,20,0,-20
13389,1,0,29,0,-29
13390,1,1,434,1920,1486
13391,1,1,690,4146,3456
13392,1,1,1311,1250,-61
13393,1,1,210,1332,1122
13394,1,1,126,1427,1301
13395,0,0,116,0,-116
13396,0,0,5,0,-5
13397,1,0,71,0,-71
13398,1,1,452,1366,914
13399,0,0,134,0,-134
13400,1,1,241,1363,1122
13401,0,0,42,0,-42
13402,1,0,84,0,-84
13403,0,0,52,0,-52
13404,1,1,11,1256,1245
13405,0,0,65,0,-65
13406,1,0,36,0,-36
13407,1,1,725,1920,1195
13408,0,0,6,0,-6
13409,1,0,43,0,-43
13410,0,0,6,0,-6
13411,1,1,141,1265,1124
13412,0,0,22,0,-22
13413,0,0,25,0,-25
13414,1,0,150,0,-150
13415,1,0,191,0,-191
13416,0,0,57,0,-57
13417,0,0,45,0,-45
13418,1,1,1038,1293,255
13419,1,1,169,1212,1043
13420,0,0,27,0,-27
13421,1,0,42,0,-42
13422,1,0,46,0,-46
13423,1,1,1200,1715,515
13424,0,0,82,0,-82
13425,0,0,175,0,-175
13426,0,0,15,0,-15
13427,1,0,1,0,-1
13428,0,0,82,0,-82
13429,1,1,377,1771,1394
13430,1,0,16,0,-16
13431,0,0,79,0,-79
13432,1,0,39,0,-39
13433,1,1,458,3199,2741
13434,0,0,12,0,-12
13435,0,0,36,0,-36
13436,0,0,9,0,-9
13437,0,0,12,0,-12
13438,1,0,12,0,-12
13439,0,0,1,0,-1
13440,1,0,125,0,-125
13441,0,0,4,0,-4
13442,0,0,6,0,-6
13443,0,0,29,0,-29
13444,0,0,59,0,-59
13445,1,0,72,0,-72
13446,1,1,349,1304,955
13447,1,0,4,0,-4
13448,1,1,225,1673,1448
13449,1,1,432,1905,1473
13450,1,0,105,0,-105
13451,0,0,41,0,-41
13452,1,0,12,0,-12
13453,0,0,24,0,-24
13454,1,1,739,1560,821
13455,0,0,67,0,-67
13456,1,0,7,0,-7
13457,0,0,16,0,-16
13458,1,1,232,2096,1864
13459,0,0,54,0,-54
13460,0,0,27,0,-27
13461,1,0,62,0,-62
13462,1,1,302,1725,1423
13463,0,0,2,0,-2
13464,1,1,280,1449,1169
13465,1,1,493,2479,1986
13466,1,1,166,1223,1057
13467,1,1,56,1787,1731
13468,1,0,51,0,-51
13469,1,0,139,0,-139
13470,1,0,67,0,-67
13471,1,0,81,0,-81
13472,0,0,13,0,-13
13473,1,0,65,0,-65
13474,1,0,55,0,-55
13475,1,0,70,0,-70
13476,1,0,4,0,-4
13477,1,0,167,0,-167
13478,1,1,90,1938,1848
13479,1,1,551,1211,660
13480,0,0,5,0,-5
13481,0,0,44,0,-44
13482,0,0,16,0,-16
13483,1,1,883,1469,586
13484,1,0,27,0,-27
13485,0,0,132,0,-132
13486,1,0,14,0,-14
13487,1,0,15,0,-15
13488,1,0,17,0,-17
13489,1,1,419,1479,1060
13490,1,1,322,1235,913
13491,0,0,38,0,-38
13492,0,0,45,0,-45
13493,1,0,48,0,-48
13494,1,1,253,1382,1129
13495,1,0,147,0,-147
13496,1,0,168,0,-168
13497,0,0,32,0,-32
13498,1,1,792,1607,815
13499,1,0,28,0,-28
13500,1,0,2,0,-2
13501,0,0,123,0,-123
13502,0,0,0,0,0
13503,0,0,35,0,-35
13504,0,0,18,0,-18
13505,1,0,12,0,-12
13506,1,0,18,0,-18
13507,1,1,999,1223,224
13508,0,0,62,0,-62
13509,0,0,99,0,-99
13510,1,1,188,1827,1639
13511,0,0,17,0,-17
13512,1,0,1,0,-1
13513,0,0,0,0,0
13514,1,1,884,1205,321
13515,1,0,23,0,-23
13516,0,0,9,0,-9
13517,0,0,17,0,-17
13518,0,0,64,0,-64
13519,1,0,30,0,-30
13520,0,0,16,0,-16
13521,1,0,1,0,-1
13522,0,0,28,0,-28
13523,0,0,11,0,-11
13524,1,0,52,0,-52
13525,0,0,124,0,-124
13526,1,0,53,0,-53
13527,0,0,34,0,-34
13528,1,0,25,0,-25
13529,0,0,12,0,-12
13530,0,0,13,0,-13
13531,1,1,326,1762,1436
13532,1,0,33,0,-33
13533,0,0,32,0,-32
13534,1,1,700,2081,1381
13535,0,0,85,0,-85
13536,0,0,9,0,-9
13537,0,0,19,0,-19
13538,0,0,0,0,0
13539,1,1,103,1693,1590
13540,1,0,68,0,-68
13541,1,1,408,1392,984
13542,0,0,24,0,-24
13543,0,0,61,0,-61
13544,0,0,192,0,-192
13545,1,1,689,1667,978
13546,0,0,45,0,-45
13547,1,1,733,1627,894
13548,0,0,99,0,-99
13549,0,0,58,0,-58
13550,1,1,1345,2475,1130
13551,0,0,5,0,-5
13552,0,0,12,0,-12
13553,1,0,16,0,-16
13554,0,0,8,0,-8
13555,0,0,153,0,-153
13556,1,1,346,1467,1121
13557,1,1,73,1254,1181
13558,1,0,14,0,-14
13559,1,1,456,1710,1254
13560,1,1,72,1381,1309
13561,1,1,237,1594,1357
13562,1,0,30,0,-30
13563,1,1,461,2437,1976
13564,0,0,33,0,-33
13565,1,1,852,1364,512
13566,0,0,4,0,-4
13567,0,0,32,0,-32
13568,1,0,115,0,-115
13569,1,1,184,2465,2281
13570,0,0,12,0,-12
13571,1,1,336,1323,987
13572,0,0,37,0,-37
13573,1,0,22,0,-22
13574,1,0,114,0,-114
13575,0,0,85,0,-85
13576,1,1,267,1274,1007
13577,1,1,366,1725,1359
13578,0,0,122,0,-122
13579,0,0,17,0,-17
13580,1,0,66,0,-66
13581,1,0,44,0,-44
13582,1,0,20,0,-20
13583,1,0,125,0,-125
13584,0,0,87,0,-87
13585,0,0,4,0,-4
13586,1,0,27,0,-27
13587,1,0,10,0,-10
13588,0,0,8,0,-8
13589,1,0,10,0,-10
13590,0,0,11,0,-11
13591,1,0,3,0,-3
13592,0,0,138,0,-138
13593,0,0,56,0,-56
13594,0,0,3,0,-3
13595,1,1,132,1296,1164
13596,0,0,33,0,-33
13597,0,0,11,0,-11
13598,0,0,30,0,-30
13599,1,1,475,1577,1102
13600,0,0,21,0,-21
13601,1,1,493,1359,866
13602,1,1,392,1233,841
13603,0,0,50,0,-50
13604,0,0,79,0,-79
13605,1,0,58,0,-58
13606,0,0,117,0,-117
13607,1,0,48,0,-48
13608,1,0,28,0,-28
13609,0,0,13,0,-13
13610,0,0,81,0,-81
13611,1,1,218,1215,997
13612,0,0,50,0,-50
13613,0,0,53,0,-53
13614,1,1,1106,1381,275
13615,0,0,95,0,-95
13616,1,1,419,1278,859
13617,1,0,31,0,-31
13618,1,1,513,1672,1159
13619,1,0,34,0,-34
13620,0,0,115,0,-115
13621,0,0,81,0,-81
13622,1,0,73,0,-73
13623,0,0,6,0,-6
13624,1,0,0,0,0
13625,1,1,164,1513,1349
13626,0,0,123,0,-123
13627,0,0,73,0,-73
13628,0,0,106,0,-106
13629,1,0,87,0,-87
13630,1,0,81,0,-81
13631,1,1,842,1927,1085
13632,1,1,37,1566,1529
13633,0,0,6,0,-6
13634,1,0,34,0,-34
13635,0,0,5,0,-5
13636,0,0,42,0,-42
13637,1,0,20,0,-20
13638,1,1,1223,1344,121
13639,1,0,57,0,-57
13640,1,0,4,0,-4
13641,0,0,151,0,-151
13642,1,0,12,0,-12
13643,0,0,38,0,-38
13644,0,0,52,0,-52
13645,1,0,94,0,-94
13646,1,1,615,1230,615
13647,0,0,44,0,-44
13648,1,0,6,0,-6
13649,1,0,19,0,-19
13650,1,1,473,4065,3592
13651,1,1,51,1245,1194
13652,0,0,49,0,-49
13653,1,1,626,1758,1132
13654,0,0,21,0,-21
13655,1,1,370,1225,855
13656,1,0,92,0,-92
13657,1,0,125,0,-125
13658,0,0,87,0,-87
13659,1,1,110,2342,2232
13660,1,0,10,0,-10
13661,0,0,7,0,-7
13662,1,0,13,0,-13
13663,1,1,3134,1430,-1704
13664,1,0,54,0,-54
13665,1,0,13,0,-13
13666,1,1,2241,1616,-625
13667,0,0,45,0,-45
13668,1,1,132,1812,1680
13669,0,0,28,0,-28
13670,1,1,603,1456,853
13671,1,1,280,1329,1049
13672,0,0,14,0,-14
13673,1,0,9,0,-9
13674,0,0,30,0,-30
13675,0,0,10,0,-10
13676,0,0,112,0,-112
13677,1,1,1084,1277,193
13678,0,0,28,0,-28
13679,1,0,136,0,-136
13680,0,0,0,0,0
13681,1,0,27,0,-27
13682,1,0,31,0,-31
13683,0,0,88,0,-88
13684,1,0,123,0,-123
13685,1,0,6,0,-6
13686,1,1,406,1697,1291
13687,1,1,107,1256,1149
13688,0,0,7,0,-7
13689,1,0,45,0,-45
13690,1,0,14,0,-14
13691,1,1,86,1755,1669
13692,0,0,22,0,-22
13693,0,0,31,0,-31
13694,1,1,182,1508,1326
13695,0,0,56,0,-56
13696,0,0,4,0,-4
13697,0,0,12,0,-12
13698,1,0,32,0,-32
13699,1,0,148,0,-148
13700,1,1,154,1415,1261
13701,1,1,682,1251,569
13702,0,0,14,0,-14
13703,1,1,272,1657,1385
13704,0,0,69,0,-69
13705,0,0,43,0,-43
13706,0,0,263,0,-263
13707,0,0,6,0,-6
13708,1,1,211,1631,1420
13709,1,1,6,1648,1642
13710,1,0,27,0,-27
13711,0,0,33,0,-33
13712,0,0,274,0,-274
13713,0,0,35,0,-35
13714,1,1,2568,1201,-1367
13715,0,0,64,0,-64
13716,0,0,42,0,-42
13717,0,0,19,0,-19
13718,0,0,15,0,-15
13719,1,0,45,0,-45
13720,0,0,15,0,-15
13721,1,1,128,1652,1524
13722,1,0,62,0,-62
13723,1,1,1340,2127,787
13724,0,0,18,0,-18
13725,1,0,50,0,-50
13726,1,0,22,0,-22
13727,0,0,37,0,-37
13728,1,1,1378,1219,-159
13729,0,0,62,0,-62
13730,1,0,4,0,-4
13731,0,0,35,0,-35
13732,1,1,231,1645,1414
13733,1,1,774,2383,1609
13734,1,0,94,0,-94
13735,1,1,156,1617,1461
13736,1,1,643,1789,1146
13737,1,0,111,0,-111
13738,1,1,361,1424,1063
13739,1,1,453,1586,1133
13740,0,0,49,0,-49
13741,0,0,25,0,-25
13742,1,1,69,1235,1166
13743,1,1,41,1298,1257
13744,0,0,9,0,-9
13745,0,0,7,0,-7
13746,1,0,139,0,-139
13747,1,1,514,1303,789
13748,1,1,345,1284,939
13749,0,0,9,0,-9
13750,1,0,36,0,-36
13751,0,0,24,0,-24
13752,1,0,52,0,-52
13753,1,1,10,1644,1634
13754,1,0,15,0,-15
13755,0,0,25,0,-25
13756,1,1,630,1642,1012
13757,0,0,284,0,-284
13758,1,0,30,0,-30
13759,0,0,81,0,-81
13760,1,1,2841,1409,-1432
13761,0,0,87,0,-87
13762,1,1,984,1400,416
13763,1,1,120,1294,1174
13764,0,0,92,0,-92
13765,0,0,80,0,-80
13766,0,0,121,0,-121
13767,1,0,108,0,-108
13768,1,0,34,0,-34
13769,0,0,42,0,-42
13770,1,0,38,0,-38
13771,0,0,1,0,-1
13772,0,0,14,0,-14
13773,0,0,21,0,-21
13774,1,1,1042,1399,357
13775,0,0,5,0,-5
13776,0,0,65,0,-65
13777,0,0,115,0,-115
13778,1,1,169,1315,1146
13779,1,0,103,0,-103
13780,1,1,575,1933,1358
13781,1,1,3431,1571,-1860
13782,1,0,248,0,-248
13783,0,0,15,0,-15
13784,1,0,16,0,-16
13785,0,0,15,0,-15
13786,0,0,135,0,-135
13787,1,0,121,0,-121
13788,1,0,3,0,-3
13789,1,0,292,0,-292
13790,1,0,61,0,-61
13791,1,1,527,1260,733
13792,0,0,1,0,-1
13793,1,1,439,1387,948
13794,1,0,141,0,-141
13795,0,0,306,0,-306
13796,1,0,5,0,-5
13797,1,0,31,0,-31
13798,0,0,19,0,-19
13799,1,0,0,0,0
13800,0,0,51,0,-51
13801,0,0,18,0,-18
13802,0,0,21,0,-21
13803,1,0,20,0,-20
13804,1,0,67,0,-67
13805,0,0,10,0,-10
13806,0,0,11,0,-11
13807,1,0,194,0,-194
13808,0,0,50,0,-50
13809,0,0,6,0,-6
13810,0,0,26,0,-26
13811,1,1,594,1213,619
13812,0,0,42,0,-42
13813,1,1,796,1210,414
13814,1,0,27,0,-27
13815,1,1,642,1278,636
13816,0,0,54,0,-54
13817,1,1,153,1225,1072
13818,0,0,78,0,-78
13819,1,0,30,0,-30
13820,0,0,12,0,-12
13821,1,0,85,0,-85
13822,1,0,152,0,-152
13823,1,0,78,0,-78
13824,0,0,96,0,-96
13825,1,1,96,1453,1357
13826,1,0,5,0,-5
13827,0,0,14,0,-14
13828,0,0,8,0,-8
13829,0,0,25,0,-25
13830,1,1,149,1208,1059
13831,0,0,24,0,-24
13832,0,0,105,0,-105
13833,1,0,25,0,-25
13834,1,0,14,0,-14
13835,1,0,17,0,-17
13836,0,0,21,0,-21
13837,1,0,10,0,-10
13838,1,1,129,1504,1375
13839,0,0,40,0,-40
13840,1,1,43,1300,1257
13841,0,0,184,0,-184
13842,0,0,27,0,-27
13843,1,1,684,2646,1962
13844,1,1,103,1252,1149
13845,1,1,305,1253,948
13846,1,0,54,0,-54
13847,0,0,49,0,-49
13848,1,0,57,0,-57
13849,1,0,6,0,-6
13850,0,0,12,0,-12
13851,1,0,118,0,-118
13852,1,1,195,1254,1059
13853,1,0,6,0,-6
13854,0,0,72,0,-72
13855,1,1,642,1432,790
13856,1,0,3,0,-3
13857,1,0,8,0,-8
13858,1,0,34,0,-34
13859,1,1,1296,1604,308
13860,0,0,7,0,-7
13861,1,1,107,1237,1130
13862,0,0,25,0,-25
13863,1,0,14,0,-14
13864,0,0,90,0,-90
13865,1,0,39,0,-39
13866,1,1,590,1234,644
13867,1,0,45,0,-45
13868,1,1,136,1244,1108
13869,0,0,1,0,-1
13870,0,0,3,0,-3
13871,0,0,142,0,-142
13872,0,0,3,0,-3
13873,0,0,4,0,-4
13874,1,0,216,0,-216
13875,1,0,15,0,-15
13876,0,0,69,0,-69
13877,0,0,20,0,-20
13878,0,0,15,0,-15
13879,1,1,764,1547,783
13880,1,1,185,1219,1034
13881,1,0,31,0,-31
13882,1,1,601,1292,691
13883,1,0,43,0,-43
13884,1,1,274,1281,1007
13885,1,1,59,1332,1273
13886,0,0,25,0,-25
13887,1,1,648,1669,1021
13888,0,0,53,0,-53
13889,0,0,118,0,-118
13890,1,0,80,0,-80
13891,1,0,122,0,-122
13892,0,0,6,0,-6
13893,1,1,1350,1695,345
13894,1,0,107,0,-107
13895,0,0,39,0,-39
13896,1,0,29,0,-29
13897,1,1,611,2071,1460
13898,0,0,31,0,-31
13899,1,1,416,1236,820
13900,0,0,76,0,-76
13901,0,0,18,0,-18
13902,0,0,21,0,-21
13903,0,0,141,0,-141
13904,1,1,62,2177,2115
13905,0,0,14,0,-14
13906,1,0,1,0,-1
13907,0,0,6,0,-6
13908,0,0,23,0,-23
13909,1,1,730,1780,1050
13910,0,0,81,0,-81
13911,1,0,126,0,-126
13912,0,0,30,0,-30
13913,1,1,290,1556,1266
13914,1,0,82,0,-82
13915,0,0,16,0,-16
13916,1,0,99,0,-99
13917,1,1,106,2012,1906
13918,0,0,8,0,-8
13919,1,0,44,0,-44
13920,1,0,15,0,-15
13921,1,1,358,1234,876
13922,1,0,16,0,-16
13923,1,0,93,0,-93
13924,1,1,430,1419,989
13925,1,1,236,1358,1122
13926,0,0,66,0,-66
13927,0,0,120,0,-120
13928,0,0,147,0,-147
13929,0,0,86,0,-86
13930,0,0,116,0,-116
13931,0,0,46,0,-46
13932,1,0,0,0,0
13933,1,1,245,1413,1168
13934,1,1,875,1429,554
13935,1,0,199,0,-199
13936,1,0,20,0,-20
13937,0,0,74,0,-74
13938,1,1,208,1488,1280
13939,1,0,40,0,-40
13940,1,0,13,0,-13
13941,1,1,1215,1472,257
13942,1,0,50,0,-50
13943,0,0,30,0,-30
13944,1,0,13,0,-13
13945,1,1,436,1456,1020
13946,1,0,9,0,-9
13947,1,1,276,1445,1169
13948,1,0,28,0,-28
13949,1,0,30,0,-30
13950,1,1,958,1259,301
13951,1,0,130,0,-130
13952,1,1,156,1503,1347
13953,0,0,75,0,-75
13954,0,0,9,0,-9
13955,0,0,28,0,-28
13956,0,0,39,0,-39
13957,0,0,84,0,-84
13958,0,0,69,0,-69
13959,1,0,26,0,-26
13960,0,0,0,0,0
13961,1,1,417,1408,991
13962,1,1,1203,1588,385
13963,1,1,1314,1724,410
13964,0,0,48,0,-48
13965,0,0,54,0,-54
13966,1,1,17,1706,1689
13967,1,1,506,1519,1013
13968,1,1,121,1397,1276
13969,0,0,121,0,-121
13970,1,1,590,1300,710
13971,1,1,496,1414,918
13972,1,0,47,0,-47
13973,0,0,52,0,-52
13974,1,0,17,0,-17
13975,0,0,50,0,-50
13976,1,1,210,2000,1790
13977,0,0,72,0,-72
13978,1,1,660,1206,546
13979,1,0,99,0,-99
13980,0,0,12,0,-12
13981,0,0,1,0,-1
13982,1,0,1,0,-1
13983,1,0,15,0,-15
13984,1,1,1249,1428,179
13985,0,0,148,0,-148
13986,1,0,94,0,-94
13987,1,0,69,0,-69
13988,1,1,620,3704,3084
13989,1,1,299,1271,972
13990,1,1,387,1727,1340
13991,1,0,40,0,-40
13992,1,0,69,0,-69
13993,1,1,144,3074,2930
13994,1,1,232,1281,1049
13995,1,1,629,2616,1987
13996,0,0,120,0,-120
13997,1,0,42,0,-42
13998,1,0,25,0,-25
13999,0,0,21,0,-21
14000,1,1,511,4156,3645
14001,1,1,1393,1284,-109
14002,0,0,71,0,-71
14003,1,0,8,0,-8
14004,1,0,24,0,-24
14005,0,0,104,0,-104
14006,1,1,579,1220,641
14007,0,0,20,0,-20
14008,1,1,650,1397,747
14009,1,1,316,1249,933
14010,1,0,47,0,-47
14011,1,0,109,0,-109
14012,0,0,9,0,-9
14013,0,0,12,0,-12
14014,0,0,3,0,-3
14015,0,0,48,0,-48
14016,1,1,645,1345,700
14017,0,0,26,0,-26
14018,0,0,95,0,-95
14019,0,0,56,0,-56
14020,0,0,10,0,-10
14021,0,0,16,0,-16
14022,0,0,17,0,-17
14023,1,0,4,0,-4
14024,1,0,20,0,-20
14025,1,0,3,0,-3
14026,1,1,1149,1574,425
14027,0,0,37,0,-37
14028,1,1,1077,2211,1134
14029,1,1,482,1584,1102
14030,0,0,13,0,-13
14031,1,0,23,0,-23
14032,0,0,93,0,-93
14033,0,0,2,0,-2
14034,0,0,89,0,-89
14035,1,1,123,1237,1114
14036,1,0,100,0,-100
14037,0,0,18,0,-18
14038,0,0,0,0,0
14039,1,0,18,0,-18
14040,1,0,92,0,-92
14041,0,0,13,0,-13
14042,1,1,431,1240,809
14043,0,0,41,0,-41
14044,1,1,343,1561,1218
14045,0,0,29,0,-29
14046,0,0,2,0,-2
14047,0,0,2,0,-2
14048,0,0,8,0,-8
14049,0,0,290,0,-290
14050,1,1,158,1520,1362
14051,0,0,2,0,-2
14052,1,0,8,0,-8
14053,1,1,396,1722,1326
14054,0,0,39,0,-39
14055,0,0,91,0,-91
14056,0,0,25,0,-25
14057,0,0,43,0,-43
14058,0,0,24,0,-24
14059,0,0,28,0,-28
14060,1,0,122,0,-122
14061,1,1,817,1366,549
14062,1,0,103,0,-103
14063,0,0,51,0,-51
14064,1,1,169,1650,1481
14065,1,0,10,0,-10
14066,1,0,51,0,-51
14067,1,0,90,0,-90
14068,0,0,24,0,-24
14069,1,0,24,0,-24
14070,1,0,172,0,-172
14071,1,0,13,0,-13
14072,1,1,417,1331,914
14073,1,0,28,0,-28
14074,0,0,59,0,-59
14075,0,0,45,0,-45
14076,0,0,242,0,-242
14077,1,0,212,0,-212
14078,0,0,11,0,-11
14079,0,0,7,0,-7
14080,1,0,65,0,-65
14081,1,0,21,0,-21
14082,1,0,9,0,-9
14083,1,1,776,1559,783
14084,0,0,26,0,-26
14085,0,0,31,0,-31
14086,1,1,394,2954,2560
14087,1,0,54,0,-54
14088,0,0,28,0,-28
14089,0,0,62,0,-62
14090,0,0,49,0,-49
14091,0,0,27,0,-27
14092,1,0,7,0,-7
14093,1,0,141,0,-141
14094,0,0,10,0,-10
14095,0,0,79,0,-79
14096,0,0,6,0,-6
14097,1,1,537,1556,1019
14098,1,1,859,2227,1368
14099,1,1,144,1422,1278
14100,1,1,230,3241,3011
14101,1,1,173,1252,1079
14102,0,0,28,0,-28
14103,0,0,20,0,-20
14104,1,0,313,0,-313
14105,0,0,40,0,-40
14106,0,0,46,0,-46
14107,1,0,25,0,-25
14108,1,0,40,0,-40
14109,1,0,106,0,-106
14110,1,1,125,1728,1603
14111,0,0,11,0,-11
14112,0,0,20,0,-20
14113,1,1,167,1208,1041
14114,0,0,242,0,-242
14115,1,0,8,0,-8
14116,0,0,22,0,-22
14117,1,0,33,0,-33
14118,0,0,11,0,-11
14119,0,0,68,0,-68
14120,1,0,24,0,-24
14121,1,0,2,0,-2
14122,1,0,219,0,-219
14123,1,0,84,0,-84
14124,1,0,9,0,-9
14125,0,0,81,0,-81
14126,0,0,12,0,-12
14127,0,0,20,0,-20
14128,0,0,1,0,-1
14129,0,0,2,0,-2
14130,1,1,446,1939,1493
14131,0,0,8,0,-8
14132,0,0,121,0,-121
14133,0,0,59,0,-59
14134,0,0,33,0,-33
14135,0,0,147,0,-147
14136,0,0,18,0,-18
14137,1,0,16,0,-16
14138,1,1,395,2310,1915
14139,0,0,6,0,-6
14140,0,0,78,0,-78
14141,1,0,150,0,-150
14142,0,0,123,0,-123
14143,1,1,278,1289,1011
14144,0,0,92,0,-92
14145,1,1,256,1348,1092
14146,1,1,86,1514,1428
14147,0,0,38,0,-38
14148,0,0,6,0,-6
14149,0,0,72,0,-72
14150,1,1,1762,1271,-491
14151,1,1,694,1290,596
14152,0,0,73,0,-73
14153,1,0,134,0,-134
14154,1,0,59,0,-59
14155,0,0,12,0,-12
14156,0,0,23,0,-23
14157,1,1,336,1222,886
14158,1,1,190,2740,2550
14159,0,0,81,0,-81
14160,1,0,134,0,-134
14161,1,0,55,0,-55
14162,1,1,275,1387,1112
14163,0,0,27,0,-27
14164,1,1,790,2577,1787
14165,1,1,1327,1234,-93
14166,1,1,392,1379,987
14167,0,0,1,0,-1
14168,1,1,213,1214,1001
14169,1,0,10,0,-10
14170,1,1,192,1853,1661
14171,1,1,43,1604,1561
14172,0,0,26,0,-26
14173,1,0,12,0,-12
14174,0,0,53,0,-53
14175,0,0,2,0,-2
14176,0,0,20,0,-20
14177,0,0,29,0,-29
14178,1,0,46,0,-46
14179,0,0,22,0,-22
14180,1,1,92,1755,1663
14181,1,0,12,0,-12
14182,0,0,101,0,-101
14183,0,0,67,0,-67
14184,1,0,49,0,-49
14185,1,1,194,1209,1015
14186,0,0,24,0,-24
14187,0,0,25,0,-25
14188,1,0,38,0,-38
14189,0,0,4,0,-4
14190,1,1,295,1595,1300
14191,1,1,620,1548,928
14192,0,0,49,0,-49
14193,1,1,1162,1351,189
14194,1,0,38,0,-38
14195,0,0,97,0,-97
14196,1,0,41,0,-41
14197,1,1,432,1479,1047
14198,0,0,49,0,-49
14199,0,0,2,0,-2
14200,1,0,17,0,-17
14201,1,1,376,1511,1135
14202,0,0,42,0,-42
14203,1,0,41,0,-41
14204,1,0,22,0,-22
14205,1,0,58,0,-58
14206,0,0,47,0,-47
14207,1,0,3,0,-3
14208,0,0,12,0,-12
14209,1,0,16,0,-16
14210,1,1,158,2113,1955
14211,1,1,283,1205,922
14212,1,0,3,0,-3
14213,0,0,1,0,-1
14214,0,0,29,0,-29
14215,1,1,960,1250,290
14216,0,0,36,0,-36
14217,1,0,50,0,-50
14218,1,1,16,1420,1404
14219,0,0,42,0,-42
14220,1,1,1104,1776,672
14221,0,0,2,0,-2
14222,1,0,9,0,-9
14223,1,1,479,1340,861
14224,0,0,54,0,-54
14225,1,1,513,1478,965
14226,1,1,284,1922,1638
14227,1,0,114,0,-114
14228,1,0,53,0,-53
14229,1,0,75,0,-75
14230,0,0,68,0,-68
14231,0,0,4,0,-4
14232,1,1,1391,2162,771
14233,0,0,25,0,-25
14234,1,0,58,0,-58
14235,0,0,20,0,-20
14236,1,0,19,0,-19
14237,0,0,13,0,-13
14238,1,1,132,1246,1114
14239,1,0,5,0,-5
14240,0,0,90,0,-90
14241,1,0,3,0,-3
14242,1,0,39,0,-39
14243,0,0,74,0,-74
14244,1,1,243,1242,999
14245,1,0,83,0,-83
14246,0,0,14,0,-14
14247,1,0,61,0,-61
14248,0,0,52,0,-52
14249,1,0,40,0,-40
14250,1,0,8,0,-8
14251,1,0,2,0,-2
14252,1,1,881,1274,393
14253,1,0,41,0,-41
14254,1,0,3,0,-3
14255,0,0,73,0,-73
14256,1,1,222,1423,1201
14257,0,0,26,0,-26
14258,1,1,134,2075,1941
14259,0,0,3,0,-3
14260,0,0,22,0,-22
14261,0,0,31,0,-31
14262,1,0,13,0,-13
14263,0,0,50,0,-50
14264,0,0,53,0,-53
14265,1,0,25,0,-25
14266,0,0,71,0,-71
14267,1,0,20,0,-20
14268,0,0,73,0,-73
14269,1,0,45,0,-45
14270,1,0,46,0,-46
14271,1,1,1072,1494,422
14272,1,0,256,0,-256
14273,0,0,18,0,-18
14274,1,1,263,1359,1096
14275,1,0,0,0,0
14276,0,0,59,0,-59
14277,0,0,69,0,-69
14278,1,0,46,0,-46
14279,1,0,160,0,-160
14280,0,0,21,0,-21
14281,1,1,163,1637,1474
14282,1,1,1115,1233,118
14283,1,1,160,1486,1326
14284,1,1,436,1202,766
14285,1,1,1263,1247,-16
14286,1,0,72,0,-72
14287,0,0,27,0,-27
14288,1,0,115,0,-115
14289,1,0,34,0,-34
14290,0,0,7,0,-7
14291,0,0,109,0,-109
14292,0,0,66,0,-66
14293,1,0,11,0,-11
14294,0,0,0,0,0
14295,1,0,31,0,-31
14296,1,0,129,0,-129
14297,1,1,253,1385,1132
14298,1,0,77,0,-77
14299,1,0,79,0,-79
14300,1,1,418,1419,1001
14301,0,0,50,0,-50
14302,0,0,21,0,-21
14303,1,1,1446,1703,257
14304,1,0,47,0,-47
14305,0,0,25,0,-25
14306,1,0,75,0,-75
14307,0,0,20,0,-20
14308,1,1,642,1361,719
14309,1,0,194,0,-194
14310,0,0,15,0,-15
14311,1,1,258,2031,1773
14312,1,1,210,1520,1310
14313,0,0,134,0,-134
14314,1,1,839,1380,541
14315,1,1,351,1915,1564
14316,0,0,12,0,-12
14317,0,0,20,0,-20
14318,1,1,656,1649,993
14319,0,0,50,0,-50
14320,1,1,628,1437,809
14321,1,0,97,0,-97
14322,1,1,567,1354,787
14323,1,1,564,1263,699
14324,1,1,508,1968,1460
14325,1,0,181,0,-181
14326,1,1,67,1711,1644
14327,1,1,2255,1775,-480
14328,1,0,38,0,-38
14329,1,1,577,1212,635
14330,0,0,78,0,-78
14331,1,1,152,1335,1183
14332,0,0,74,0,-74
14333,1,1,263,1397,1134
14334,1,0,186,0,-186
14335,0,0,27,0,-27
14336,1,1,218,1342,1124
14337,1,1,338,1422,1084
14338,1,0,0,0,0
14339,0,0,25,0,-25
14340,1,1,164,1399,1235
14341,1,1,162,1950,1788
14342,0,0,98,0,-98
14343,0,0,3,0,-3
14344,0,0,60,0,-60
14345,1,1,744,1240,496
14346,1,0,57,0,-57
14347,0,0,4,0,-4
14348,0,0,11,0,-11
14349,1,1,81,1219,1138
14350,0,0,22,0,-22
14351,1,0,9,0,-9
14352,1,1,787,1702,915
14353,1,1,96,1418,1322
14354,0,0,16,0,-16
14355,1,1,1961,1800,-161
14356,0,0,24,0,-24
14357,0,0,26,0,-26
14358,1,0,64,0,-64
14359,0,0,17,0,-17
14360,1,0,103,0,-103
14361,0,0,117,0,-117
14362,1,0,4,0,-4
14363,0,0,28,0,-28
14364,1,1,12,1486,1474
14365,0,0,23,0,-23
14366,1,0,26,0,-26
14367,1,1,398,1331,933
14368,0,0,13,0,-13
14369,1,0,42,0,-42
14370,1,1,116,1842,1726
14371,1,1,87,3610,3523
14372,1,0,11,0,-11
14373,0,0,23,0,-23
14374,1,0,40,0,-40
14375,1,0,117,0,-117
14376,1,1,29,1358,1329
14377,1,1,404,1462,1058
14378,1,0,90,0,-90
14379,1,0,73,0,-73
14380,0,0,93,0,-93
14381,1,1,1070,1296,226
14382,1,1,413,1278,865
14383,0,0,22,0,-22
14384,1,1,515,1546,1031
14385,0,0,69,0,-69
14386,1,0,115,0,-115
14387,0,0,3,0,-3
14388,0,0,0,0,0
14389,0,0,0,0,0
14390,1,1,50,1322,1272
14391,1,0,67,0,-67
14392,1,1,1482,1452,-30
14393,0,0,44,0,-44
14394,1,1,1997,1306,-691
14395,0,0,52,0,-52
14396,0,0,12,0,-12
14397,1,0,24,0,-24
14398,1,1,792,1449,657
14399,1,1,13,1447,1434
14400,1,0,145,0,-145
14401,1,1,1396,1200,-196
14402,0,0,100,0,-100
14403,0,0,145,0,-145
14404,0,0,171,0,-171
14405,1,0,125,0,-125
14406,0,0,78,0,-78
14407,1,1,106,1226,1120
14408,0,0,7,0,-7
14409,0,0,36,0,-36
14410,1,1,783,1435,652
14411,0,0,124,0,-124
14412,0,0,1,0,-1
14413,0,0,81,0,-81
14414,1,0,18,0,-18
14415,0,0,6,0,-6
14416,1,0,16,0,-16
14417,1,1,1084,1275,191
14418,0,0,119,0,-119
14419,1,1,1098,1343,245
14420,1,0,62,0,-62
14421,1,0,63,0,-63
14422,1,0,59,0,-59
14423,1,0,102,0,-102
14424,1,0,38,0,-38
14425,0,0,1,0,-1
14426,0,0,70,0,-70
14427,0,0,18,0,-18
14428,1,0,14,0,-14
14429,0,0,41,0,-41
14430,1,1,976,1763,787
14431,1,0,192,0,-192
14432,0,0,41,0,-41
14433,0,0,24,0,-24
14434,1,1,1088,1253,165
14435,1,1,413,1314,901
14436,1,1,273,1292,1019
14437,1,1,78,1963,1885
14438,1,1,539,1277,738
14439,1,0,13,0,-13
14440,1,0,55,0,-55
14441,1,0,35,0,-35
14442,1,1,748,1285,537
14443,0,0,25,0,-25
14444,0,0,49,0,-49
14445,1,1,153,1384,1231
14446,1,1,659,1428,769
14447,0,0,10,0,-10
14448,1,0,0,0,0
14449,0,0,26,0,-26
14450,1,0,109,0,-109
14451,1,1,1328,1460,132
14452,0,0,101,0,-101
14453,0,0,37,0,-37
14454,0,0,17,0,-17
14455,1,1,503,1401,898
14456,0,0,23,0,-23
14457,1,0,51,0,-51
14458,0,0,3,0,-3
14459,1,1,370,1605,1235
14460,0,0,6,0,-6
14461,1,1,118,1228,1110
14462,1,1,1117,1522,405
14463,1,1,198,1476,1278
14464,0,0,57,0,-57
14465,1,1,1176,1398,222
14466,1,0,17,0,-17
14467,1,0,27,0,-27
14468,1,1,760,1243,483
14469,0,0,5,0,-5
14470,1,1,2736,1429,-1307
14471,1,1,1183,2009,826
14472,1,1,210,2955,2745
14473,1,0,19,0,-19
14474,1,0,31,0,-31
14475,1,0,39,0,-39
14476,1,0,67,0,-67
14477,1,0,67,0,-67
14478,0,0,75,0,-75
14479,0,0,34,0,-34
14480,1,1,1146,1507,361
14481,0,0,20,0,-20
14482,0,0,2,0,-2
14483,1,0,59,0,-59
14484,0,0,47,0,-47
14485,1,0,91,0,-91
14486,1,1,761,1223,462
14487,0,0,173,0,-173
14488,0,0,61,0,-61
14489,1,1,547,1829,1282
14490,0,0,54,0,-54
14491,0,0,56,0,-56
14492,1,1,994,1243,249
14493,1,1,427,1655,1228
14494,0,0,15,0,-15
14495,1,1,255,1513,1258
14496,0,0,33,0,-33
14497,1,1,480,4368,3888
14498,1,1,86,1579,1493
14499,1,0,1,0,-1
14500,0,0,45,0,-45
14501,0,0,58,0,-58
14502,1,0,12,0,-12
14503,1,1,845,1250,405
14504,1,0,64,0,-64
14505,1,1,380,1271,891
14506,1,0,43,0,-43
14507,1,1,326,1484,1158
14508,1,1,885,1566,681
14509,1,1,1312,3317,2005
14510,1,0,65,0,-65
14511,1,1,227,1686,1459
14512,0,0,2,0,-2
14513,1,1,277,1363,1086
14514,1,1,626,1412,786
14515,1,1,285,1747,1462
14516,0,0,64,0,-64
14517,0,0,80,0,-80
14518,1,0,70,0,-70
14519,0,0,139,0,-139
14520,1,0,5,0,-5
14521,1,0,17,0,-17
14522,1,0,51,0,-51
14523,1,1,302,2178,1876
14524,1,1,2234,1491,-743
14525,1,0,106,0,-106
14526,0,0,26,0,-26
14527,0,0,143,0,-143
14528,1,1,1786,1242,-544
14529,1,1,858,1963,1105
14530,0,0,200,0,-200
14531,0,0,36,0,-36
14532,1,0,48,0,-48
14533,0,0,44,0,-44
14534,1,1,161,2475,2314
14535,1,1,118,1348,1230
14536,0,0,39,0,-39
14537,0,0,1,0,-1
14538,1,0,3,0,-3
14539,0,0,39,0,-39
14540,1,1,654,1230,576
14541,1,1,979,2349,1370
14542,1,0,70,0,-70
14543,0,0,4,0,-4
14544,1,0,49,0,-49
14545,0,0,49,0,-49
14546,1,0,40,0,-40
14547,1,0,95,0,-95
14548,1,1,559,2179,1620
14549,1,0,38,0,-38
14550,0,0,15,0,-15
14551,1,0,14,0,-14
14552,1,1,201,1399,1198
14553,0,0,68,0,-68
14554,1,1,86,1558,1472
14555,1,0,53,0,-53
14556,1,0,7,0,-7
14557,0,0,16,0,-16
14558,1,1,456,1282,826
14559,1,0,69,0,-69
14560,1,0,175,0,-175
14561,1,1,536,1383,847
14562,1,0,34,0,-34
14563,0,0,91,0,-91
14564,1,0,292,0,-292
14565,0,0,9,0,-9
14566,0,0,18,0,-18
14567,1,1,290,1238,948
14568,1,0,71,0,-71
14569,0,0,119,0,-119
14570,1,1,1888,1249,-639
14571,0,0,44,0,-44
14572,1,0,29,0,-29
14573,0,0,73,0,-73
14574,1,1,717,1711,994
14575,0,0,13,0,-13
14576,1,0,0,0,0
14577,1,1,77,1270,1193
14578,1,1,1796,1317,-479
14579,0,0,119,0,-119
14580,0,0,12,0,-12
14581,0,0,26,0,-26
14582,0,0,50,0,-50
14583,1,0,72,0,-72
14584,1,0,20,0,-20
14585,1,1,182,1557,1375
14586,1,1,445,1561,1116
14587,0,0,18,0,-18
14588,0,0,50,0,-50
14589,0,0,94,0,-94
14590,1,1,882,1207,325
14591,0,0,2,0,-2
14592,1,1,450,2166,1716
14593,1,1,502,3137,2635
14594,1,1,161,1575,1414
14595,1,0,1,0,-1
14596,0,0,8,0,-8
14597,0,0,62,0,-62
14598,1,0,85,0,-85
14599,1,1,203,1363,1160
14600,1,0,114,0,-114
14601,1,1,1492,1232,-260
14602,1,0,5,0,-5
14603,0,0,37,0,-37
14604,1,1,364,1626,1262
14605,0,0,198,0,-198
14606,0,0,9,0,-9
14607,0,0,11,0,-11
14608,0,0,21,0,-21
14609,0,0,87,0,-87
14610,1,0,113,0,-113
14611,1,1,1911,1445,-466
14612,1,1,765,1701,936
14613,1,0,217,0,-217
14614,1,0,17,0,-17
14615,1,1,922,1279,357
14616,0,0,106,0,-106
14617,1,0,10,0,-10
14618,1,1,571,1697,1126
14619,1,0,171,0,-171
14620,1,1,511,2134,1623
14621,1,1,194,1269,1075
14622,0,0,17,0,-17
14623,0,0,86,0,-86
14624,1,0,178,0,-178
14625,1,0,20,0,-20
14626,1,0,298,0,-298
14627,1,0,30,0,-30
14628,1,0,4,0,-4
14629,1,1,249,2188,1939
14630,0,0,29,0,-29
14631,1,0,23,0,-23
14632,1,1,404,1677,1273
14633,1,1,791,1697,906
14634,1,1,329,1231,902
14635,1,0,29,0,-29
14636,1,0,74,0,-74
14637,0,0,173,0,-173
14638,0,0,94,0,-94
14639,1,0,54,0,-54
14640,1,0,5,0,-5
14641,1,0,43,0,-43
14642,0,0,3,0,-3
14643,1,1,823,1719,896
14644,0,0,18,0,-18
14645,0,0,80,0,-80
14646,1,1,1021,1351,330
14647,0,0,39,0,-39
14648,1,0,5,0,-5
14649,1,1,41,2027,1986
14650,1,0,91,0,-91
14651,0,0,8,0,-8
14652,0,0,67,0,-67
14653,1,0,5,0,-5
14654,1,1,71,1432,1361
14655,0,0,11,0,-11
14656,1,1,550,1606,1056
14657,1,0,27,0,-27
14658,0,0,19,0,-19
14659,0,0,8,0,-8
14660,1,0,35,0,-35
14661,0,0,187,0,-187
14662,1,1,1121,1207,86
14663,1,1,189,2072,1883
14664,1,0,30,0,-30
14665,1,0,106,0,-106
14666,0,0,1,0,-1
14667,0,0,159,0,-159
14668,1,0,97,0,-97
14669,1,0,47,0,-47
14670,0,0,18,0,-18
14671,0,0,64,0,-64
14672,0,0,14,0,-14
14673,1,1,776,1301,525
14674,0,0,91,0,-91
14675,0,0,41,0,-41
14676,1,1,98,1268,1170
14677,0,0,7,0,-7
14678,0,0,32,0,-32
14679,1,1,486,1591,1105
14680,1,1,555,1731,1176
14681,1,1,84,1714,1630
14682,0,0,15,0,-15
14683,1,0,9,0,-9
14684,0,0,150,0,-150
14685,1,0,4,0,-4
14686,0,0,83,0,-83
14687,0,0,18,0,-18
14688,1,1,904,1202,298
14689,0,0,163,0,-163
14690,1,1,1418,1581,163
14691,1,0,4,0,-4
14692,0,0,116,0,-116
14693,1,1,311,1554,1243
14694,1,1,967,1525,558
14695,1,1,516,1585,1069
14696,1,1,623,2012,1389
14697,0,0,58,0,-58
14698,0,0,10,0,-10
14699,1,0,243,0,-243
14700,1,1,177,1315,1138
14701,1,1,2116,1359,-757
14702,0,0,12,0,-12
14703,0,0,36,0,-36
14704,1,1,264,1294,1030
14705,0,0,48,0,-48
14706,0,0,245,0,-245
14707,0,0,42,0,-42
14708,1,0,81,0,-81
14709,1,1,393,1929,1536
14710,1,0,51,0,-51
14711,1,1,323,1227,904
14712,0,0,0,0,0
14713,1,0,38,0,-38
14714,1,1,771,1232,461
14715,1,1,412,1215,803
14716,0,0,65,0,-65
14717,1,1,334,1422,1088
14718,0,0,63,0,-63
14719,1,1,267,1718,1451
14720,1,1,624,1756,1132
14721,1,0,68,0,-68
14722,1,0,25,0,-25
14723,0,0,6,0,-6
14724,0,0,9,0,-9
14725,0,0,35,0,-35
14726,0,0,33,0,-33
14727,1,1,127,1245,1118
14728,1,0,68,0,-68
14729,1,0,2,0,-2
14730,0,0,27,0,-27
14731,1,0,9,0,-9
14732,0,0,11,0,-11
14733,0,0,29,0,-29
14734,0,0,1,0,-1
14735,0,0,11,0,-11
14736,0,0,20,0,-20
14737,0,0,19,0,-19
14738,1,1,144,1316,1172
14739,1,1,598,2480,1882
14740,1,0,77,0,-77
14741,1,0,65,0,-65
14742,1,0,32,0,-32
14743,1,1,833,1386,553
14744,0,0,5,0,-5
14745,0,0,117,0,-117
14746,1,0,125,0,-125
14747,0,0,15,0,-15
14748,0,0,27,0,-27
14749,0,0,26,0,-26
14750,1,1,48,1279,1231
14751,1,1,659,1407,748
14752,1,0,6,0,-6
14753,0,0,121,0,-121
14754,1,1,87,1235,1148
14755,0,0,2,0,-2
14756,1,1,465,1418,953
14757,0,0,18,0,-18
14758,1,1,199,1545,1346
14759,0,0,35,0,-35
14760,1,0,114,0,-114
14761,1,0,4,0,-4
14762,0,0,0,0,0
14763,1,0,23,0,-23
14764,1,1,186,1462,1276
14765,1,0,98,0,-98
14766,1,0,88,0,-88
14767,1,1,307,1600,1293
14768,1,1,663,1768,1105
14769,1,1,425,1210,785
14770,0,0,31,0,-31
14771,1,0,11,0,-11
14772,0,0,46,0,-46
14773,0,0,176,0,-176
14774,1,0,47,0,-47
14775,1,1,209,1237,1028
14776,1,1,196,1479,1283
14777,1,1,439,1632,1193
14778,1,0,28,0,-28
14779,0,0,8,0,-8
14780,0,0,29,0,-29
14781,1,0,10,0,-10
14782,1,0,12,0,-12
14783,1,0,22,0,-22
14784,1,0,35,0,-35
14785,1,1,481,1293,812
14786,1,0,16,0,-16
14787,1,0,22,0,-22
14788,0,0,28,0,-28
14789,1,0,43,0,-43
14790,1,1,742,2076,1334
14791,0,0,16,0,-16
14792,0,0,21,0,-21
14793,1,1,92,1590,1498
14794,1,0,145,0,-145
14795,0,0,225,0,-225
14796,0,0,31,0,-31
14797,1,0,61,0,-61
14798,1,0,46,0,-46
14799,1,0,0,0,0
14800,0,0,42,0,-42
14801,0,0,75,0,-75
14802,0,0,24,0,-24
14803,0,0,25,0,-25
14804,1,0,20,0,-20
14805,1,0,122,0,-122
14806,0,0,28,0,-28
14807,1,1,942,2030,1088
14808,0,0,46,0,-46
14809,0,0,0,0,0
14810,1,1,179,1694,1515
14811,1,0,41,0,-41
14812,1,0,23,0,-23
14813,0,0,62,0,-62
14814,0,0,11,0,-11
14815,0,0,18,0,-18
14816,1,0,27,0,-27
14817,1,1,1222,2242,1020
14818,0,0,34,0,-34
14819,0,0,22,0,-22
14820,1,0,103,0,-103
14821,1,0,3,0,-3
14822,1,1,276,1256,980
14823,0,0,65,0,-65
14824,1,1,133,1479,1346
14825,1,1,384,2869,2485
14826,0,0,37,0,-37
14827,0,0,120,0,-120
14828,1,1,259,2052,1793
14829,0,0,97,0,-97
14830,1,0,43,0,-43
14831,1,0,218,0,-218
14832,1,0,22,0,-22
14833,0,0,95,0,-95
14834,1,0,32,0,-32
14835,0,0,30,0,-30
14836,1,1,158,1206,1048
14837,1,1,1609,3076,1467
14838,1,1,985,1307,322
14839,1,1,175,1231,1056
14840,0,0,19,0,-19
14841,0,0,28,0,-28
14842,1,0,44,0,-44
14843,1,1,349,1388,1039
14844,1,0,49,0,-49
14845,0,0,12,0,-12
14846,1,1,312,1517,1205
14847,1,1,135,1368,1233
14848,0,0,127,0,-127
14849,1,1,673,1443,770
14850,0,0,26,0,-26
14851,1,0,28,0,-28
14852,1,0,47,0,-47
14853,0,0,95,0,-95
14854,1,1,122,1834,1712
14855,1,0,58,0,-58
14856,0,0,28,0,-28
14857,0,0,18,0,-18
14858,0,0,25,0,-25
14859,1,1,84,1269,1185
14860,0,0,17,0,-17
14861,1,0,4,0,-4
14862,1,1,346,1974,1628
14863,1,1,1474,1561,87
14864,0,0,123,0,-123
14865,0,0,33,0,-33
14866,0,0,75,0,-75
14867,1,0,139,0,-139
14868,0,0,5,0,-5
14869,0,0,121,0,-121
14870,0,0,167,0,-167
14871,1,1,999,1396,397
14872,0,0,23,0,-23
14873,1,1,216,1275,1059
14874,1,1,916,1379,463
14875,1,1,417,1910,1493
14876,1,0,28,0,-28
14877,0,0,5,0,-5
14878,0,0,61,0,-61
14879,0,0,31,0,-31
14880,0,0,24,0,-24
14881,1,1,454,1237,783
14882,1,0,1,0,-1
14883,1,0,69,0,-69
14884,0,0,20,0,-20
14885,0,0,91,0,-91
14886,1,0,31,0,-31
14887,1,1,329,1596,1267
14888,1,1,1389,1510,121
14889,0,0,2,0,-2
14890,1,0,14,0,-14
14891,1,0,17,0,-17
14892,0,0,4,0,-4
14893,0,0,64,0,-64
14894,1,0,111,0,-111
14895,0,0,105,0,-105
14896,1,0,49,0,-49
14897,1,0,6,0,-6
14898,1,0,87,0,-87
14899,1,0,202,0,-202
14900,0,0,224,0,-224
14901,1,1,406,1696,1290
14902,1,1,90,1423,1333
14903,1,0,10,0,-10
14904,1,1,560,1644,1084
14905,0,0,116,0,-116
14906,0,0,11,0,-11
14907,1,0,35,0,-35
14908,1,0,14,0,-14
14909,1,0,77,0,-77
14910,0,0,118,0,-118
14911,0,0,22,0,-22
14912,0,0,6,0,-6
14913,0,0,66,0,-66
14914,1,0,109,0,-109
14915,1,0,47,0,-47
14916,1,1,362,1306,944
14917,0,0,72,0,-72
14918,0,0,20,0,-20
14919,1,1,119,1430,1311
14920,0,0,69,0,-69
14921,1,1,716,1269,553
14922,0,0,101,0,-101
14923,0,0,34,0,-34
14924,0,0,13,0,-13
14925,1,1,618,1309,691
14926,1,1,151,1392,1241
14927,1,1,1307,3893,2586
14928,1,0,97,0,-97
14929,0,0,67,0,-67
14930,1,0,2,0,-2
14931,1,0,0,0,0
14932,1,1,1174,1752,578
14933,0,0,20,0,-20
14934,1,1,407,1628,1221
14935,1,0,101,0,-101
14936,1,1,135,1524,1389
14937,1,1,82,1206,1124
14938,1,0,9,0,-9
14939,1,1,155,2353,2198
14940,1,0,25,0,-25
14941,1,0,246,0,-246
14942,1,1,1493,1872,379
14943,1,0,8,0,-8
14944,0,0,3,0,-3
14945,1,1,623,1703,1080
14946,1,0,11,0,-11
14947,1,1,273,1228,955
14948,1,1,152,1826,1674
14949,0,0,25,0,-25
14950,1,1,147,1746,1599
14951,1,1,415,3633,3218
14952,0,0,62,0,-62
14953,1,1,429,2319,1890
14954,0,0,98,0,-98
14955,0,0,27,0,-27
14956,0,0,73,0,-73
14957,0,0,138,0,-138
14958,1,0,29,0,-29
14959,1,0,42,0,-42
14960,0,0,24,0,-24
14961,0,0,42,0,-42
14962,1,0,45,0,-45
14963,0,0,43,0,-43
14964,1,0,4,0,-4
14965,0,0,55,0,-55
14966,1,1,56,1394,1338
14967,0,0,29,0,-29
14968,0,0,3,0,-3
14969,1,1,1502,1211,-291
14970,1,0,163,0,-163
14971,0,0,6,0,-6
14972,1,0,141,0,-141
14973,1,0,11,0,-11
14974,1,1,367,1315,948
14975,1,1,804,2036,1232
14976,1,1,678,1545,867
14977,1,0,58,0,-58
14978,1,1,547,1360,813
14979,1,1,1077,1327,250
14980,1,0,26,0,-26
14981,1,1,230,2029,1799
14982,1,1,577,1808,1231
14983,0,0,240,0,-240
14984,1,1,248,1244,996
14985,1,0,22,0,-22
14986,1,0,77,0,-77
14987,0,0,27,0,-27
14988,0,0,3,0,-3
14989,1,0,81,0,-81
14990,1,1,473,1205,732
14991,1,1,623,1561,938
14992,0,0,101,0,-101
14993,0,0,1,0,-1
14994,1,0,39,0,-39
14995,0,0,53,0,-53
14996,1,0,30,0,-30
14997,1,0,33,0,-33
14998,0,0,1,0,-1
14999,1,1,59,1280,1221
15000,0,0,16,0,-16
15001,1,1,2187,1550,-637
15002,0,0,2,0,-2
15003,0,0,115,0,-115
15004,1,1,321,1404,1083
15005,0,0,1,0,-1
15006,1,0,17,0,-17
15007,0,0,173,0,-173
15008,1,1,289,1814,1525
15009,0,0,54,0,-54
15010,1,0,119,0,-119
15011,1,0,42,0,-42
15012,0,0,27,0,-27
15013,0,0,25,0,-25
15014,1,1,1113,1351,238
15015,1,0,39,0,-39
15016,0,0,42,0,-42
15017,1,0,47,0,-47
15018,1,0,80,0,-80
15019,1,0,6,0,-6
15020,1,1,501,1208,707
15021,0,0,136,0,-136
15022,1,0,137,0,-137
15023,1,0,42,0,-42
15024,1,1,86,1234,1148
15025,1,0,64,0,-64
15026,0,0,39,0,-39
15027,1,0,2,0,-2
15028,0,0,82,0,-82
15029,0,0,9,0,-9
15030,0,0,10,0,-10
15031,0,0,31,0,-31
15032,1,1,177,2067,1890
15033,1,1,366,1400,1034
15034,0,0,25,0,-25
15035,0,0,2,0,-2
15036,0,0,56,0,-56
15037,0,0,7,0,-7
15038,0,0,3,0,-3
15039,0,0,273,0,-273
15040,1,1,638,1310,672
15041,1,1,256,1257,1001
15042,0,0,49,0,-49
15043,0,0,23,0,-23
15044,1,1,904,1242,338
15045,1,1,723,1347,624
15046,1,1,446,1646,1200
15047,0,0,3,0,-3
15048,1,0,0,0,0
15049,1,0,56,0,-56
15050,0,0,32,0,-32
15051,1,1,645,1848,1203
15052,0,0,106,0,-106
15053,1,1,688,1395,707
15054,1,0,116,0,-116
15055,1,0,31,0,-31
15056,1,0,15,0,-15
15057,0,0,139,0,-139
15058,1,0,24,0,-24
15059,1,1,676,1304,628
15060,1,1,644,1649,1005
15061,0,0,57,0,-57
15062,0,0,24,0,-24
15063,0,0,66,0,-66
15064,0,0,109,0,-109
15065,1,0,36,0,-36
15066,0,0,3,0,-3
15067,1,0,16,0,-16
15068,1,0,27,0,-27
15069,1,1,265,1226,961
15070,0,0,30,0,-30
15071,0,0,131,0,-131
15072,0,0,24,0,-24
15073,1,0,2,0,-2
15074,0,0,16,0,-16
15075,1,1,18,1795,1777
15076,1,1,880,1976,1096
15077,0,0,40,0,-40
15078,1,0,39,0,-39
15079,0,0,34,0,-34
15080,0,0,35,0,-35
15081,0,0,11,0,-11
15082,0,0,2,0,-2
15083,0,0,3,0,-3
15084,1,0,65,0,-65
15085,1,1,113,2031,1918
15086,0,0,1,0,-1
15087,1,1,445,1845,1400
15088,1,0,104,0,-104
15089,1,1,157,1226,1069
15090,1,1,177,1844,1667
15091,0,0,27,0,-27
15092,0,0,63,0,-63
15093,1,0,37,0,-37
15094,1,0,36,0,-36
15095,1,1,1200,1880,680
15096,1,1,2068,1241,-827
15097,0,0,19,0,-19
15098,1,1,181,1211,1030
15099,0,0,52,0,-52
15100,1,0,16,0,-16
15101,1,0,2,0,-2
15102,0,0,4,0,-4
15103,1,0,1,0,-1
15104,1,0,36,0,-36
15105,1,1,1166,1636,470
15106,0,0,64,0,-64
15107,1,0,72,0,-72
15108,0,0,24,0,-24
15109,0,0,19,0,-19
15110,0,0,47,0,-47
15111,0,0,36,0,-36
15112,1,0,18,0,-18
15113,1,0,26,0,-26
15114,0,0,38,0,-38
15115,0,0,125,0,-125
15116,1,1,388,1578,1190
15117,0,0,167,0,-167
15118,0,0,77,0,-77
15119,1,0,1,0,-1
15120,0,0,6,0,-6
15121,1,1,126,1733,1607
15122,1,1,5,1737,1732
15123,1,0,38,0,-38
15124,1,1,125,1848,1723
15125,1,1,113,1635,1522
15126,1,0,1,0,-1
15127,1,1,583,1960,1377
15128,1,0,170,0,-170
15129,0,0,2,0,-2
15130,0,0,33,0,-33
15131,1,1,475,2882,2407
15132,0,0,45,0,-45
15133,1,0,124,0,-124
15134,0,0,36,0,-36
15135,0,0,4,0,-4
15136,1,1,571,1234,663
15137,0,0,75,0,-75
15138,1,1,163,1427,1264
15139,1,1,99,1324,1225
15140,1,0,28,0,-28
15141,0,0,86,0,-86
15142,1,0,14,0,-14
15143,1,0,59,0,-59
15144,1,1,699,1226,527
15145,0,0,86,0,-86
15146,0,0,49,0,-49
15147,1,0,4,0,-4
15148,1,0,11,0,-11
15149,0,0,19,0,-19
15150,0,0,9,0,-9
15151,0,0,333,0,-333
15152,1,0,27,0,-27
15153,0,0,32,0,-32
15154,1,1,175,1411,1236
15155,1,1,1188,1290,102
15156,1,1,711,1297,586
15157,0,0,95,0,-95
15158,1,0,3,0,-3
15159,1,1,69,1299,1230
15160,1,0,28,0,-28
15161,1,0,132,0,-132
15162,1,0,49,0,-49
15163,0,0,33,0,-33
15164,1,1,19,1343,1324
15165,1,1,273,1371,1098
15166,1,1,1493,2299,806
15167,0,0,80,0,-80
15168,1,1,679,1201,522
15169,1,1,1359,2688,1329
15170,1,1,1165,1750,585
15171,1,0,2,0,-2
15172,1,1,883,2022,1139
15173,1,1,37,1217,1180
15174,1,1,498,1471,973
15175,1,1,436,1247,811
15176,1,1,219,1806,1587
15177,0,0,14,0,-14
15178,0,0,19,0,-19
15179,1,0,69,0,-69
15180,1,0,6,0,-6
15181,1,0,91,0,-91
15182,0,0,64,0,-64
15183,1,1,80,2056,1976
15184,1,1,408,1261,853
15185,1,1,492,1457,965
15186,0,0,97,0,-97
15187,1,1,506,1445,939
15188,1,1,1243,2506,1263
15189,1,1,1249,1660,411
15190,1,0,37,0,-37
15191,1,1,506,2493,1987
15192,0,0,100,0,-100
15193,1,1,27,1235,1208
15194,1,0,38,0,-38
15195,0,0,219,0,-219
15196,1,0,58,0,-58
15197,0,0,44,0,-44
15198,1,0,8,0,-8
15199,1,1,187,1360,1173
15200,0,0,59,0,-59
15201,1,1,834,1731,897
15202,1,0,107,0,-107
15203,1,1,500,1422,922
15204,0,0,100,0,-100
15205,1,0,14,0,-14
15206,0,0,27,0,-27
15207,1,1,1126,1901,775
15208,1,0,63,0,-63
15209,0,0,2,0,-2
15210,0,0,109,0,-109
15211,0,0,84,0,-84
15212,0,0,2,0,-2
15213,0,0,7,0,-7
15214,0,0,6,0,-6
15215,0,0,28,0,-28
15216,1,0,103,0,-103
15217,0,0,94,0,-94
15218,1,1,579,1304,725
15219,0,0,38,0,-38
15220,0,0,48,0,-48
15221,1,1,51,1336,1285
15222,0,0,30,0,-30
15223,1,1,923,1283,360
15224,0,0,49,0,-49
15225,0,0,102,0,-102
15226,1,1,1311,1592,281
15227,1,0,333,0,-333
15228,0,0,20,0,-20
15229,1,0,58,0,-58
15230,1,0,99,0,-99
15231,0,0,8,0,-8
15232,0,0,35,0,-35
15233,0,0,184,0,-184
15234,1,0,18,0,-18
15235,1,0,5,0,-5
15236,1,0,121,0,-121
15237,0,0,51,0,-51
15238,0,0,6,0,-6
15239,0,0,43,0,-43
15240,0,0,7,0,-7
15241,1,1,2067,1537,-530
15242,1,1,557,1241,684
15243,1,1,351,1238,887
15244,0,0,206,0,-206
15245,1,0,24,0,-24
15246,0,0,55,0,-55
15247,1,0,52,0,-52
15248,0,0,48,0,-48
15249,1,1,937,1663,726
15250,1,1,145,1680,1535
15251,1,1,1170,1390,220
15252,1,1,61,1232,1171
15253,1,1,159,1577,1418
15254,1,0,39,0,-39
15255,0,0,48,0,-48
15256,1,1,28,1674,1646
15257,1,1,232,1741,1509
15258,1,0,44,0,-44
15259,0,0,44,0,-44
15260,1,0,24,0,-24
15261,1,1,1114,3827,2713
15262,1,0,20,0,-20
15263,1,0,119,0,-119
15264,1,0,157,0,-157
15265,0,0,49,0,-49
15266,0,0,23,0,-23
15267,1,0,49,0,-49
15268,1,0,31,0,-31
15269,0,0,11,0,-11
15270,1,1,66,1350,1284
15271,1,0,13,0,-13
15272,1,1,112,1212,1100
15273,0,0,39,0,-39
15274,0,0,57,0,-57
15275,1,1,313,1337,1024
15276,0,0,10,0,-10
15277,1,0,9,0,-9
15278,1,0,17,0,-17
15279,0,0,9,0,-9
15280,0,0,25,0,-25
15281,0,0,84,0,-84
15282,0,0,12,0,-12
15283,1,0,18,0,-18
15284,1,0,35,0,-35
15285,1,1,1623,1588,-35
15286,1,0,10,0,-10
15287,1,0,9,0,-9
15288,1,1,352,1336,984
15289,1,0,20,0,-20
15290,1,1,787,2218,1431
15291,1,0,60,0,-60
15292,1,1,1260,1252,-8
15293,0,0,4,0,-4
15294,1,1,1903,1236,-667
15295,1,1,634,1999,1365
15296,1,0,240,0,-240
15297,1,0,177,0,-177
15298,0,0,71,0,-71
15299,1,1,117,1456,1339
15300,1,0,52,0,-52
15301,1,1,134,1326,1192
15302,0,0,57,0,-57
15303,1,1,454,1654,1200
15304,0,0,2,0,-2
15305,1,1,720,2425,1705
15306,1,1,336,1581,1245
15307,0,0,124,0,-124
15308,1,1,86,1710,1624
15309,1,0,23,0,-23
15310,1,1,30,1320,1290
15311,1,0,212,0,-212
15312,1,1,313,1204,891
15313,1,1,538,1744,1206
15314,0,0,21,0,-21
15315,0,0,18,0,-18
15316,1,0,5,0,-5
15317,1,1,51,1315,1264
15318,1,1,119,1269,1150
15319,1,1,932,1452,520
15320,1,0,9,0,-9
15321,1,1,207,2574,2367
15322,1,1,1567,1499,-68
15323,1,1,667,1426,759
15324,1,0,13,0,-13
15325,0,0,97,0,-97
15326,1,1,1132,1253,121
15327,0,0,2,0,-2
15328,1,1,230,1437,1207
15329,0,0,40,0,-40
15330,1,1,1332,2228,896
15331,0,0,74,0,-74
15332,1,1,549,1320,771
15333,0,0,13,0,-13
15334,1,0,2,0,-2
15335,1,1,1568,1272,-296
15336,1,0,39,0,-39
15337,1,0,31,0,-31
15338,0,0,21,0,-21
15339,0,0,38,0,-38
15340,1,0,27,0,-27
15341,0,0,14,0,-14
15342,1,1,380,1773,1393
15343,1,1,2433,1480,-953
15344,0,0,19,0,-19
15345,1,1,1962,1201,-761
15346,0,0,12,0,-12
15347,0,0,7,0,-7
15348,1,1,1379,6076,4697
15349,1,1,771,2101,1330
15350,1,0,38,0,-38
15351,1,0,8,0,-8
15352,1,0,17,0,-17
15353,1,1,199,1494,1295
15354,1,1,832,1881,1049
15355,1,0,13,0,-13
15356,1,0,95,0,-95
15357,0,0,1,0,-1
15358,1,1,210,1230,1020
15359,0,0,59,0,-59
15360,0,0,2,0,-2
15361,0,0,18,0,-18
15362,1,1,496,1278,782
15363,1,1,2054,1295,-759
15364,1,1,484,1741,1257
15365,1,0,20,0,-20
15366,0,0,38,0,-38
15367,1,1,419,1383,964
15368,1,0,0,0,0
15369,1,0,18,0,-18
15370,0,0,27,0,-27
15371,1,1,319,1407,1088
15372,1,0,0,0,0
15373,1,0,179,0,-179
15374,0,0,1,0,-1
15375,1,1,363,1626,1263
15376,1,1,27,1347,1320
15377,1,0,76,0,-76
15378,0,0,20,0,-20
15379,0,0,58,0,-58
15380,1,1,922,1309,387
15381,1,1,172,1427,1255
15382,1,0,90,0,-90
15383,1,1,146,1425,1279
15384,1,0,37,0,-37
15385,1,0,81,0,-81
15386,1,0,38,0,-38
15387,1,0,81,0,-81
15388,0,0,65,0,-65
15389,0,0,18,0,-18
15390,1,1,120,1507,1387
15391,0,0,26,0,-26
15392,1,0,7,0,-7
15393,1,0,88,0,-88
15394,1,0,136,0,-136
15395,1,1,218,1794,1576
15396,1,0,202,0,-202
15397,0,0,21,0,-21
15398,1,0,4,0,-4
15399,1,0,44,0,-44
15400,0,0,24,0,-24
15401,1,0,225,0,-225
15402,1,0,16,0,-16
15403,0,0,19,0,-19
15404,1,1,524,1272,748
15405,1,0,13,0,-13
15406,1,0,80,0,-80
15407,1,1,574,1686,1112
15408,1,1,832,1497,665
15409,1,1,112,1653,1541
15410,1,0,7,0,-7
15411,1,0,52,0,-52
15412,0,0,6,0,-6
15413,1,0,36,0,-36
15414,1,0,22,0,-22
15415,1,0,25,0,-25
15416,1,0,0,0,0
15417,0,0,58,0,-58
15418,0,0,57,0,-57
15419,1,1,64,1930,1866
15420,1,0,41,0,-41
15421,1,0,5,0,-5
15422,0,0,0,0,0
15423,1,1,246,1481,1235
15424,1,0,107,0,-107
15425,0,0,52,0,-52
15426,0,0,22,0,-22
15427,0,0,24,0,-24
15428,0,0,3,0,-3
15429,1,1,422,2846,2424
15430,0,0,16,0,-16
15431,0,0,74,0,-74
15432,0,0,25,0,-25
15433,1,0,11,0,-11
15434,1,0,40,0,-40
15435,0,0,47,0,-47
15436,0,0,49,0,-49
15437,1,0,13,0,-13
15438,1,0,22,0,-22
15439,0,0,37,0,-37
15440,1,1,774,1251,477
15441,0,0,66,0,-66
15442,1,1,268,1232,964
15443,0,0,42,0,-42
15444,1,1,645,1611,966
15445,1,1,988,1292,304
15446,1,0,2,0,-2
15447,0,0,57,0,-57
15448,0,0,16,0,-16
15449,1,0,91,0,-91
15450,1,1,688,1450,762
15451,1,1,150,1564,1414
15452,0,0,221,0,-221
15453,1,1,220,1496,1276
15454,1,0,13,0,-13
15455,1,1,421,1228,807
15456,0,0,14,0,-14
15457,1,1,548,1426,878
15458,1,1,494,1403,909
15459,1,0,60,0,-60
15460,1,1,1276,2461,1185
15461,1,1,607,1277,670
15462,0,0,12,0,-12
15463,1,1,1071,1289,218
15464,0,0,28,0,-28
15465,1,1,74,1448,1374
15466,0,0,141,0,-141
15467,1,0,94,0,-94
15468,1,0,67,0,-67
15469,0,0,104,0,-104
15470,1,0,41,0,-41
15471,1,0,44,0,-44
15472,1,0,35,0,-35
15473,1,0,29,0,-29
15474,1,0,47,0,-47
15475,1,0,79,0,-79
15476,1,1,257,1276,1019
15477,0,0,204,0,-204
15478,1,1,1043,1412,369
15479,1,1,1937,1767,-170
15480,1,1,1556,1547,-9
15481,1,0,24,0,-24
15482,0,0,119,0,-119
15483,0,0,52,0,-52
15484,1,1,685,1288,603
15485,1,1,2506,1837,-669
15486,1,0,13,0,-13
15487,0,0,12,0,-12
15488,1,0,54,0,-54
15489,1,0,52,0,-52
15490,1,1,256,1709,1453
15491,0,0,60,0,-60
15492,0,0,105,0,-105
15493,0,0,4,0,-4
15494,0,0,17,0,-17
15495,1,1,53,1258,1205
15496,1,1,297,1271,974
15497,1,1,462,1200,738
15498,1,0,39,0,-39
15499,1,1,435,1230,795
15500,0,0,198,0,-198
15501,0,0,107,0,-107
15502,0,0,50,0,-50
15503,1,0,13,0,-13
15504,0,0,12,0,-12
15505,1,0,11,0,-11
15506,1,1,918,1292,374
15507,0,0,93,0,-93
15508,1,1,303,1854,1551
15509,0,0,12,0,-12
15510,1,0,118,0,-118
15511,0,0,92,0,-92
15512,0,0,0,0,0
15513,0,0,53,0,-53
15514,0,0,21,0,-21
15515,0,0,42,0,-42
15516,1,0,52,0,-52
15517,1,0,42,0,-42
15518,1,1,544,2304,1760
15519,0,0,33,0,-33
15520,0,0,16,0,-16
15521,1,0,25,0,-25
15522,1,1,168,1232,1064
15523,1,0,23,0,-23
15524,1,0,53,0,-53
15525,1,1,292,2767,2475
15526,0,0,30,0,-30
15527,0,0,1,0,-1
15528,1,0,61,0,-61
15529,1,1,244,1293,1049
15530,0,0,72,0,-72
15531,1,1,1972,4449,2477
15532,1,1,701,1247,546
15533,1,1,2156,1632,-524
15534,0,0,0,0,0
15535,1,0,71,0,-71
15536,0,0,28,0,-28
15537,1,1,894,1235,341
15538,0,0,9,0,-9
15539,1,0,12,0,-12
15540,1,0,15,0,-15
15541,1,0,94,0,-94
15542,1,0,31,0,-31
15543,0,0,9,0,-9
15544,0,0,48,0,-48
15545,1,1,292,1240,948
15546,0,0,25,0,-25
15547,0,0,24,0,-24
15548,0,0,74,0,-74
15549,1,0,53,0,-53
15550,0,0,48,0,-48
15551,1,1,633,1467,834
15552,1,1,134,1252,1118
15553,0,0,5,0,-5
15554,1,0,13,0,-13
15555,0,0,84,0,-84
15556,0,0,73,0,-73
15557,0,0,15,0,-15
15558,1,0,4,0,-4
15559,0,0,1,0,-1
15560,1,1,222,1982,1760
15561,0,0,4,0,-4
15562,0,0,124,0,-124
15563,0,0,91,0,-91
15564,0,0,88,0,-88
15565,1,0,52,0,-52
15566,1,1,380,1334,954
15567,1,1,1113,1467,354
15568,0,0,15,0,-15
15569,1,0,11,0,-11
15570,1,1,645,1212,567
15571,1,0,6,0,-6
15572,1,0,1,0,-1
15573,0,0,14,0,-14
15574,1,1,61,2472,2411
15575,1,1,317,1504,1187
15576,1,0,53,0,-53
15577,1,0,16,0,-16
15578,1,0,35,0,-35
15579,1,0,73,0,-73
15580,1,0,25,0,-25
15581,1,0,51,0,-51
15582,1,0,80,0,-80
15583,0,0,47,0,-47
15584,0,0,5,0,-5
15585,1,1,86,2848,2762
15586,1,1,173,1980,1807
15587,1,0,94,0,-94
15588,1,0,65,0,-65
15589,1,1,343,1658,1315
15590,1,1,1308,2011,703
15591,1,0,199,0,-199
15592,0,0,7,0,-7
15593,0,0,11,0,-11
15594,0,0,132,0,-132
15595,0,0,9,0,-9
15596,1,0,66,0,-66
15597,1,1,32,1351,1319
15598,1,0,38,0,-38
15599,1,1,1266,2300,1034
15600,0,0,4,0,-4
15601,0,0,31,0,-31
15602,0,0,19,0,-19
15603,0,0,21,0,-21
15604,0,0,5,0,-5
15605,0,0,42,0,-42
15606,1,0,26,0,-26
15607,0,0,86,0,-86
15608,0,0,17,0,-17
15609,0,0,59,0,-59
15610,0,0,18,0,-18
15611,1,1,95,1214,1119
15612,1,0,77,0,-77
15613,1,0,25,0,-25
15614,0,0,85,0,-85
15615,0,0,17,0,-17
15616,1,1,522,1449,927
15617,0,0,17,0,-17
15618,1,1,200,1466,1266
15619,1,0,19,0,-19
15620,1,0,10,0,-10
15621,1,1,197,1224,1027
15622,1,0,30,0,-30
15623,1,0,6,0,-6
15624,1,1,298,1238,940
15625,1,0,78,0,-78
15626,1,1,101,1751,1650
15627,1,1,1294,1528,234
15628,1,1,273,2957,2684
15629,1,0,37,0,-37
15630,1,0,55,0,-55
15631,1,1,101,1409,1308
15632,0,0,126,0,-126
15633,1,1,335,1282,947
15634,0,0,2,0,-2
15635,1,1,229,1260,1031
15636,0,0,46,0,-46
15637,1,0,50,0,-50
15638,1,1,291,1283,992
15639,1,0,95,0,-95
15640,1,1,205,1315,1110
15641,0,0,27,0,-27
15642,1,1,423,1304,881
15643,0,0,9,0,-9
15644,1,0,9,0,-9
15645,0,0,1,0,-1
15646,0,0,12,0,-12
15647,1,1,414,1790,1376
15648,1,1,601,1559,958
15649,0,0,79,0,-79
15650,0,0,67,0,-67
15651,1,1,191,1519,1328
15652,0,0,60,0,-60
15653,0,0,2,0,-2
15654,0,0,140,0,-140
15655,1,0,2,0,-2
15656,1,0,21,0,-21
15657,0,0,77,0,-77
15658,1,1,243,1373,1130
15659,0,0,13,0,-13
15660,0,0,26,0,-26
15661,0,0,74,0,-74
15662,0,0,9,0,-9
15663,0,0,91,0,-91
15664,0,0,160,0,-160
15665,0,0,5,0,-5
15666,1,0,92,0,-92
15667,0,0,126,0,-126
15668,0,0,2,0,-2
15669,1,0,5,0,-5
15670,1,1,148,1539,1391
15671,1,0,56,0,-56
15672,0,0,41,0,-41
15673,1,1,1019,1439,420
15674,1,0,12,0,-12
15675,0,0,55,0,-55
15676,1,1,397,1397,1000
15677,1,1,470,1822,1352
15678,0,0,210,0,-210
15679,0,0,13,0,-13
15680,1,1,556,1323,767
15681,1,0,10,0,-10
15682,1,1,845,2153,1308
15683,0,0,115,0,-115
15684,1,0,36,0,-36
15685,1,1,468,1442,974
15686,1,0,5,0,-5
15687,1,0,55,0,-55
15688,1,0,28,0,-28
15689,1,1,941,1421,480
15690,1,1,59,1702,1643
15691,1,1,542,1208,666
15692,1,1,414,1546,1132
15693,0,0,108,0,-108
15694,1,0,109,0,-109
15695,0,0,88,0,-88
15696,0,0,7,0,-7
15697,0,0,415,0,-415
15698,1,1,257,1368,1111
15699,0,0,180,0,-180
15700,1,1,235,1922,1687
15701,1,0,28,0,-28
15702,1,1,906,1249,343
15703,0,0,29,0,-29
15704,1,1,131,1588,1457
15705,0,0,6,0,-6
15706,1,0,57,0,-57
15707,1,0,11,0,-11
15708,0,0,30,0,-30
15709,1,0,10,0,-10
15710,1,0,73,0,-73
15711,1,0,51,0,-51
15712,0,0,40,0,-40
15713,0,0,12,0,-12
15714,1,1,499,1358,859
15715,1,1,246,2383,2137
15716,0,0,11,0,-11
15717,0,0,3,0,-3
15718,1,0,121,0,-121
15719,1,0,2,0,-2
15720,1,1,94,1249,1155
15721,0,0,186,0,-186
15722,1,0,16,0,-16
15723,1,1,18,1226,1208
15724,0,0,15,0,-15
15725,1,0,11,0,-11
15726,1,1,2251,1352,-899
15727,1,0,14,0,-14
15728,1,1,569,1422,853
15729,1,1,245,1332,1087
15730,1,1,89,1879,1790
15731,0,0,98,0,-98
15732,1,1,311,1468,1157
15733,0,0,104,0,-104
15734,1,1,187,1225,1038
15735,0,0,34,0,-34
15736,0,0,5,0,-5
15737,1,1,152,1253,1101
15738,0,0,8,0,-8
15739,0,0,5,0,-5
15740,0,0,51,0,-51
15741,1,0,135,0,-135
15742,1,0,28,0,-28
15743,1,1,443,1326,883
15744,1,1,92,1580,1488
15745,0,0,13,0,-13
15746,1,1,358,1495,1137
15747,1,1,618,1251,633
15748,1,0,16,0,-16
15749,1,1,984,1371,387
15750,1,0,37,0,-37
15751,0,0,96,0,-96
15752,1,1,829,1219,390
15753,1,0,33,0,-33
15754,1,0,71,0,-71
15755,1,1,474,1272,798
15756,0,0,56,0,-56
15757,1,1,208,1334,1126
15758,1,0,48,0,-48
15759,1,0,12,0,-12
15760,0,0,6,0,-6
15761,1,1,1024,1905,881
15762,1,1,199,1233,1034
15763,1,0,111,0,-111
15764,1,1,777,1882,1105
15765,1,1,457,1217,760
15766,0,0,42,0,-42
15767,1,0,106,0,-106
15768,0,0,27,0,-27
15769,0,0,80,0,-80
15770,1,1,2002,1308,-694
15771,1,0,34,0,-34
15772,0,0,66,0,-66
15773,1,1,1080,2239,1159
15774,0,0,58,0,-58
15775,1,0,8,0,-8
15776,1,1,31,1345,1314
15777,0,0,27,0,-27
15778,1,0,1,0,-1
15779,0,0,28,0,-28
15780,1,0,28,0,-28
15781,1,1,1539,1285,-254
15782,0,0,22,0,-22
15783,1,1,222,1292,1070
15784,1,0,13,0,-13
15785,1,1,342,1843,1501
15786,0,0,11,0,-11
15787,1,1,403,1452,1049
15788,1,1,140,1629,1489
15789,0,0,150,0,-150
15790,1,1,203,1504,1301
15791,1,1,516,1636,1120
15792,0,0,92,0,-92
15793,1,1,199,1212,1013
15794,1,1,95,1812,1717
15795,1,0,85,0,-85
15796,0,0,2,0,-2
15797,0,0,15,0,-15
15798,1,1,934,1281,347
15799,1,1,1038,1740,702
15800,1,1,189,1303,1114
15801,1,0,41,0,-41
15802,0,0,8,0,-8
15803,1,1,378,1457,1079
15804,0,0,17,0,-17
15805,0,0,30,0,-30
15806,1,1,122,1264,1142
15807,1,1,324,1411,1087
15808,1,0,14,0,-14
15809,1,0,5,0,-5
15810,0,0,113,0,-113
15811,1,0,35,0,-35
15812,1,0,23,0,-23
15813,1,0,71,0,-71
15814,0,0,15,0,-15
15815,1,1,162,1254,1092
15816,1,1,632,1233,601
15817,1,0,3,0,-3
15818,1,1,151,1270,1119
15819,0,0,20,0,-20
15820,0,0,14,0,-14
15821,1,0,43,0,-43
15822,0,0,107,0,-107
15823,1,0,2,0,-2
15824,0,0,140,0,-140
15825,0,0,0,0,0
15826,1,0,153,0,-153
15827,1,0,19,0,-19
15828,0,0,3,0,-3
15829,1,0,11,0,-11
15830,0,0,16,0,-16
15831,0,0,28,0,-28
15832,0,0,37,0,-37
15833,0,0,53,0,-53
15834,1,0,94,0,-94
15835,1,1,781,2315,1534
15836,1,0,53,0,-53
15837,1,1,843,1369,526
15838,1,1,406,1511,1105
15839,0,0,9,0,-9
15840,1,0,3,0,-3
15841,0,0,39,0,-39
15842,1,1,873,2069,1196
15843,1,1,856,1261,405
15844,1,1,247,1547,1300
15845,0,0,2,0,-2
15846,0,0,50,0,-50
15847,1,1,124,1672,1548
15848,1,0,4,0,-4
15849,0,0,33,0,-33
15850,1,1,47,1398,1351
15851,0,0,67,0,-67
15852,1,0,20,0,-20
15853,0,0,69,0,-69
15854,1,1,1342,1953,611
15855,0,0,17,0,-17
15856,0,0,130,0,-130
15857,1,0,60,0,-60
15858,0,0,121,0,-121
15859,1,1,380,1210,830
15860,1,0,162,0,-162
15861,0,0,36,0,-36
15862,0,0,28,0,-28
15863,1,1,554,1250,696
15864,0,0,5,0,-5
15865,1,0,61,0,-61
15866,1,0,51,0,-51
15867,1,1,736,1611,875
15868,0,0,99,0,-99
15869,1,0,19,0,-19
15870,0,0,35,0,-35
15871,1,0,27,0,-27
15872,1,1,422,1589,1167
15873,0,0,12,0,-12
15874,1,0,58,0,-58
15875,1,0,0,0,0
15876,0,0,53,0,-53
15877,1,1,214,1421,1207
15878,0,0,13,0,-13
15879,0,0,55,0,-55
15880,0,0,95,0,-95
15881,1,0,1,0,-1
15882,0,0,76,0,-76
15883,0,0,145,0,-145
15884,0,0,30,0,-30
15885,1,1,162,1486,1324
15886,1,0,72,0,-72
15887,0,0,41,0,-41
15888,0,0,60,0,-60
15889,1,0,27,0,-27
15890,1,0,118,0,-118
15891,1,0,48,0,-48
15892,1,0,7,0,-7
15893,1,1,481,1850,1369
15894,0,0,15,0,-15
15895,0,0,12,0,-12
15896,0,0,19,0,-19
15897,1,0,2,0,-2
15898,1,1,575,1445,870
15899,1,0,95,0,-95
15900,0,0,195,0,-195
15901,0,0,6,0,-6
15902,1,0,39,0,-39
15903,1,1,388,1225,837
15904,1,1,781,1457,676
15905,1,1,256,1228,972
15906,1,1,269,2379,2110
15907,0,0,1,0,-1
15908,1,0,15,0,-15
15909,1,0,12,0,-12
15910,0,0,191,0,-191
15911,1,0,62,0,-62
15912,0,0,14,0,-14
15913,1,1,601,2661,2060
15914,0,0,49,0,-49
15915,1,1,1720,1627,-93
15916,0,0,51,0,-51
15917,1,0,104,0,-104
15918,1,0,32,0,-32
15919,0,0,96,0,-96
15920,0,0,46,0,-46
15921,1,0,145,0,-145
15922,1,1,77,3691,3614
15923,0,0,120,0,-120
15924,0,0,103,0,-103
15925,0,0,78,0,-78
15926,0,0,4,0,-4
15927,0,0,0,0,0
15928,1,1,1329,1589,260
15929,1,0,28,0,-28
15930,1,0,146,0,-146
15931,1,0,79,0,-79
15932,0,0,79,0,-79
15933,0,0,59,0,-59
15934,1,1,270,1489,1219
15935,0,0,12,0,-12
15936,0,0,5,0,-5
15937,1,0,60,0,-60
15938,0,0,11,0,-11
15939,0,0,69,0,-69
15940,1,1,24,1765,1741
15941,0,0,8,0,-8
15942,0,0,159,0,-159
15943,1,0,109,0,-109
15944,1,1,784,1705,921
15945,1,0,37,0,-37
15946,0,0,11,0,-11
15947,0,0,39,0,-39
15948,0,0,59,0,-59
15949,1,1,754,1294,540
15950,0,0,11,0,-11
15951,0,0,54,0,-54
15952,1,1,233,2167,1934
15953,1,0,209,0,-209
15954,0,0,93,0,-93
15955,1,0,29,0,-29
15956,0,0,93,0,-93
15957,1,0,21,0,-21
15958,1,0,110,0,-110
15959,1,0,17,0,-17
15960,1,0,56,0,-56
15961,1,0,97,0,-97
15962,0,0,13,0,-13
15963,0,0,46,0,-46
15964,1,0,39,0,-39
15965,0,0,297,0,-297
15966,1,1,746,1534,788
15967,1,0,126,0,-126
15968,1,1,499,1254,755
15969,0,0,25,0,-25
15970,0,0,37,0,-37
15971,1,0,24,0,-24
15972,1,0,9,0,-9
15973,1,0,112,0,-112
15974,0,0,126,0,-126
15975,0,0,72,0,-72
15976,1,0,88,0,-88
15977,0,0,15,0,-15
15978,0,0,192,0,-192
15979,0,0,10,0,-10
15980,1,1,24,1272,1248
15981,0,0,75,0,-75
15982,0,0,90,0,-90
15983,1,0,5,0,-5
15984,0,0,65,0,-65
15985,1,0,13,0,-13
15986,1,1,681,1463,782
15987,1,0,33,0,-33
15988,1,1,63,1492,1429
15989,0,0,42,0,-42
15990,0,0,8,0,-8
15991,1,1,1027,1212,185
15992,1,1,982,1240,258
15993,1,0,18,0,-18
15994,1,0,49,0,-49
15995,0,0,85,0,-85
15996,1,1,802,1390,588
15997,0,0,6,0,-6
15998,1,0,56,0,-56
15999,0,0,50,0,-50
16000,1,0,34,0,-34
16001,0,0,119,0,-119
16002,0,0,58,0,-58
16003,0,0,82,0,-82
16004,1,0,61,0,-61
16005,1,0,0,0,0
16006,0,0,47,0,-47
16007,1,0,134,0,-134
16008,1,0,96,0,-96
16009,0,0,13,0,-13
16010,1,1,443,1622,1179
16011,1,0,62,0,-62
16012,1,1,361,1324,963
16013,1,1,543,1242,699
16014,1,1,45,1721,1676
16015,1,0,0,0,0
16016,0,0,14,0,-14
16017,0,0,95,0,-95
16018,0,0,16,0,-16
16019,1,0,13,0,-13
16020,0,0,168,0,-168
16021,0,0,65,0,-65
16022,1,1,1210,1338,128
16023,1,0,56,0,-56
16024,1,1,661,1917,1256
16025,1,0,19,0,-19
16026,1,1,1341,1451,110
16027,1,0,12,0,-12
16028,1,1,2440,1547,-893
16029,1,0,8,0,-8
16030,1,1,316,1340,1024
16031,1,1,244,1698,1454
16032,1,0,143,0,-143
16033,0,0,11,0,-11
16034,1,0,55,0,-55
16035,1,0,292,0,-292
16036,1,0,19,0,-19
16037,0,0,14,0,-14
16038,1,0,143,0,-143
16039,0,0,22,0,-22
16040,0,0,17,0,-17
16041,1,1,523,1326,803
16042,1,0,3,0,-3
16043,1,1,553,1444,891
16044,0,0,35,0,-35
16045,1,0,135,0,-135
16046,1,1,504,1533,1029
16047,0,0,2,0,-2
16048,1,0,8,0,-8
16049,0,0,105,0,-105
16050,0,0,66,0,-66
16051,1,1,890,1298,408
16052,1,0,62,0,-62
16053,1,0,65,0,-65
16054,1,1,943,1224,281
16055,0,0,8,0,-8
16056,1,0,48,0,-48
16057,0,0,80,0,-80
16058,1,1,278,2098,1820
16059,1,0,128,0,-128
16060,0,0,77,0,-77
16061,1,0,155,0,-155
16062,1,0,44,0,-44
16063,1,1,858,1259,401
16064,1,0,80,0,-80
16065,0,0,33,0,-33
16066,1,1,157,1216,1059
16067,0,0,30,0,-30
16068,1,1,148,1218,1070
16069,1,0,9,0,-9
16070,1,1,364,1265,901
16071,0,0,15,0,-15
16072,1,0,59,0,-59
16073,1,0,4,0,-4
16074,0,0,72,0,-72
16075,1,0,26,0,-26
16076,0,0,43,0,-43
16077,0,0,30,0,-30
16078,1,1,292,1306,1014
16079,0,0,152,0,-152
16080,1,0,67,0,-67
16081,1,1,101,1333,1232
16082,0,0,4,0,-4
16083,0,0,62,0,-62
16084,0,0,37,0,-37
16085,1,1,325,1629,1304
16086,0,0,28,0,-28
16087,1,0,20,0,-20
16088,1,1,292,1668,1376
16089,0,0,18,0,-18
16090,1,0,69,0,-69
16091,0,0,26,0,-26
16092,1,1,462,1630,1168
16093,1,1,276,1301,1025
16094,0,0,1,0,-1
16095,1,0,2,0,-2
16096,1,0,2,0,-2
16097,0,0,124,0,-124
16098,0,0,3,0,-3
16099,1,0,9,0,-9
16100,1,1,34,1244,1210
16101,0,0,54,0,-54
16102,1,1,960,8254,7294
16103,1,1,287,1216,929
16104,0,0,45,0,-45
16105,0,0,29,0,-29
16106,1,1,780,1379,599
16107,1,0,44,0,-44
16108,0,0,49,0,-49
16109,1,0,18,0,-18
16110,1,0,159,0,-159
16111,0,0,61,0,-61
16112,0,0,16,0,-16
16113,1,0,105,0,-105
16114,1,1,889,1404,515
16115,1,1,351,2912,2561
16116,1,0,15,0,-15
16117,1,0,51,0,-51
16118,1,0,115,0,-115
16119,1,1,488,1243,755
16120,1,1,28,1455,1427
16121,1,0,123,0,-123
16122,0,0,56,0,-56
16123,1,0,8,0,-8
16124,0,0,134,0,-134
16125,1,0,23,0,-23
16126,1,0,101,0,-101
16127,1,1,1092,2042,950
16128,1,1,405,1735,1330
16129,1,0,118,0,-118
16130,0,0,68,0,-68
16131,1,1,797,1286,489
16132,1,0,23,0,-23
16133,0,0,146,0,-146
16134,0,0,152,0,-152
16135,1,1,1237,1808,571
16136,1,1,751,2054,1303
16137,1,0,11,0,-11
16138,1,1,1566,1782,216
16139,0,0,27,0,-27
16140,0,0,76,0,-76
16141,1,0,90,0,-90
16142,1,1,665,1304,639
16143,1,1,943,1620,677
16144,0,0,84,0,-84
16145,1,1,1856,1384,-472
16146,1,1,461,1796,1335
16147,0,0,34,0,-34
16148,1,1,243,1404,1161
16149,0,0,37,0,-37
16150,0,0,2,0,-2
16151,0,0,87,0,-87
16152,1,0,39,0,-39
16153,1,0,17,0,-17
16154,0,0,21,0,-21
16155,0,0,81,0,-81
16156,0,0,14,0,-14
16157,1,1,889,1704,815
16158,0,0,71,0,-71
16159,1,1,87,1412,1325
16160,1,0,43,0,-43
16161,1,1,574,1328,754
16162,0,0,23,0,-23
16163,0,0,10,0,-10
16164,0,0,45,0,-45
16165,1,1,481,4050,3569
16166,0,0,1,0,-1
16167,1,0,8,0,-8
16168,1,1,258,1646,1388
16169,1,0,5,0,-5
16170,0,0,29,0,-29
16171,1,0,13,0,-13
16172,1,1,1047,1893,846
16173,1,1,801,1406,605
16174,1,1,657,1328,671
16175,1,0,42,0,-42
16176,1,1,57,1366,1309
16177,0,0,16,0,-16
16178,1,1,557,1382,825
16179,1,0,69,0,-69
16180,0,0,13,0,-13
16181,1,1,686,1308,622
16182,1,0,141,0,-141
16183,1,0,34,0,-34
16184,1,0,13,0,-13
16185,1,0,78,0,-78
16186,0,0,9,0,-9
16187,1,0,43,0,-43
16188,1,0,57,0,-57
16189,0,0,1,0,-1
16190,0,0,17,0,-17
16191,1,0,22,0,-22
16192,1,0,40,0,-40
16193,1,0,14,0,-14
16194,1,0,59,0,-59
16195,1,1,160,1456,1296
16196,1,0,77,0,-77
16197,0,0,35,0,-35
16198,1,0,36,0,-36
16199,0,0,17,0,-17
16200,0,0,13,0,-13
16201,0,0,66,0,-66
16202,1,0,129,0,-129
16203,0,0,26,0,-26
16204,1,0,58,0,-58
16205,0,0,45,0,-45
16206,1,0,0,0,0
16207,0,0,20,0,-20
16208,0,0,41,0,-41
16209,1,1,556,1473,917
16210,1,1,301,1441,1140
16211,0,0,3,0,-3
16212,0,0,59,0,-59
16213,0,0,58,0,-58
16214,1,0,23,0,-23
16215,0,0,53,0,-53
16216,1,1,916,1411,495
16217,0,0,0,0,0
16218,1,1,103,1213,1110
16219,1,1,846,2139,1293
16220,1,0,187,0,-187
16221,1,1,356,1249,893
16222,1,1,522,1527,1005
16223,0,0,55,0,-55
16224,0,0,1,0,-1
16225,1,0,22,0,-22
16226,1,1,145,1420,1275
16227,1,0,40,0,-40
16228,0,0,0,0,0
16229,1,1,351,1450,1099
16230,1,1,82,1697,1615
16231,1,1,159,1458,1299
16232,1,1,1167,1512,345
16233,1,1,1491,1339,-152
16234,0,0,9,0,-9
16235,0,0,171,0,-171
16236,1,0,103,0,-103
16237,1,0,43,0,-43
16238,1,1,280,1306,1026
16239,1,0,8,0,-8
16240,0,0,65,0,-65
16241,1,1,187,1860,1673
16242,1,0,54,0,-54
16243,0,0,42,0,-42
16244,0,0,85,0,-85
16245,1,1,284,1256,972
16246,0,0,0,0,0
16247,1,1,225,1205,980
16248,1,1,286,1209,923
16249,1,1,381,1567,1186
16250,0,0,6,0,-6
16251,1,0,58,0,-58
16252,1,0,96,0,-96
16253,1,1,563,1470,907
16254,1,1,2791,1897,-894
16255,1,0,97,0,-97
16256,1,1,334,1334,1000
16257,1,0,9,0,-9
16258,1,1,89,2049,1960
16259,0,0,35,0,-35
16260,1,0,15,0,-15
16261,1,0,108,0,-108
16262,1,1,175,1354,1179
16263,1,1,104,1533,1429
16264,1,1,457,2981,2524
16265,0,0,95,0,-95
16266,1,0,20,0,-20
16267,1,1,1317,1420,103
16268,1,0,2,0,-2
16269,1,0,65,0,-65
16270,1,0,47,0,-47
16271,0,0,0,0,0
16272,1,0,164,0,-164
16273,1,0,6,0,-6
16274,0,0,10,0,-10
16275,1,1,518,1341,823
16276,0,0,66,0,-66
16277,1,1,1620,1569,-51
16278,1,0,6,0,-6
16279,1,0,319,0,-319
16280,0,0,52,0,-52
16281,1,1,1101,1375,274
16282,0,0,23,0,-23
16283,1,1,206,1354,1148
16284,1,1,121,1480,1359
16285,1,1,327,1409,1082
16286,1,1,324,2080,1756
16287,0,0,19,0,-19
16288,1,0,22,0,-22
16289,0,0,20,0,-20
16290,1,0,102,0,-102
16291,1,0,74,0,-74
16292,1,0,53,0,-53
16293,1,1,132,1413,1281
16294,0,0,4,0,-4
16295,0,0,119,0,-119
16296,0,0,68,0,-68
16297,0,0,25,0,-25
16298,0,0,50,0,-50
16299,1,0,5,0,-5
16300,1,0,65,0,-65
16301,0,0,0,0,0
16302,1,0,66,0,-66
16303,1,0,0,0,0
16304,1,1,1095,1616,521
16305,1,0,20,0,-20
16306,1,1,660,2064,1404
16307,1,1,358,1324,966
16308,0,0,8,0,-8
16309,1,1,269,1264,995
16310,0,0,13,0,-13
16311,0,0,3,0,-3
16312,1,1,236,1331,1095
16313,1,1,1122,1333,211
16314,1,0,6,0,-6
16315,0,0,10,0,-10
16316,1,0,151,0,-151
16317,1,1,477,1654,1177
16318,0,0,16,0,-16
16319,1,1,224,3240,3016
16320,1,1,401,2131,1730
16321,1,1,946,1394,448
16322,0,0,150,0,-150
16323,1,1,318,1317,999
16324,1,0,63,0,-63
16325,1,0,38,0,-38
16326,0,0,7,0,-7
16327,1,0,63,0,-63
16328,0,0,70,0,-70
16329,1,1,186,1308,1122
16330,1,0,68,0,-68
16331,1,1,723,1376,653
16332,1,1,922,1305,383
16333,1,1,556,1299,743
16334,1,0,99,0,-99
16335,1,0,13,0,-13
16336,0,0,108,0,-108
16337,0,0,24,0,-24
16338,1,1,1386,1311,-75
16339,0,0,6,0,-6
16340,0,0,92,0,-92
16341,1,0,2,0,-2
16342,0,0,9,0,-9
16343,0,0,119,0,-119
16344,0,0,188,0,-188
16345,0,0,69,0,-69
16346,1,1,275,1373,1098
16347,1,1,219,1533,1314
16348,0,0,122,0,-122
16349,0,0,214,0,-214
16350,0,0,114,0,-114
16351,1,1,170,1625,1455
16352,1,0,107,0,-107
16353,0,0,62,0,-62
16354,1,1,363,1227,864
16355,1,1,140,1274,1134
16356,0,0,98,0,-98
16357,1,1,2196,1471,-725
16358,1,0,54,0,-54
16359,1,0,7,0,-7
16360,1,1,990,1955,965
16361,1,0,6,0,-6
16362,0,0,12,0,-12
16363,1,1,379,1492,1113
16364,1,1,956,1253,297
16365,1,0,13,0,-13
16366,1,1,259,1442,1183
16367,1,1,423,2055,1632
16368,0,0,9,0,-9
16369,1,1,163,1201,1038
16370,0,0,3,0,-3
16371,1,1,803,1251,448
16372,1,1,433,1506,1073
16373,0,0,13,0,-13
16374,1,0,45,0,-45
16375,1,0,55,0,-55
16376,0,0,14,0,-14
16377,0,0,153,0,-153
16378,1,0,97,0,-97
16379,0,0,22,0,-22
16380,1,0,143,0,-143
16381,1,0,14,0,-14
16382,1,1,336,1684,1348
16383,0,0,11,0,-11
16384,0,0,102,0,-102
16385,1,1,418,1200,782
16386,0,0,27,0,-27
16387,0,0,12,0,-12
16388,0,0,66,0,-66
16389,0,0,16,0,-16
16390,0,0,27,0,-27
16391,1,0,49,0,-49
16392,0,0,6,0,-6
16393,1,1,450,1242,792
16394,1,1,327,2254,1927
16395,1,1,341,1315,974
16396,1,0,90,0,-90
16397,0,0,116,0,-116
16398,1,1,930,1682,752
16399,1,1,165,1219,1054
16400,1,0,34,0,-34
16401,1,0,32,0,-32
16402,0,0,12,0,-12
16403,1,0,219,0,-219
16404,0,0,29,0,-29
16405,1,0,27,0,-27
16406,1,0,40,0,-40
16407,1,1,94,3540,3446
16408,0,0,70,0,-70
16409,0,0,44,0,-44
16410,1,1,109,1228,1119
16411,1,0,73,0,-73
16412,1,1,427,1764,1337
16413,0,0,5,0,-5
16414,0,0,48,0,-48
16415,1,1,348,1411,1063
16416,1,0,38,0,-38
16417,1,0,3,0,-3
16418,1,1,558,2241,1683
16419,0,0,67,0,-67
16420,0,0,127,0,-127
16421,1,1,185,1353,1168
16422,0,0,107,0,-107
16423,0,0,50,0,-50
16424,1,1,1298,1290,-8
16425,1,1,62,1627,1565
16426,0,0,43,0,-43
16427,1,0,46,0,-46
16428,1,1,1283,1297,14
16429,1,1,514,1204,690
16430,0,0,29,0,-29
16431,0,0,11,0,-11
16432,1,1,220,1321,1101
16433,1,1,278,1223,945
16434,0,0,52,0,-52
16435,0,0,36,0,-36
16436,1,1,1183,1539,356
16437,1,1,576,1847,1271
16438,1,1,1015,1498,483
16439,0,0,25,0,-25
16440,0,0,13,0,-13
16441,0,0,37,0,-37
16442,1,0,183,0,-183
16443,1,0,22,0,-22
16444,1,0,6,0,-6
16445,1,1,29,1379,1350
16446,1,0,3,0,-3
16447,0,0,39,0,-39
16448,1,1,922,1702,780
16449,1,0,191,0,-191
16450,1,0,4,0,-4
16451,1,0,115,0,-115
16452,1,0,5,0,-5
16453,1,0,0,0,0
16454,1,1,598,1392,794
16455,0,0,48,0,-48
16456,1,1,470,1274,804
16457,1,0,19,0,-19
16458,0,0,14,0,-14
16459,1,1,853,1689,836
16460,1,1,58,1250,1192
16461,0,0,92,0,-92
16462,0,0,175,0,-175
16463,0,0,9,0,-9
16464,1,0,16,0,-16
16465,1,0,58,0,-58
16466,0,0,25,0,-25
16467,1,0,18,0,-18
16468,1,0,42,0,-42
16469,1,1,63,1764,1701
16470,0,0,54,0,-54
16471,0,0,58,0,-58
16472,1,0,0,0,0
16473,0,0,108,0,-108
16474,1,1,89,1275,1186
16475,1,1,1460,1683,223
16476,0,0,26,0,-26
16477,1,0,11,0,-11
16478,0,0,43,0,-43
16479,0,0,83,0,-83
16480,0,0,29,0,-29
16481,0,0,35,0,-35
16482,1,0,223,0,-223
16483,1,0,33,0,-33
16484,1,1,1216,1614,398
16485,1,0,96,0,-96
16486,0,0,13,0,-13
16487,1,1,1867,1439,-428
16488,0,0,9,0,-9
16489,0,0,10,0,-10
16490,1,1,677,1205,528
16491,1,0,6,0,-6
16492,0,0,3,0,-3
16493,1,1,446,1644,1198
16494,1,0,89,0,-89
16495,1,1,687,1350,663
16496,1,0,233,0,-233
16497,0,0,17,0,-17
16498,0,0,10,0,-10
16499,1,0,6,0,-6
16500,0,0,44,0,-44
16501,0,0,7,0,-7
16502,0,0,57,0,-57
16503,1,0,68,0,-68
16504,1,0,97,0,-97
16505,0,0,65,0,-65
16506,1,0,8,0,-8
16507,0,0,111,0,-111
16508,0,0,42,0,-42
16509,1,1,394,2474,2080
16510,0,0,11,0,-11
16511,0,0,35,0,-35
16512,1,1,608,2019,1411
16513,1,0,3,0,-3
16514,1,1,432,1269,837
16515,1,0,18,0,-18
16516,0,0,94,0,-94
16517,1,0,151,0,-151
16518,1,0,27,0,-27
16519,1,1,529,1374,845
16520,1,1,272,1271,999
16521,1,1,404,1321,917
16522,1,1,239,1328,1089
16523,0,0,142,0,-142
16524,0,0,38,0,-38
16525,0,0,73,0,-73
16526,1,0,15,0,-15
16527,0,0,31,0,-31
16528,1,1,1063,1233,170
16529,1,0,62,0,-62
16530,1,1,477,1308,831
16531,1,0,9,0,-9
16532,0,0,70,0,-70
16533,0,0,61,0,-61
16534,0,0,13,0,-13
16535,0,0,194,0,-194
16536,0,0,67,0,-67
16537,1,1,598,1334,736
16538,1,1,632,1378,746
16539,0,0,8,0,-8
16540,0,0,8,0,-8
16541,0,0,30,0,-30
16542,1,1,1362,1629,267
16543,1,0,164,0,-164
16544,1,0,80,0,-80
16545,1,1,163,1719,1556
16546,1,0,52,0,-52
16547,1,0,65,0,-65
16548,0,0,37,0,-37
16549,0,0,5,0,-5
16550,0,0,50,0,-50
16551,0,0,124,0,-124
16552,1,1,274,6866,6592
16553,0,0,196,0,-196
16554,1,1,86,1325,1239
16555,1,0,1,0,-1
16556,1,0,31,0,-31
16557,1,1,719,1475,756
16558,1,0,48,0,-48
16559,1,1,158,1457,1299
16560,1,0,14,0,-14
16561,1,0,45,0,-45
16562,1,1,336,1227,891
16563,1,0,14,0,-14
16564,0,0,13,0,-13
16565,1,1,1765,1273,-492
16566,1,1,510,1932,1422
16567,1,0,146,0,-146
16568,0,0,22,0,-22
16569,0,0,18,0,-18
16570,0,0,13,0,-13
16571,1,1,260,1967,1707
16572,0,0,20,0,-20
16573,0,0,19,0,-19
16574,0,0,115,0,-115
16575,0,0,21,0,-21
16576,0,0,21,0,-21
16577,0,0,22,0,-22
16578,1,0,83,0,-83
16579,0,0,23,0,-23
16580,0,0,7,0,-7
16581,1,0,42,0,-42
16582,1,0,1,0,-1
16583,0,0,14,0,-14
16584,0,0,18,0,-18
16585,1,1,970,2629,1659
16586,0,0,64,0,-64
16587,1,0,14,0,-14
16588,1,0,83,0,-83
16589,1,1,335,1226,891
16590,1,0,6,0,-6
16591,0,0,63,0,-63
16592,1,0,16,0,-16
16593,1,0,58,0,-58
16594,1,1,397,1477,1080
16595,1,0,4,0,-4
16596,1,1,1824,1349,-475
16597,0,0,29,0,-29
16598,0,0,39,0,-39
16599,1,1,281,1259,978
16600,1,0,16,0,-16
16601,0,0,4,0,-4
16602,0,0,26,0,-26
16603,1,1,635,1331,696
16604,0,0,157,0,-157
16605,1,1,143,2351,2208
16606,1,0,40,0,-40
16607,0,0,5,0,-5
16608,1,1,1058,1699,641
16609,1,1,191,1404,1213
16610,1,1,307,2049,1742
16611,0,0,13,0,-13
16612,1,0,138,0,-138
16613,0,0,93,0,-93
16614,0,0,6,0,-6
16615,1,0,43,0,-43
16616,1,0,228,0,-228
16617,1,0,125,0,-125
16618,0,0,49,0,-49
16619,1,1,859,1215,356
16620,0,0,24,0,-24
16621,0,0,13,0,-13
16622,1,0,41,0,-41
16623,1,1,284,1279,995
16624,0,0,21,0,-21
16625,1,1,802,1560,758
16626,1,0,41,0,-41
16627,1,1,904,1482,578
16628,1,1,168,1287,1119
16629,0,0,33,0,-33
16630,0,0,28,0,-28
16631,1,0,24,0,-24
16632,1,1,78,1910,1832
16633,0,0,52,0,-52
16634,1,0,27,0,-27
16635,1,0,17,0,-17
16636,0,0,132,0,-132
16637,1,0,9,0,-9
16638,0,0,71,0,-71
16639,0,0,381,0,-381
16640,0,0,68,0,-68
16641,0,0,2,0,-2
16642,1,0,91,0,-91
16643,1,1,1829,1396,-433
16644,1,1,205,2264,2059
16645,1,0,37,0,-37
16646,1,1,185,1347,1162
16647,0,0,66,0,-66
16648,1,0,3,0,-3
16649,1,1,674,1484,810
16650,1,0,167,0,-167
16651,1,1,874,1300,426
16652,1,0,6,0,-6
16653,0,0,37,0,-37
16654,1,1,46,1438,1392
16655,1,1,1100,1353,253
16656,1,1,587,1347,760
16657,1,0,69,0,-69
16658,1,0,69,0,-69
16659,1,1,525,2480,1955
16660,0,0,189,0,-189
16661,0,0,9,0,-9
16662,1,0,36,0,-36
16663,1,1,367,1442,1075
16664,1,0,0,0,0
16665,1,1,169,1355,1186
16666,1,1,1040,1603,563
16667,1,0,24,0,-24
16668,0,0,8,0,-8
16669,0,0,0,0,0
16670,1,1,644,3135,2491
16671,0,0,4,0,-4
16672,1,1,520,1716,1196
16673,0,0,3,0,-3
16674,0,0,48,0,-48
16675,1,1,1277,1326,49
16676,1,0,0,0,0
16677,0,0,18,0,-18
16678,1,0,13,0,-13
16679,0,0,80,0,-80
16680,1,1,31,1721,1690
16681,1,1,178,1452,1274
16682,1,1,1321,1957,636
16683,1,0,125,0,-125
16684,0,0,80,0,-80
16685,1,0,109,0,-109
16686,1,1,382,1292,910
16687,1,0,106,0,-106
16688,1,0,76,0,-76
16689,1,1,1336,2235,899
16690,1,0,17,0,-17
16691,0,0,19,0,-19
16692,1,1,469,1371,902
16693,0,0,128,0,-128
16694,1,0,7,0,-7
16695,1,0,8,0,-8
16696,1,0,36,0,-36
16697,1,0,79,0,-79
16698,1,0,151,0,-151
16699,1,0,28,0,-28
16700,1,1,334,1238,904
16701,0,0,137,0,-137
16702,0,0,51,0,-51
16703,1,0,280,0,-280
16704,0,0,41,0,-41
16705,1,0,52,0,-52
16706,0,0,6,0,-6
16707,1,1,1474,1655,181
16708,1,1,139,1223,1084
16709,0,0,71,0,-71
16710,0,0,54,0,-54
16711,1,0,130,0,-130
16712,1,0,12,0,-12
16713,1,1,158,1501,1343
16714,1,1,829,1304,475
16715,0,0,9,0,-9
16716,1,1,277,1411,1134
16717,1,1,595,1309,714
16718,0,0,24,0,-24
16719,1,1,55,1760,1705
16720,1,1,1234,1215,-19
16721,1,1,1063,1286,223
16722,1,1,270,1299,1029
16723,1,0,33,0,-33
16724,0,0,75,0,-75
16725,0,0,170,0,-170
16726,0,0,43,0,-43
16727,0,0,157,0,-157
16728,1,1,452,1548,1096
16729,1,0,37,0,-37
16730,1,0,34,0,-34
16731,1,1,616,2355,1739
16732,1,0,11,0,-11
16733,0,0,110,0,-110
16734,0,0,74,0,-74
16735,0,0,73,0,-73
16736,1,1,703,1361,658
16737,1,0,14,0,-14
16738,0,0,7,0,-7
16739,0,0,21,0,-21
16740,1,0,6,0,-6
16741,0,0,185,0,-185
16742,0,0,9,0,-9
16743,0,0,30,0,-30
16744,0,0,34,0,-34
16745,1,1,402,2338,1936
16746,0,0,15,0,-15
16747,0,0,62,0,-62
16748,0,0,35,0,-35
16749,1,1,223,1327,1104
16750,1,0,10,0,-10
16751,1,0,63,0,-63
16752,1,0,0,0,0
16753,1,1,601,1218,617
16754,1,0,67,0,-67
16755,1,0,39,0,-39
16756,1,0,26,0,-26
16757,0,0,0,0,0
16758,1,1,633,1200,567
16759,1,0,136,0,-136
16760,1,1,116,1366,1250
16761,1,1,806,2638,1832
16762,1,0,7,0,-7
16763,0,0,49,0,-49
16764,0,0,11,0,-11
16765,0,0,5,0,-5
16766,1,1,367,1508,1141
16767,1,1,1134,1966,832
16768,1,0,5,0,-5
16769,1,0,3,0,-3
16770,0,0,15,0,-15
16771,1,1,119,1281,1162
16772,1,0,37,0,-37
16773,0,0,75,0,-75
16774,1,1,112,1362,1250
16775,1,1,1372,1324,-48
16776,0,0,62,0,-62
16777,0,0,8,0,-8
16778,1,1,213,1230,1017
16779,1,0,63,0,-63
16780,0,0,43,0,-43
16781,1,1,80,1209,1129
16782,1,1,1256,1492,236
16783,1,1,137,1495,1358
16784,0,0,146,0,-146
16785,1,0,24,0,-24
16786,1,0,33,0,-33
16787,0,0,18,0,-18
16788,1,0,20,0,-20
16789,0,0,37,0,-37
16790,0,0,166,0,-166
16791,1,1,346,1203,857
16792,1,1,279,1244,965
16793,1,1,41,1573,1532
16794,0,0,41,0,-41
16795,1,0,36,0,-36
16796,1,1,396,1626,1230
16797,1,1,326,1310,984
16798,0,0,12,0,-12
16799,0,0,30,0,-30
16800,1,0,39,0,-39
16801,0,0,117,0,-117
16802,1,0,53,0,-53
16803,0,0,16,0,-16
16804,0,0,71,0,-71
16805,1,1,157,1213,1056
16806,1,1,244,1698,1454
16807,0,0,182,0,-182
16808,0,0,14,0,-14
16809,1,0,16,0,-16
16810,0,0,54,0,-54
16811,1,1,360,1601,1241
16812,1,0,25,0,-25
16813,1,0,24,0,-24
16814,1,1,1511,1446,-65
16815,0,0,58,0,-58
16816,1,1,1243,1243,0
16817,0,0,1,0,-1
16818,1,1,118,1783,1665
16819,1,0,55,0,-55
16820,0,0,140,0,-140
16821,1,0,157,0,-157
16822,0,0,86,0,-86
16823,1,1,1641,1429,-212
16824,0,0,70,0,-70
16825,1,1,368,1373,1005
16826,1,1,604,1493,889
16827,1,1,321,1379,1058
16828,1,1,199,1203,1004
16829,1,1,17,1680,1663
16830,1,1,667,1360,693
16831,0,0,4,0,-4
16832,0,0,14,0,-14
16833,0,0,4,0,-4
16834,0,0,62,0,-62
16835,1,0,10,0,-10
16836,1,0,25,0,-25
16837,1,1,66,1286,1220
16838,1,0,2,0,-2
16839,0,0,24,0,-24
16840,0,0,81,0,-81
16841,1,1,484,1244,760
16842,1,1,30,1370,1340
16843,1,1,788,1554,766
16844,1,1,258,1307,1049
16845,1,1,916,1359,443
16846,0,0,15,0,-15
16847,1,1,520,1244,724
16848,1,1,126,1246,1120
16849,0,0,32,0,-32
16850,0,0,38,0,-38
16851,1,0,47,0,-47
16852,0,0,60,0,-60
16853,1,1,72,1366,1294
16854,0,0,35,0,-35
16855,1,1,247,1742,1495
16856,1,1,865,3474,2609
16857,1,1,158,1265,1107
16858,1,1,485,1461,976
16859,1,0,88,0,-88
16860,0,0,100,0,-100
16861,0,0,14,0,-14
16862,1,0,63,0,-63
16863,1,1,273,1263,990
16864,0,0,38,0,-38
16865,0,0,78,0,-78
16866,1,1,258,1262,1004
16867,0,0,12,0,-12
16868,0,0,35,0,-35
16869,0,0,83,0,-83
16870,1,1,202,2172,1970
16871,1,0,82,0,-82
16872,1,0,7,0,-7
16873,1,1,557,1312,755
16874,1,0,44,0,-44
16875,1,0,10,0,-10
16876,0,0,14,0,-14
16877,1,0,1,0,-1
16878,0,0,31,0,-31
16879,0,0,15,0,-15
16880,1,0,3,0,-3
16881,1,0,18,0,-18
16882,1,1,1708,1301,-407
16883,1,0,101,0,-101
16884,1,0,33,0,-33
16885,0,0,40,0,-40
16886,1,0,0,0,0
16887,1,0,91,0,-91
16888,0,0,18,0,-18
16889,0,0,54,0,-54
16890,0,0,0,0,0
16891,1,1,908,2359,1451
16892,0,0,15,0,-15
16893,0,0,105,0,-105
16894,1,1,617,1299,682
16895,1,0,19,0,-19
16896,1,0,81,0,-81
16897,1,0,34,0,-34
16898,0,0,53,0,-53
16899,1,1,93,1255,1162
16900,0,0,178,0,-178
16901,1,0,37,0,-37
16902,0,0,316,0,-316
16903,0,0,218,0,-218
16904,1,1,720,1933,1213
16905,1,0,2,0,-2
16906,1,1,12,1349,1337
16907,1,1,1151,1516,365
16908,0,0,202,0,-202
16909,0,0,5,0,-5
16910,0,0,37,0,-37
16911,0,0,20,0,-20
16912,0,0,152,0,-152
16913,1,1,441,2394,1953
16914,1,1,960,1317,357
16915,0,0,9,0,-9
16916,1,0,29,0,-29
16917,0,0,55,0,-55
16918,0,0,53,0,-53
16919,1,0,31,0,-31
16920,1,0,11,0,-11
16921,1,1,311,1554,1243
16922,1,1,318,1617,1299
16923,1,1,11,1357,1346
16924,1,0,14,0,-14
16925,1,1,669,1793,1124
16926,1,0,155,0,-155
16927,0,0,2,0,-2
16928,1,1,954,1599,645
16929,1,1,441,1393,952
16930,1,0,27,0,-27
16931,1,0,48,0,-48
16932,1,0,5,0,-5
16933,0,0,9,0,-9
16934,1,1,1181,1574,393
16935,1,0,39,0,-39
16936,0,0,3,0,-3
16937,1,0,134,0,-134
16938,1,1,247,1297,1050
16939,0,0,16,0,-16
16940,1,0,4,0,-4
16941,1,0,123,0,-123
16942,0,0,35,0,-35
16943,1,0,20,0,-20
16944,0,0,2,0,-2
16945,0,0,10,0,-10
16946,0,0,111,0,-111
16947,0,0,28,0,-28
16948,0,0,37,0,-37
16949,0,0,11,0,-11
16950,0,0,88,0,-88
16951,0,0,49,0,-49
16952,0,0,37,0,-37
16953,0,0,3,0,-3
16954,1,0,64,0,-64
16955,0,0,95,0,-95
16956,1,0,42,0,-42
16957,0,0,65,0,-65
16958,1,0,62,0,-62
16959,1,1,303,2118,1815
16960,0,0,38,0,-38
16961,0,0,43,0,-43
16962,1,0,39,0,-39
16963,0,0,27,0,-27
16964,1,1,624,1260,636
16965,1,0,12,0,-12
16966,1,1,849,3115,2266
16967,1,0,178,0,-178
16968,1,0,22,0,-22
16969,1,1,393,1551,1158
16970,1,0,45,0,-45
16971,0,0,32,0,-32
16972,1,1,233,1223,990
16973,0,0,79,0,-79
16974,1,1,23,1258,1235
16975,1,1,238,1232,994
16976,0,0,19,0,-19
16977,0,0,88,0,-88
16978,1,1,114,1353,1239
16979,1,0,44,0,-44
16980,1,1,200,1996,1796
16981,1,0,95,0,-95
16982,0,0,39,0,-39
16983,1,1,78,1488,1410
16984,0,0,36,0,-36
16985,1,1,496,1979,1483
16986,1,1,699,1312,613
16987,1,0,24,0,-24
16988,1,1,835,1420,585
16989,0,0,9,0,-9
16990,0,0,42,0,-42
16991,0,0,93,0,-93
16992,0,0,8,0,-8
16993,0,0,16,0,-16
16994,0,0,133,0,-133
16995,0,0,8,0,-8
16996,0,0,50,0,-50
16997,1,0,12,0,-12
16998,1,0,25,0,-25
16999,1,0,84,0,-84
17000,1,1,664,2539,1875
17001,1,1,518,1489,971
17002,1,1,354,1461,1107
17003,1,0,82,0,-82
17004,0,0,30,0,-30
17005,1,0,58,0,-58
17006,1,1,256,1369,1113
17007,0,0,14,0,-14
17008,1,1,299,1928,1629
17009,0,0,28,0,-28
17010,0,0,16,0,-16
17011,0,0,30,0,-30
17012,0,0,1,0,-1
17013,1,1,586,2271,1685
17014,0,0,44,0,-44
17015,1,0,4,0,-4
17016,0,0,1,0,-1
17017,0,0,28,0,-28
17018,1,0,23,0,-23
17019,0,0,51,0,-51
17020,1,0,33,0,-33
17021,0,0,47,0,-47
17022,1,0,346,0,-346
17023,1,1,728,1352,624
17024,0,0,85,0,-85
17025,0,0,90,0,-90
17026,0,0,154,0,-154
17027,1,0,7,0,-7
17028,0,0,7,0,-7
17029,1,1,56,1386,1330
17030,1,0,52,0,-52
17031,0,0,35,0,-35
17032,0,0,83,0,-83
17033,0,0,5,0,-5
17034,1,1,123,1428,1305
17035,1,1,253,1229,976
17036,1,0,10,0,-10
17037,1,1,119,1288,1169
17038,1,1,2017,1241,-776
17039,1,1,419,1439,1020
17040,1,0,11,0,-11
17041,1,1,323,1476,1153
17042,1,1,528,1384,856
17043,1,0,54,0,-54
17044,0,0,69,0,-69
17045,1,1,923,1425,502
17046,1,0,8,0,-8
17047,0,0,1,0,-1
17048,0,0,13,0,-13
17049,1,1,323,1739,1416
17050,0,0,29,0,-29
17051,0,0,61,0,-61
17052,0,0,21,0,-21
17053,1,0,105,0,-105
17054,1,0,86,0,-86
17055,0,0,38,0,-38
17056,0,0,321,0,-321
17057,1,1,387,1231,844
17058,0,0,7,0,-7
17059,1,0,44,0,-44
17060,0,0,9,0,-9
17061,1,0,6,0,-6
17062,0,0,24,0,-24
17063,0,0,32,0,-32
17064,0,0,68,0,-68
17065,1,0,19,0,-19
17066,0,0,7,0,-7
17067,1,0,12,0,-12
17068,1,1,246,1316,1070
17069,0,0,92,0,-92
17070,1,1,77,1465,1388
17071,1,0,92,0,-92
17072,1,1,212,1515,1303
17073,0,0,11,0,-11
17074,1,1,605,1494,889
17075,1,1,1119,1244,125
17076,1,1,434,1494,1060
17077,0,0,56,0,-56
17078,1,0,32,0,-32
17079,1,0,20,0,-20
17080,1,1,2191,1689,-502
17081,1,1,1030,1306,276
17082,1,0,32,0,-32
17083,1,0,18,0,-18
17084,1,1,2437,1476,-961
17085,1,1,490,1320,830
17086,0,0,1,0,-1
17087,0,0,74,0,-74
17088,0,0,41,0,-41
17089,1,0,2,0,-2
17090,1,0,13,0,-13
17091,1,0,21,0,-21
17092,1,0,76,0,-76
17093,1,1,1316,1314,-2
17094,0,0,56,0,-56
17095,1,1,635,2282,1647
17096,0,0,21,0,-21
17097,1,0,173,0,-173
17098,0,0,43,0,-43
17099,0,0,169,0,-169
17100,0,0,24,0,-24
17101,0,0,76,0,-76
17102,1,0,72,0,-72
17103,0,0,4,0,-4
17104,1,1,493,1318,825
17105,0,0,10,0,-10
17106,1,0,1,0,-1
17107,1,1,145,1447,1302
17108,1,1,1478,1716,238
17109,0,0,29,0,-29
17110,1,0,22,0,-22
17111,1,1,940,1954,1014
17112,0,0,28,0,-28
17113,1,0,3,0,-3
17114,1,1,624,1792,1168
17115,1,0,32,0,-32
17116,1,1,480,1861,1381
17117,1,0,19,0,-19
17118,0,0,92,0,-92
17119,1,1,228,1353,1125
17120,0,0,116,0,-116
17121,1,1,42,2454,2412
17122,1,0,9,0,-9
17123,0,0,102,0,-102
17124,1,1,294,1465,1171
17125,1,0,194,0,-194
17126,1,1,1532,1636,104
17127,1,1,211,1333,1122
17128,1,0,17,0,-17
17129,1,1,1460,2114,654
17130,1,1,242,1696,1454
17131,1,0,33,0,-33
17132,0,0,17,0,-17
17133,1,1,769,1214,445
17134,0,0,110,0,-110
17135,1,0,163,0,-163
17136,0,0,97,0,-97
17137,1,1,475,1275,800
17138,1,1,92,1247,1155
17139,1,1,619,1209,590
17140,0,0,160,0,-160
17141,0,0,22,0,-22
17142,1,0,152,0,-152
17143,0,0,35,0,-35
17144,0,0,54,0,-54
17145,1,0,12,0,-12
17146,1,0,5,0,-5
17147,0,0,1,0,-1
17148,1,0,25,0,-25
17149,1,1,230,1515,1285
17150,1,0,33,0,-33
17151,0,0,4,0,-4
17152,1,0,10,0,-10
17153,0,0,8,0,-8
17154,1,0,44,0,-44
17155,1,0,27,0,-27
17156,1,1,720,1250,530
17157,0,0,96,0,-96
17158,1,1,131,1784,1653
17159,0,0,32,0,-32
17160,0,0,12,0,-12
17161,1,0,59,0,-59
17162,0,0,13,0,-13
17163,0,0,1,0,-1
17164,0,0,92,0,-92
17165,1,1,255,1246,991
17166,0,0,3,0,-3
17167,1,0,170,0,-170
17168,0,0,1,0,-1
17169,1,0,5,0,-5
17170,0,0,28,0,-28
17171,0,0,39,0,-39
17172,1,1,510,1273,763
17173,0,0,42,0,-42
17174,1,0,151,0,-151
17175,1,0,19,0,-19
17176,1,1,155,1390,1235
17177,1,0,97,0,-97
17178,1,1,815,1256,441
17179,1,1,393,1362,969
17180,1,1,1032,1201,169
17181,0,0,49,0,-49
17182,0,0,2,0,-2
17183,1,1,140,1433,1293
17184,0,0,26,0,-26
17185,0,0,11,0,-11
17186,0,0,4,0,-4
17187,1,1,395,1343,948
17188,0,0,4,0,-4
17189,0,0,112,0,-112
17190,0,0,33,0,-33
17191,1,1,433,1400,967
17192,0,0,4,0,-4
17193,1,0,2,0,-2
17194,1,0,71,0,-71
17195,0,0,9,0,-9
17196,1,1,176,1944,1768
17197,0,0,2,0,-2
17198,1,1,257,1244,987
17199,0,0,7,0,-7
17200,1,0,1,0,-1
17201,1,0,11,0,-11
17202,1,1,1317,1504,187
17203,1,1,1626,1304,-322
17204,1,1,156,1472,1316
17205,0,0,41,0,-41
17206,0,0,24,0,-24
17207,0,0,36,0,-36
17208,0,0,126,0,-126
17209,0,0,92,0,-92
17210,1,1,255,1367,1112
17211,1,0,130,0,-130
17212,1,1,1375,1443,68
17213,1,1,785,1278,493
17214,0,0,6,0,-6
17215,0,0,128,0,-128
17216,1,1,144,1321,1177
17217,1,1,273,1530,1257
17218,0,0,0,0,0
17219,1,0,3,0,-3
17220,1,1,165,2112,1947
17221,1,1,40,2127,2087
17222,1,1,945,1299,354
17223,0,0,15,0,-15
17224,0,0,17,0,-17
17225,0,0,100,0,-100
17226,1,0,1,0,-1
17227,1,1,449,1226,777
17228,1,0,22,0,-22
17229,0,0,32,0,-32
17230,0,0,51,0,-51
17231,1,0,89,0,-89
17232,1,0,9,0,-9
17233,1,1,674,1608,934
17234,0,0,21,0,-21
17235,1,0,25,0,-25
17236,1,0,29,0,-29
17237,0,0,4,0,-4
17238,0,0,18,0,-18
17239,1,1,162,1426,1264
17240,1,0,36,0,-36
17241,0,0,138,0,-138
17242,1,0,35,0,-35
17243,0,0,24,0,-24
17244,1,1,248,1237,989
17245,0,0,120,0,-120
17246,1,0,12,0,-12
17247,1,1,814,1235,421
17248,1,1,159,1201,1042
17249,0,0,58,0,-58
17250,1,0,17,0,-17
17251,0,0,38,0,-38
17252,1,1,953,1469,516
17253,1,1,391,1379,988
17254,0,0,22,0,-22
17255,1,0,128,0,-128
17256,0,0,6,0,-6
17257,0,0,102,0,-102
17258,1,0,30,0,-30
17259,0,0,48,0,-48
17260,1,0,85,0,-85
17261,1,0,14,0,-14
17262,1,0,4,0,-4
17263,1,1,41,1283,1242
17264,1,0,42,0,-42
17265,0,0,17,0,-17
17266,0,0,44,0,-44
17267,1,0,40,0,-40
17268,1,1,1737,1275,-462
17269,0,0,42,0,-42
17270,1,0,38,0,-38
17271,1,0,15,0,-15
17272,1,1,353,1237,884
17273,1,0,72,0,-72
17274,1,0,8,0,-8
17275,0,0,172,0,-172
17276,0,0,25,0,-25
17277,1,0,33,0,-33
17278,1,1,799,1320,521
17279,0,0,27,0,-27
17280,1,0,25,0,-25
17281,1,1,913,1427,514
17282,1,0,0,0,0
17283,0,0,53,0,-53
17284,0,0,12,0,-12
17285,1,0,38,0,-38
17286,1,0,67,0,-67
17287,1,0,1,0,-1
17288,1,1,630,1648,1018
17289,0,0,116,0,-116
17290,0,0,40,0,-40
17291,1,1,607,1733,1126
17292,1,0,2,0,-2
17293,1,0,6,0,-6
17294,0,0,16,0,-16
17295,0,0,54,0,-54
17296,1,0,65,0,-65
17297,0,0,41,0,-41
17298,1,0,23,0,-23
17299,0,0,104,0,-104
17300,1,0,33,0,-33
17301,1,1,435,1507,1072
17302,1,1,258,1286,1028
17303,1,1,1568,1933,365
17304,0,0,107,0,-107
17305,0,0,16,0,-16
17306,0,0,11,0,-11
17307,0,0,30,0,-30
17308,1,0,40,0,-40
17309,1,1,211,1267,1056
17310,0,0,50,0,-50
17311,0,0,12,0,-12
17312,0,0,14,0,-14
17313,0,0,52,0,-52
17314,1,0,62,0,-62
17315,0,0,48,0,-48
17316,0,0,33,0,-33
17317,0,0,87,0,-87
17318,1,1,904,1256,352
17319,0,0,23,0,-23
17320,1,1,819,1430,611
17321,1,0,17,0,-17
17322,0,0,37,0,-37
17323,1,0,9,0,-9
17324,0,0,28,0,-28
17325,1,1,255,1408,1153
17326,0,0,54,0,-54
17327,1,1,66,1222,1156
17328,0,0,9,0,-9
17329,1,0,54,0,-54
17330,1,0,16,0,-16
17331,1,1,239,1244,1005
17332,1,1,499,1759,1260
17333,0,0,37,0,-37
17334,0,0,57,0,-57
17335,1,0,11,0,-11
17336,1,0,50,0,-50
17337,0,0,123,0,-123
17338,0,0,45,0,-45
17339,1,1,1683,2004,321
17340,0,0,8,0,-8
17341,1,0,44,0,-44
17342,1,0,64,0,-64
17343,0,0,37,0,-37
17344,1,0,52,0,-52
17345,0,0,35,0,-35
17346,1,1,362,1662,1300
17347,1,1,828,1383,555
17348,1,0,1,0,-1
17349,1,0,3,0,-3
17350,0,0,24,0,-24
17351,1,0,102,0,-102
17352,1,1,60,1824,1764
17353,1,0,22,0,-22
17354,1,0,28,0,-28
17355,0,0,49,0,-49
17356,1,0,55,0,-55
17357,1,1,725,1292,567
17358,0,0,88,0,-88
17359,1,0,34,0,-34
17360,1,1,523,1278,755
17361,1,0,253,0,-253
17362,0,0,75,0,-75
17363,0,0,33,0,-33
17364,1,1,848,1454,606
17365,1,0,4,0,-4
17366,1,1,1084,1921,837
17367,1,0,11,0,-11
17368,1,1,881,1588,707
17369,1,1,1459,1374,-85
17370,1,0,43,0,-43
17371,1,1,1044,2535,1491
17372,1,0,116,0,-116
17373,1,1,87,1556,1469
17374,0,0,56,0,-56
17375,1,0,78,0,-78
17376,1,0,89,0,-89
17377,1,0,38,0,-38
17378,0,0,24,0,-24
17379,1,0,50,0,-50
17380,0,0,1,0,-1
17381,0,0,103,0,-103
17382,0,0,34,0,-34
17383,0,0,63,0,-63
17384,0,0,26,0,-26
17385,1,0,49,0,-49
17386,1,1,860,1568,708
17387,1,0,163,0,-163
17388,1,0,1,0,-1
17389,1,1,971,1327,356
17390,1,1,469,2009,1540
17391,1,0,84,0,-84
17392,1,1,49,1347,1298
17393,1,0,104,0,-104
17394,1,1,1018,1268,250
17395,1,1,97,1915,1818
17396,0,0,53,0,-53
17397,0,0,32,0,-32
17398,1,0,17,0,-17
17399,0,0,35,0,-35
17400,0,0,98,0,-98
17401,0,0,0,0,0
17402,1,0,30,0,-30
17403,1,0,45,0,-45
17404,1,1,262,1354,1092
17405,0,0,8,0,-8
17406,1,0,4,0,-4
17407,0,0,182,0,-182
17408,1,0,32,0,-32
17409,0,0,28,0,-28
17410,1,1,719,1515,796
17411,0,0,183,0,-183
17412,1,0,22,0,-22
17413,0,0,22,0,-22
17414,0,0,43,0,-43
17415,1,1,212,1200,988
17416,0,0,43,0,-43
17417,1,0,37,0,-37
17418,0,0,37,0,-37
17419,0,0,27,0,-27
17420,1,1,648,1536,888
17421,1,0,51,0,-51
17422,0,0,66,0,-66
17423,0,0,8,0,-8
17424,0,0,55,0,-55
17425,0,0,44,0,-44
17426,1,0,12,0,-12
17427,0,0,1,0,-1
17428,0,0,4,0,-4
17429,1,0,7,0,-7
17430,1,1,354,1702,1348
17431,0,0,77,0,-77
17432,1,1,212,1492,1280
17433,0,0,7,0,-7
17434,1,1,528,1206,678
17435,1,0,51,0,-51
17436,1,1,733,1304,571
17437,0,0,67,0,-67
17438,1,1,109,1512,1403
17439,0,0,38,0,-38
17440,1,1,647,1572,925
17441,1,1,334,1331,997
17442,1,1,242,1250,1008
17443,1,1,830,2455,1625
17444,1,1,435,1489,1054
17445,0,0,18,0,-18
17446,1,1,12,1360,1348
17447,1,0,18,0,-18
17448,0,0,6,0,-6
17449,1,0,21,0,-21
17450,1,0,9,0,-9
17451,0,0,72,0,-72
17452,1,1,1079,1387,308
17453,1,1,189,2396,2207
17454,1,1,689,1321,632
17455,1,0,34,0,-34
17456,1,0,21,0,-21
17457,1,0,112,0,-112
17458,1,0,111,0,-111
17459,0,0,30,0,-30
17460,1,0,34,0,-34
17461,0,0,71,0,-71
17462,0,0,21,0,-21
17463,1,0,5,0,-5
17464,1,0,29,0,-29
17465,1,0,16,0,-16
17466,0,0,1,0,-1
17467,0,0,26,0,-26
17468,0,0,17,0,-17
17469,0,0,22,0,-22
17470,0,0,51,0,-51
17471,1,1,584,1340,756
17472,0,0,23,0,-23
17473,1,1,286,2782,2496
17474,1,0,13,0,-13
17475,0,0,193,0,-193
17476,1,1,605,1777,1172
17477,0,0,58,0,-58
17478,1,1,375,1424,1049
17479,1,0,45,0,-45
17480,1,0,9,0,-9
17481,1,0,34,0,-34
17482,1,0,40,0,-40
17483,1,0,19,0,-19
17484,1,0,122,0,-122
17485,0,0,54,0,-54
17486,1,0,62,0,-62
17487,1,0,0,0,0
17488,1,1,292,1583,1291
17489,1,0,5,0,-5
17490,0,0,67,0,-67
17491,1,0,16,0,-16
17492,1,1,171,1274,1103
17493,1,0,60,0,-60
17494,1,1,342,1413,1071
17495,1,1,151,2004,1853
17496,0,0,220,0,-220
17497,0,0,59,0,-59
17498,1,1,106,2447,2341
17499,0,0,81,0,-81
17500,1,0,48,0,-48
17501,0,0,26,0,-26
17502,1,1,1383,1549,166
17503,1,1,1268,1290,22
17504,1,0,35,0,-35
17505,1,0,9,0,-9
17506,1,0,49,0,-49
17507,1,0,3,0,-3
17508,0,0,109,0,-109
17509,1,0,19,0,-19
17510,0,0,175,0,-175
17511,0,0,48,0,-48
17512,1,0,0,0,0
17513,1,0,98,0,-98
17514,0,0,21,0,-21
17515,1,1,264,1451,1187
17516,1,0,14,0,-14
17517,1,0,168,0,-168
17518,1,1,431,2639,2208
17519,1,1,563,2285,1722
17520,1,0,1,0,-1
17521,1,1,79,1988,1909
17522,0,0,21,0,-21
17523,0,0,8,0,-8
17524,0,0,3,0,-3
17525,1,1,161,1840,1679
17526,0,0,24,0,-24
17527,1,1,279,1723,1444
17528,1,1,993,1326,333
17529,0,0,64,0,-64
17530,0,0,42,0,-42
17531,0,0,26,0,-26
17532,1,1,59,1377,1318
17533,1,1,1507,1224,-283
17534,1,0,1,0,-1
17535,1,1,357,1212,855
17536,1,0,24,0,-24
17537,1,1,1021,1314,293
17538,1,1,783,1639,856
17539,0,0,29,0,-29
17540,1,1,89,1599,1510
17541,1,0,121,0,-121
17542,1,0,26,0,-26
17543,1,1,72,2071,1999
17544,0,0,30,0,-30
17545,1,1,301,2530,2229
17546,0,0,19,0,-19
17547,0,0,24,0,-24
17548,1,1,159,1391,1232
17549,0,0,129,0,-129
17550,0,0,126,0,-126
17551,1,0,25,0,-25
17552,0,0,13,0,-13
17553,0,0,21,0,-21
17554,0,0,5,0,-5
17555,1,1,403,1272,869
17556,0,0,74,0,-74
17557,0,0,42,0,-42
17558,1,1,1319,1733,414
17559,0,0,30,0,-30
17560,1,0,89,0,-89
17561,1,0,39,0,-39
17562,1,1,1009,1207,198
17563,1,1,724,1348,624
17564,1,0,18,0,-18
17565,0,0,26,0,-26
17566,0,0,56,0,-56
17567,1,0,39,0,-39
17568,1,1,976,1312,336
17569,0,0,7,0,-7
17570,1,0,104,0,-104
17571,1,0,107,0,-107
17572,1,1,687,1705,1018
17573,0,0,17,0,-17
17574,1,0,34,0,-34
17575,0,0,71,0,-71
17576,1,0,13,0,-13
17577,0,0,14,0,-14
17578,1,0,40,0,-40
17579,0,0,14,0,-14
17580,0,0,17,0,-17
17581,1,1,502,1293,791
17582,0,0,8,0,-8
17583,1,1,480,1883,1403
17584,1,1,130,1552,1422
17585,1,0,11,0,-11
17586,0,0,48,0,-48
17587,1,0,19,0,-19
17588,0,0,1,0,-1
17589,1,0,93,0,-93
17590,1,0,140,0,-140
17591,1,1,616,2093,1477
17592,0,0,59,0,-59
17593,1,0,99,0,-99
17594,1,1,950,1349,399
17595,1,1,139,1413,1274
17596,1,0,39,0,-39
17597,1,1,571,1341,770
17598,1,0,94,0,-94
17599,1,1,555,1427,872
17600,0,0,7,0,-7
17601,1,0,6,0,-6
17602,0,0,6,0,-6
17603,1,1,409,3099,2690
17604,1,0,3,0,-3
17605,0,0,7,0,-7
17606,0,0,57,0,-57
17607,1,1,547,1222,675
17608,0,0,15,0,-15
17609,1,1,952,1817,865
17610,0,0,66,0,-66
17611,1,0,3,0,-3
17612,1,1,117,1286,1169
17613,1,0,5,0,-5
17614,1,1,736,1218,482
17615,1,0,0,0,0
17616,1,0,14,0,-14
17617,0,0,47,0,-47
17618,1,1,407,1297,890
17619,1,1,98,1385,1287
17620,1,1,1261,1336,75
17621,1,1,1079,1409,330
17622,1,1,47,1303,1256
17623,1,0,46,0,-46
17624,0,0,6,0,-6
17625,1,0,69,0,-69
17626,1,1,95,2224,2129
17627,1,0,3,0,-3
17628,1,1,322,1329,1007
17629,0,0,122,0,-122
17630,1,0,18,0,-18
17631,1,0,10,0,-10
17632,1,1,183,1293,1110
17633,0,0,51,0,-51
17634,0,0,35,0,-35
17635,1,1,1189,1932,743
17636,1,0,54,0,-54
17637,0,0,101,0,-101
17638,0,0,2,0,-2
17639,1,0,13,0,-13
17640,1,0,178,0,-178
17641,1,0,7,0,-7
17642,1,0,3,0,-3
17643,1,1,165,1358,1193
17644,1,1,998,1202,204
17645,1,0,22,0,-22
17646,0,0,106,0,-106
17647,1,0,4,0,-4
17648,0,0,12,0,-12
17649,1,1,428,1392,964
17650,1,0,26,0,-26
17651,1,0,63,0,-63
17652,1,1,302,1704,1402
17653,1,1,837,1274,437
17654,1,1,418,2100,1682
17655,1,1,815,1426,611
17656,0,0,71,0,-71
17657,1,0,16,0,-16
17658,1,1,90,1716,1626
17659,1,0,123,0,-123
17660,1,0,11,0,-11
17661,1,0,14,0,-14
17662,1,0,5,0,-5
17663,1,1,1615,1706,91
17664,1,0,5,0,-5
17665,1,1,113,1276,1163
17666,1,1,270,1303,1033
17667,1,0,10,0,-10
17668,0,0,12,0,-12
17669,1,1,17,1764,1747
17670,0,0,92,0,-92
17671,1,0,19,0,-19
17672,0,0,59,0,-59
17673,0,0,202,0,-202
17674,0,0,27,0,-27
17675,1,0,67,0,-67
17676,0,0,114,0,-114
17677,0,0,34,0,-34
17678,0,0,65,0,-65
17679,1,0,23,0,-23
17680,0,0,50,0,-50
17681,0,0,38,0,-38
17682,0,0,32,0,-32
17683,1,1,583,1420,837
17684,1,1,292,1245,953
17685,1,0,107,0,-107
17686,1,0,43,0,-43
17687,1,0,42,0,-42
17688,0,0,32,0,-32
17689,1,1,605,1643,1038
17690,1,1,674,1300,626
17691,1,1,656,2365,1709
17692,0,0,111,0,-111
17693,0,0,5,0,-5
17694,1,0,63,0,-63
17695,1,1,79,1491,1412
17696,0,0,31,0,-31
17697,0,0,93,0,-93
17698,0,0,34,0,-34
17699,1,0,0,0,0
17700,1,1,1441,1281,-160
17701,1,0,92,0,-92
17702,0,0,60,0,-60
17703,1,1,614,1329,715
17704,1,0,75,0,-75
17705,1,1,55,1305,1250
17706,1,1,305,1607,1302
17707,0,0,1,0,-1
17708,0,0,119,0,-119
17709,0,0,0,0,0
17710,0,0,81,0,-81
17711,1,0,22,0,-22
17712,1,1,277,1679,1402
17713,0,0,8,0,-8
17714,0,0,8,0,-8
17715,1,0,4,0,-4
17716,1,1,113,1346,1233
17717,0,0,28,0,-28
17718,1,0,14,0,-14
17719,0,0,43,0,-43
17720,0,0,105,0,-105
17721,0,0,51,0,-51
17722,0,0,12,0,-12
17723,1,0,87,0,-87
17724,1,0,66,0,-66
17725,1,0,18,0,-18
17726,0,0,69,0,-69
17727,0,0,24,0,-24
17728,1,1,638,1223,585
17729,0,0,85,0,-85
17730,1,0,35,0,-35
17731,1,1,1096,1323,227
17732,1,1,1803,1202,-601
17733,1,0,54,0,-54
17734,1,0,61,0,-61
17735,1,0,39,0,-39
17736,0,0,35,0,-35
17737,0,0,6,0,-6
17738,0,0,9,0,-9
17739,1,1,1037,1238,201
17740,0,0,32,0,-32
17741,0,0,16,0,-16
17742,1,1,568,1519,951
17743,1,0,11,0,-11
17744,1,1,197,1354,1157
17745,1,1,535,1931,1396
17746,1,0,40,0,-40
17747,0,0,67,0,-67
17748,1,0,26,0,-26
17749,0,0,14,0,-14
17750,1,1,431,1275,844
17751,1,0,34,0,-34
17752,1,0,197,0,-197
17753,1,0,65,0,-65
17754,1,0,10,0,-10
17755,1,0,3,0,-3
17756,1,1,185,1329,1144
17757,0,0,85,0,-85
17758,0,0,0,0,0
17759,0,0,27,0,-27
17760,1,1,321,1448,1127
17761,0,0,3,0,-3
17762,1,0,16,0,-16
17763,1,1,166,1217,1051
17764,0,0,20,0,-20
17765,1,1,352,1556,1204
17766,0,0,17,0,-17
17767,0,0,48,0,-48
17768,0,0,116,0,-116
17769,0,0,79,0,-79
17770,0,0,27,0,-27
17771,1,1,206,2008,1802
17772,1,0,34,0,-34
17773,1,0,65,0,-65
17774,1,1,86,1216,1130
17775,1,1,2580,1271,-1309
17776,1,0,70,0,-70
17777,0,0,36,0,-36
17778,0,0,46,0,-46
17779,0,0,0,0,0
17780,0,0,27,0,-27
17781,1,0,34,0,-34
17782,1,0,15,0,-15
17783,0,0,115,0,-115
17784,1,1,1664,1276,-388
17785,1,0,22,0,-22
17786,1,0,62,0,-62
17787,1,1,544,1265,721
17788,1,0,81,0,-81
17789,1,1,221,1222,1001
17790,1,0,29,0,-29
17791,1,0,9,0,-9
17792,1,1,1014,1205,191
17793,0,0,23,0,-23
17794,0,0,39,0,-39
17795,1,1,286,1232,946
17796,0,0,108,0,-108
17797,0,0,16,0,-16
17798,0,0,10,0,-10
17799,1,0,15,0,-15
17800,1,0,108,0,-108
17801,1,0,27,0,-27
17802,1,0,37,0,-37
17803,1,1,1608,1326,-282
17804,1,0,10,0,-10
17805,1,0,42,0,-42
17806,1,0,40,0,-40
17807,1,0,63,0,-63
17808,0,0,2,0,-2
17809,1,0,10,0,-10
17810,0,0,1,0,-1
17811,0,0,34,0,-34
17812,1,1,149,1298,1149
17813,0,0,29,0,-29
17814,0,0,64,0,-64
17815,1,0,31,0,-31
17816,0,0,35,0,-35
17817,0,0,14,0,-14
17818,1,0,11,0,-11
17819,1,0,83,0,-83
17820,0,0,58,0,-58
17821,1,0,10,0,-10
17822,1,1,322,1222,900
17823,0,0,14,0,-14
17824,1,0,5,0,-5
17825,1,0,138,0,-138
17826,1,0,166,0,-166
17827,0,0,7,0,-7
17828,1,0,150,0,-150
17829,1,1,389,2054,1665
17830,1,1,1785,2385,600
17831,1,1,867,1425,558
17832,1,0,7,0,-7
17833,0,0,125,0,-125
17834,1,0,45,0,-45
17835,1,0,59,0,-59
17836,0,0,53,0,-53
17837,1,0,2,0,-2
17838,0,0,36,0,-36
17839,1,1,25,1209,1184
17840,1,1,170,1520,1350
17841,0,0,25,0,-25
17842,0,0,36,0,-36
17843,1,1,264,1324,1060
17844,1,1,349,1922,1573
17845,0,0,20,0,-20
17846,1,1,271,4494,4223
17847,1,1,218,2450,2232
17848,0,0,64,0,-64
17849,0,0,12,0,-12
17850,0,0,47,0,-47
17851,1,0,1,0,-1
17852,1,0,3,0,-3
17853,1,1,1511,1633,122
17854,0,0,164,0,-164
17855,0,0,10,0,-10
17856,1,1,102,1280,1178
17857,0,0,36,0,-36
17858,1,0,135,0,-135
17859,1,1,709,1268,559
17860,1,1,1888,1212,-676
17861,1,0,19,0,-19
17862,1,1,76,1422,1346
17863,1,1,583,1735,1152
17864,0,0,9,0,-9
17865,0,0,48,0,-48
17866,1,0,14,0,-14
17867,0,0,40,0,-40
17868,1,0,8,0,-8
17869,0,0,17,0,-17
17870,1,1,295,1336,1041
17871,0,0,73,0,-73
17872,0,0,28,0,-28
17873,1,0,5,0,-5
17874,0,0,56,0,-56
17875,1,0,22,0,-22
17876,1,1,880,1416,536
17877,0,0,27,0,-27
17878,1,0,34,0,-34
17879,1,0,14,0,-14
17880,1,1,1206,2243,1037
17881,1,0,183,0,-183
17882,1,1,1005,1682,677
17883,1,0,0,0,0
17884,1,0,58,0,-58
17885,1,0,63,0,-63
17886,0,0,22,0,-22
17887,0,0,5,0,-5
17888,1,1,981,1396,415
17889,1,1,1976,1249,-727
17890,0,0,35,0,-35
17891,1,0,10,0,-10
17892,0,0,53,0,-53
17893,1,0,53,0,-53
17894,1,1,682,3181,2499
17895,0,0,128,0,-128
17896,0,0,25,0,-25
17897,1,1,58,1273,1215
17898,1,1,159,1537,1378
17899,1,1,15,1219,1204
17900,0,0,50,0,-50
17901,1,0,60,0,-60
17902,0,0,9,0,-9
17903,0,0,41,0,-41
17904,0,0,12,0,-12
17905,1,0,14,0,-14
17906,1,0,70,0,-70
17907,1,0,63,0,-63
17908,0,0,63,0,-63
17909,1,1,350,2254,1904
17910,1,0,8,0,-8
17911,0,0,143,0,-143
17912,1,0,82,0,-82
17913,0,0,34,0,-34
17914,1,0,51,0,-51
17915,1,0,107,0,-107
17916,1,1,244,1568,1324
17917,1,1,74,1508,1434
17918,0,0,0,0,0
17919,1,0,76,0,-76
17920,1,0,121,0,-121
17921,1,0,116,0,-116
17922,1,0,69,0,-69
17923,1,1,1589,1365,-224
17924,1,0,32,0,-32
17925,1,1,595,1377,782
17926,1,1,486,1235,749
17927,0,0,24,0,-24
17928,1,1,155,1428,1273
17929,1,0,26,0,-26
17930,1,0,1,0,-1
17931,0,0,134,0,-134
17932,0,0,30,0,-30
17933,1,1,497,2113,1616
17934,0,0,13,0,-13
17935,1,1,930,1631,701
17936,0,0,27,0,-27
17937,1,0,43,0,-43
17938,1,0,27,0,-27
17939,0,0,53,0,-53
17940,0,0,8,0,-8
17941,0,0,140,0,-140
17942,1,0,10,0,-10
17943,1,1,850,1324,474
17944,1,1,295,1279,984
17945,1,0,74,0,-74
17946,0,0,63,0,-63
17947,1,0,113,0,-113
17948,1,0,89,0,-89
17949,1,1,47,1318,1271
17950,1,0,54,0,-54
17951,1,1,424,1458,1034
17952,0,0,86,0,-86
17953,0,0,11,0,-11
17954,0,0,72,0,-72
17955,1,1,507,1429,922
17956,1,0,29,0,-29
17957,1,1,348,1773,1425
17958,1,0,84,0,-84
17959,0,0,13,0,-13
17960,1,1,1689,2003,314
17961,0,0,35,0,-35
17962,1,1,927,1389,462
17963,0,0,14,0,-14
17964,1,1,119,1966,1847
17965,0,0,100,0,-100
17966,1,1,549,1238,689
17967,1,1,270,1501,1231
17968,0,0,19,0,-19
17969,1,0,85,0,-85
17970,0,0,1,0,-1
17971,0,0,127,0,-127
17972,1,0,6,0,-6
17973,1,0,16,0,-16
17974,1,1,1883,1271,-612
17975,1,0,106,0,-106
17976,1,1,123,1561,1438
17977,0,0,57,0,-57
17978,1,0,55,0,-55
17979,0,0,49,0,-49
17980,0,0,39,0,-39
17981,1,1,417,1696,1279
17982,1,0,65,0,-65
17983,1,0,177,0,-177
17984,0,0,14,0,-14
17985,1,1,1000,1480,480
17986,0,0,64,0,-64
17987,0,0,27,0,-27
17988,0,0,26,0,-26
17989,0,0,53,0,-53
17990,1,0,71,0,-71
17991,1,1,699,1207,508
17992,1,0,11,0,-11
17993,0,0,40,0,-40
17994,0,0,19,0,-19
17995,0,0,1,0,-1
17996,0,0,16,0,-16
17997,0,0,99,0,-99
17998,0,0,0,0,0
17999,1,0,17,0,-17
18000,0,0,56,0,-56
18001,1,1,52,1200,1148
18002,0,0,160,0,-160
18003,1,1,52,2041,1989
18004,0,0,39,0,-39
18005,1,0,29,0,-29
18006,1,1,1059,1592,533
18007,0,0,56,0,-56
18008,0,0,22,0,-22
18009,0,0,13,0,-13
18010,1,0,71,0,-71
18011,1,1,326,1285,959
18012,0,0,59,0,-59
18013,1,0,46,0,-46
18014,1,0,36,0,-36
18015,1,0,76,0,-76
18016,1,1,398,3110,2712
18017,0,0,22,0,-22
18018,0,0,111,0,-111
18019,1,1,238,1427,1189
18020,0,0,91,0,-91
18021,1,1,690,1278,588
18022,0,0,239,0,-239
18023,1,1,555,1296,741
18024,1,0,109,0,-109
18025,1,1,158,2018,1860
18026,0,0,2,0,-2
18027,0,0,0,0,0
18028,0,0,65,0,-65
18029,1,1,91,1246,1155
18030,0,0,30,0,-30
18031,1,1,259,1560,1301
18032,0,0,7,0,-7
18033,0,0,43,0,-43
18034,1,0,94,0,-94
18035,0,0,157,0,-157
18036,1,0,51,0,-51
18037,1,1,62,1242,1180
18038,1,0,72,0,-72
18039,1,1,1612,1215,-397
18040,1,1,37,1780,1743
18041,0,0,170,0,-170
18042,1,1,1413,1472,59
18043,1,0,59,0,-59
18044,1,0,67,0,-67
18045,1,0,1,0,-1
18046,0,0,54,0,-54
18047,1,1,87,2094,2007
18048,0,0,33,0,-33
18049,1,1,85,1306,1221
18050,0,0,8,0,-8
18051,1,0,34,0,-34
18052,1,1,68,1315,1247
18053,1,0,89,0,-89
18054,0,0,16,0,-16
18055,1,0,71,0,-71
18056,1,0,29,0,-29
18057,1,0,51,0,-51
18058,1,0,9,0,-9
18059,1,1,602,1361,759
18060,0,0,31,0,-31
18061,1,0,4,0,-4
18062,1,0,19,0,-19
18063,1,0,56,0,-56
18064,0,0,12,0,-12
18065,0,0,30,0,-30
18066,0,0,8,0,-8
18067,1,1,466,1376,910
18068,1,1,659,1208,549
18069,1,1,296,1410,1114
18070,0,0,83,0,-83
18071,1,0,32,0,-32
18072,0,0,27,0,-27
18073,1,0,57,0,-57
18074,0,0,5,0,-5
18075,1,1,289,1716,1427
18076,1,1,628,1302,674
18077,1,1,305,1214,909
18078,1,1,443,1676,1233
18079,0,0,14,0,-14
18080,1,0,135,0,-135
18081,1,1,87,2224,2137
18082,1,1,680,1339,659
18083,0,0,48,0,-48
18084,0,0,84,0,-84
18085,1,1,1186,1478,292
18086,1,0,48,0,-48
18087,0,0,123,0,-123
18088,1,0,21,0,-21
18089,0,0,6,0,-6
18090,1,0,28,0,-28
18091,0,0,42,0,-42
18092,1,0,34,0,-34
18093,0,0,109,0,-109
18094,1,0,47,0,-47
18095,1,1,324,1540,1216
18096,0,0,66,0,-66
18097,1,1,451,2017,1566
18098,1,1,1335,1971,636
18099,0,0,4,0,-4
18100,1,1,846,1237,391
18101,0,0,21,0,-21
18102,1,0,72,0,-72
18103,1,0,31,0,-31
18104,0,0,2,0,-2
18105,1,0,190,0,-190
18106,0,0,18,0,-18
18107,0,0,18,0,-18
18108,0,0,29,0,-29
18109,1,0,57,0,-57
18110,1,0,7,0,-7
18111,1,1,548,1213,665
18112,1,1,560,1544,984
18113,1,0,103,0,-103
18114,0,0,11,0,-11
18115,0,0,96,0,-96
18116,0,0,9,0,-9
18117,1,0,14,0,-14
18118,0,0,49,0,-49
18119,1,0,10,0,-10
18120,0,0,9,0,-9
18121,1,0,55,0,-55
18122,0,0,17,0,-17
18123,1,0,131,0,-131
18124,0,0,13,0,-13
18125,0,0,23,0,-23
18126,1,0,25,0,-25
18127,1,1,100,1358,1258
18128,0,0,80,0,-80
18129,1,0,20,0,-20
18130,1,0,82,0,-82
18131,1,0,85,0,-85
18132,0,0,121,0,-121
18133,1,0,61,0,-61
18134,1,1,74,1538,1464
18135,0,0,3,0,-3
18136,1,0,0,0,0
18137,0,0,5,0,-5
18138,0,0,46,0,-46
18139,0,0,110,0,-110
18140,0,0,59,0,-59
18141,1,0,138,0,-138
18142,0,0,16,0,-16
18143,1,0,22,0,-22
18144,0,0,22,0,-22
18145,1,1,1478,1743,265
18146,1,0,56,0,-56
18147,1,1,380,1463,1083
18148,1,0,3,0,-3
18149,1,1,1581,2589,1008
18150,1,0,1,0,-1
18151,1,1,152,1339,1187
18152,1,1,235,1513,1278
18153,1,0,2,0,-2
18154,0,0,52,0,-52
18155,1,0,30,0,-30
18156,1,1,152,1839,1687
18157,1,1,402,1499,1097
18158,1,0,3,0,-3
18159,1,1,580,1272,692
18160,0,0,153,0,-153
18161,1,0,15,0,-15
18162,0,0,19,0,-19
18163,1,0,29,0,-29
18164,0,0,51,0,-51
18165,1,1,866,2150,1284
18166,0,0,126,0,-126
18167,1,1,849,1342,493
18168,0,0,116,0,-116
18169,1,0,21,0,-21
18170,1,0,7,0,-7
18171,0,0,10,0,-10
18172,1,0,3,0,-3
18173,0,0,70,0,-70
18174,1,0,40,0,-40
18175,1,1,167,1535,1368
18176,0,0,38,0,-38
18177,1,1,1881,1293,-588
18178,1,0,11,0,-11
18179,0,0,21,0,-21
18180,1,0,81,0,-81
18181,0,0,25,0,-25
18182,0,0,10,0,-10
18183,0,0,18,0,-18
18184,0,0,60,0,-60
18185,0,0,3,0,-3
18186,0,0,126,0,-126
18187,1,0,9,0,-9
18188,1,0,179,0,-179
18189,1,1,1139,1499,360
18190,0,0,58,0,-58
18191,0,0,134,0,-134
18192,0,0,32,0,-32
18193,1,0,1,0,-1
18194,1,1,608,1280,672
18195,1,1,285,1483,1198
18196,1,0,31,0,-31
18197,1,1,206,1486,1280
18198,1,1,280,1258,978
18199,1,0,16,0,-16
18200,0,0,30,0,-30
18201,0,0,86,0,-86
18202,1,0,33,0,-33
18203,0,0,10,0,-10
18204,1,1,482,1536,1054
18205,1,1,79,2445,2366
18206,1,1,1011,2778,1767
18207,0,0,272,0,-272
18208,0,0,54,0,-54
18209,0,0,19,0,-19
18210,1,0,3,0,-3
18211,0,0,43,0,-43
18212,1,0,31,0,-31
18213,1,1,175,1738,1563
18214,0,0,27,0,-27
18215,1,0,63,0,-63
18216,1,1,158,1486,1328
18217,1,0,4,0,-4
18218,0,0,27,0,-27
18219,1,0,80,0,-80
18220,0,0,28,0,-28
18221,0,0,30,0,-30
18222,0,0,1,0,-1
18223,1,1,218,1492,1274
18224,0,0,80,0,-80
18225,0,0,4,0,-4
18226,0,0,21,0,-21
18227,0,0,53,0,-53
18228,1,0,45,0,-45
18229,1,0,89,0,-89
18230,0,0,46,0,-46
18231,0,0,35,0,-35
18232,0,0,37,0,-37
18233,0,0,53,0,-53
18234,1,0,1,0,-1
18235,1,1,268,1250,982
18236,1,1,454,1605,1151
18237,1,1,798,1976,1178
18238,0,0,9,0,-9
18239,1,1,113,1450,1337
18240,0,0,25,0,-25
18241,0,0,134,0,-134
18242,1,1,296,1363,1067
18243,0,0,23,0,-23
18244,1,0,49,0,-49
18245,1,0,6,0,-6
18246,0,0,65,0,-65
18247,0,0,65,0,-65
18248,1,0,103,0,-103
18249,1,0,22,0,-22
18250,0,0,254,0,-254
18251,0,0,11,0,-11
18252,1,1,471,2388,1917
18253,0,0,44,0,-44
18254,0,0,94,0,-94
18255,1,1,2227,2601,374
18256,1,1,265,1272,1007
18257,1,1,451,1224,773
18258,0,0,85,0,-85
18259,0,0,28,0,-28
18260,0,0,47,0,-47
18261,1,1,74,2647,2573
18262,1,0,10,0,-10
18263,1,0,19,0,-19
18264,1,0,0,0,0
18265,1,1,131,1366,1235
18266,0,0,25,0,-25
18267,1,1,469,1207,738
18268,0,0,6,0,-6
18269,1,0,4,0,-4
18270,1,1,541,1325,784
18271,0,0,195,0,-195
18272,1,0,45,0,-45
18273,0,0,9,0,-9
18274,1,0,3,0,-3
18275,1,1,319,1432,1113
18276,1,0,70,0,-70
18277,0,0,24,0,-24
18278,0,0,58,0,-58
18279,1,1,379,1438,1059
18280,0,0,0,0,0
18281,1,0,39,0,-39
18282,1,0,200,0,-200
18283,0,0,86,0,-86
18284,1,0,12,0,-12
18285,1,0,25,0,-25
18286,1,0,32,0,-32
18287,1,0,32,0,-32
18288,0,0,15,0,-15
18289,0,0,51,0,-51
18290,1,0,15,0,-15
18291,1,1,1153,1342,189
18292,1,0,51,0,-51
18293,1,0,6,0,-6
18294,1,0,43,0,-43
18295,0,0,46,0,-46
18296,1,1,17,2003,1986
18297,1,0,14,0,-14
18298,0,0,40,0,-40
18299,0,0,103,0,-103
18300,1,0,64,0,-64
18301,1,1,547,1707,1160
18302,1,1,185,1515,1330
18303,0,0,90,0,-90
18304,0,0,75,0,-75
18305,1,1,279,1462,1183
18306,1,0,21,0,-21
18307,0,0,0,0,0
18308,1,1,416,2270,1854
18309,1,0,6,0,-6
18310,0,0,90,0,-90
18311,1,0,26,0,-26
18312,1,1,920,1354,434
18313,1,1,86,1374,1288
18314,1,0,49,0,-49
18315,1,1,318,1259,941
18316,0,0,71,0,-71
18317,1,0,29,0,-29
18318,1,1,592,1280,688
18319,0,0,32,0,-32
18320,1,0,27,0,-27
18321,1,1,708,1282,574
18322,0,0,28,0,-28
18323,0,0,30,0,-30
18324,0,0,159,0,-159
18325,0,0,6,0,-6
18326,1,1,150,1345,1195
18327,1,1,529,1314,785
18328,0,0,33,0,-33
18329,1,1,311,1464,1153
18330,1,0,6,0,-6
18331,0,0,16,0,-16
18332,0,0,78,0,-78
18333,1,1,922,3228,2306
18334,1,1,913,1930,1017
18335,1,0,38,0,-38
18336,0,0,11,0,-11
18337,1,1,871,1677,806
18338,1,1,395,1373,978
18339,0,0,195,0,-195
18340,0,0,21,0,-21
18341,1,0,118,0,-118
18342,0,0,81,0,-81
18343,1,1,55,1821,1766
18344,0,0,7,0,-7
18345,0,0,2,0,-2
18346,0,0,29,0,-29
18347,1,1,73,3063,2990
18348,0,0,4,0,-4
18349,0,0,13,0,-13
18350,1,1,924,1373,449
18351,0,0,119,0,-119
18352,0,0,178,0,-178
18353,1,1,79,1262,1183
18354,1,1,393,1229,836
18355,1,0,39,0,-39
18356,1,1,344,1629,1285
18357,1,1,316,1295,979
18358,0,0,8,0,-8
18359,1,1,446,2024,1578
18360,1,1,273,1234,961
18361,0,0,7,0,-7
18362,1,0,142,0,-142
18363,1,0,112,0,-112
18364,0,0,81,0,-81
18365,1,0,91,0,-91
18366,0,0,29,0,-29
18367,0,0,35,0,-35
18368,1,1,1296,1432,136
18369,0,0,73,0,-73
18370,1,0,33,0,-33
18371,1,1,959,3278,2319
18372,0,0,2,0,-2
18373,1,0,81,0,-81
18374,0,0,18,0,-18
18375,0,0,1,0,-1
18376,1,0,112,0,-112
18377,0,0,39,0,-39
18378,0,0,18,0,-18
18379,1,1,1249,1393,144
18380,1,1,212,1696,1484
18381,0,0,221,0,-221
18382,1,0,103,0,-103
18383,1,0,9,0,-9
18384,1,1,252,1246,994
18385,0,0,98,0,-98
18386,1,0,58,0,-58
18387,0,0,4,0,-4
18388,1,1,1475,1789,314
18389,1,1,472,5280,4808
18390,0,0,17,0,-17
18391,1,0,127,0,-127
18392,1,1,188,1262,1074
18393,1,0,6,0,-6
18394,1,0,34,0,-34
18395,1,1,1161,4167,3006
18396,1,0,37,0,-37
18397,1,1,261,1363,1102
18398,0,0,53,0,-53
18399,0,0,5,0,-5
18400,0,0,82,0,-82
18401,1,0,69,0,-69
18402,1,0,34,0,-34
18403,1,1,161,1349,1188
18404,1,1,311,1835,1524
18405,1,1,802,2111,1309
18406,0,0,1,0,-1
18407,0,0,315,0,-315
18408,1,1,723,1330,607
18409,1,1,549,1315,766
18410,0,0,237,0,-237
18411,1,1,244,1427,1183
18412,1,0,5,0,-5
18413,1,1,88,1373,1285
18414,0,0,20,0,-20
18415,0,0,59,0,-59
18416,1,1,119,1267,1148
18417,0,0,17,0,-17
18418,1,0,3,0,-3
18419,1,0,84,0,-84
18420,1,1,439,1680,1241
18421,0,0,46,0,-46
18422,0,0,117,0,-117
18423,1,0,43,0,-43
18424,1,0,45,0,-45
18425,1,1,375,1209,834
18426,1,1,366,3858,3492
18427,1,0,87,0,-87
18428,1,1,489,1346,857
18429,1,1,35,1571,1536
18430,1,1,672,1272,600
18431,0,0,17,0,-17
18432,0,0,29,0,-29
18433,0,0,190,0,-190
18434,1,1,1149,1210,61
18435,0,0,8,0,-8
18436,1,1,854,1380,526
18437,1,1,147,1222,1075
18438,1,1,2440,1636,-804
18439,0,0,58,0,-58
18440,1,1,861,1714,853
18441,1,0,102,0,-102
18442,1,0,27,0,-27
18443,1,1,177,1462,1285
18444,0,0,113,0,-113
18445,1,1,417,1225,808
18446,1,1,387,1582,1195
18447,0,0,82,0,-82
18448,1,0,53,0,-53
18449,0,0,22,0,-22
18450,0,0,20,0,-20
18451,0,0,13,0,-13
18452,1,1,710,1249,539
18453,1,0,104,0,-104
18454,0,0,35,0,-35
18455,1,0,6,0,-6
18456,0,0,35,0,-35
18457,1,1,372,1217,845
18458,0,0,34,0,-34
18459,1,1,350,1390,1040
18460,1,0,72,0,-72
18461,1,0,26,0,-26
18462,0,0,8,0,-8
18463,1,0,20,0,-20
18464,0,0,84,0,-84
18465,0,0,40,0,-40
18466,0,0,22,0,-22
18467,0,0,4,0,-4
18468,0,0,18,0,-18
18469,1,1,173,1696,1523
18470,0,0,0,0,0
18471,0,0,1,0,-1
18472,1,1,319,1771,1452
18473,1,0,220,0,-220
18474,1,1,129,2105,1976
18475,0,0,28,0,-28
18476,1,0,29,0,-29
18477,0,0,18,0,-18
18478,1,0,56,0,-56
18479,1,1,113,2771,2658
18480,0,0,52,0,-52
18481,0,0,28,0,-28
18482,1,0,17,0,-17
18483,0,0,44,0,-44
18484,1,1,1776,1434,-342
18485,0,0,39,0,-39
18486,0,0,19,0,-19
18487,0,0,23,0,-23
18488,0,0,10,0,-10
18489,0,0,60,0,-60
18490,0,0,113,0,-113
18491,1,0,39,0,-39
18492,1,1,1321,1558,237
18493,0,0,10,0,-10
18494,0,0,76,0,-76
18495,1,0,35,0,-35
18496,1,1,555,1881,1326
18497,1,0,66,0,-66
18498,1,0,0,0,0
18499,1,1,1416,1699,283
18500,1,1,450,1282,832
18501,1,0,4,0,-4
18502,1,1,183,1205,1022
18503,1,1,48,1345,1297
18504,0,0,46,0,-46
18505,0,0,50,0,-50
18506,0,0,6,0,-6
18507,1,1,561,1353,792
18508,0,0,33,0,-33
18509,1,1,88,1605,1517
18510,0,0,20,0,-20
18511,0,0,61,0,-61
18512,0,0,174,0,-174
18513,0,0,150,0,-150
18514,0,0,15,0,-15
18515,1,1,208,1235,1027
18516,0,0,0,0,0
18517,0,0,6,0,-6
18518,1,0,10,0,-10
18519,0,0,25,0,-25
18520,1,1,105,1216,1111
18521,1,1,188,1397,1209
18522,0,0,13,0,-13
18523,1,0,43,0,-43
18524,1,0,18,0,-18
18525,0,0,188,0,-188
18526,1,0,85,0,-85
18527,1,1,131,1819,1688
18528,1,0,67,0,-67
18529,1,0,18,0,-18
18530,1,1,715,1382,667
18531,1,1,180,1630,1450
18532,1,0,189,0,-189
18533,1,1,168,1323,1155
18534,0,0,112,0,-112
18535,0,0,105,0,-105
18536,0,0,69,0,-69
18537,0,0,17,0,-17
18538,1,1,461,1446,985
18539,0,0,37,0,-37
18540,1,0,6,0,-6
18541,0,0,6,0,-6
18542,1,0,37,0,-37
18543,1,0,120,0,-120
18544,1,1,449,1349,900
18545,1,1,324,2427,2103
18546,1,0,32,0,-32
18547,1,0,127,0,-127
18548,0,0,127,0,-127
18549,1,1,373,1201,828
18550,1,1,32,1504,1472
18551,0,0,121,0,-121
18552,1,0,3,0,-3
18553,0,0,93,0,-93
18554,0,0,9,0,-9
18555,0,0,21,0,-21
18556,1,1,566,1461,895
18557,0,0,3,0,-3
18558,1,1,196,2773,2577
18559,1,0,29,0,-29
18560,1,0,27,0,-27
18561,1,0,21,0,-21
18562,1,0,21,0,-21
18563,0,0,20,0,-20
18564,0,0,154,0,-154
18565,0,0,14,0,-14
18566,0,0,69,0,-69
18567,0,0,3,0,-3
18568,0,0,90,0,-90
18569,0,0,83,0,-83
18570,0,0,2,0,-2
18571,1,1,303,1427,1124
18572,1,1,2572,1729,-843
18573,1,0,21,0,-21
18574,1,0,49,0,-49
18575,1,1,858,1376,518
18576,1,0,18,0,-18
18577,0,0,52,0,-52
18578,1,1,479,1798,1319
18579,1,1,1188,1200,12
18580,0,0,1,0,-1
18581,1,1,2309,1398,-911
18582,0,0,6,0,-6
18583,0,0,106,0,-106
18584,1,1,245,1214,969
18585,0,0,61,0,-61
18586,0,0,117,0,-117
18587,1,0,71,0,-71
18588,1,0,13,0,-13
18589,0,0,5,0,-5
18590,1,1,228,1261,1033
18591,1,1,601,2923,2322
18592,1,0,53,0,-53
18593,1,0,11,0,-11
18594,0,0,72,0,-72
18595,0,0,74,0,-74
18596,1,1,315,1774,1459
18597,1,1,1011,2873,1862
18598,1,0,105,0,-105
18599,1,1,1199,1670,471
18600,1,1,221,1988,1767
18601,1,0,34,0,-34
18602,1,1,167,1403,1236
18603,0,0,8,0,-8
18604,0,0,0,0,0
18605,1,0,0,0,0
18606,1,0,42,0,-42
18607,0,0,50,0,-50
18608,0,0,13,0,-13
18609,0,0,2,0,-2
18610,1,0,16,0,-16
18611,1,1,289,1723,1434
18612,1,0,109,0,-109
18613,1,0,10,0,-10
18614,1,0,18,0,-18
18615,1,0,4,0,-4
18616,1,1,1250,1386,136
18617,0,0,35,0,-35
18618,0,0,2,0,-2
18619,1,1,345,1349,1004
18620,0,0,16,0,-16
18621,1,0,8,0,-8
18622,1,1,1092,1287,195
18623,0,0,122,0,-122
18624,0,0,40,0,-40
18625,1,1,238,1222,984
18626,0,0,81,0,-81
18627,1,1,1559,3702,2143
18628,0,0,8,0,-8
18629,1,1,214,1334,1120
18630,0,0,63,0,-63
18631,1,1,195,1346,1151
18632,0,0,11,0,-11
18633,0,0,95,0,-95
18634,1,0,63,0,-63
18635,0,0,114,0,-114
18636,1,1,140,1990,1850
18637,1,0,62,0,-62
18638,1,1,954,1361,407
18639,1,1,65,2976,2911
18640,1,0,65,0,-65
18641,1,0,16,0,-16
18642,1,0,137,0,-137
18643,0,0,7,0,-7
18644,0,0,88,0,-88
18645,1,1,204,1368,1164
18646,1,0,123,0,-123
18647,0,0,137,0,-137
18648,1,1,33,1212,1179
18649,1,1,1237,1718,481
18650,1,1,398,1700,1302
18651,1,0,7,0,-7
18652,0,0,58,0,-58
18653,1,0,22,0,-22
18654,0,0,79,0,-79
18655,1,0,29,0,-29
18656,1,1,104,1275,1171
18657,1,0,35,0,-35
18658,0,0,111,0,-111
18659,1,1,209,1215,1006
18660,0,0,12,0,-12
18661,1,0,4,0,-4
18662,1,1,415,1226,811
18663,0,0,311,0,-311
18664,0,0,84,0,-84
18665,1,0,75,0,-75
18666,1,0,57,0,-57
18667,1,1,89,1202,1113
18668,0,0,76,0,-76
18669,0,0,46,0,-46
18670,1,1,332,1460,1128
18671,1,0,19,0,-19
18672,1,0,40,0,-40
18673,1,1,467,1668,1201
18674,1,1,2326,1600,-726
18675,0,0,23,0,-23
18676,0,0,64,0,-64
18677,1,1,609,1259,650
18678,0,0,41,0,-41
18679,0,0,70,0,-70
18680,1,0,91,0,-91
18681,1,0,90,0,-90
18682,0,0,29,0,-29
18683,0,0,13,0,-13
18684,1,1,977,1476,499
18685,1,0,5,0,-5
18686,1,1,145,1218,1073
18687,1,1,197,1435,1238
18688,0,0,41,0,-41
18689,0,0,14,0,-14
18690,0,0,19,0,-19
18691,1,1,136,1261,1125
18692,1,0,9,0,-9
18693,0,0,129,0,-129
18694,1,1,443,1384,941
18695,0,0,133,0,-133
18696,1,1,1540,2701,1161
18697,1,1,609,1249,640
18698,1,0,89,0,-89
18699,0,0,23,0,-23
18700,1,0,32,0,-32
18701,1,0,26,0,-26
18702,0,0,16,0,-16
18703,0,0,1,0,-1
18704,0,0,99,0,-99
18705,0,0,48,0,-48
18706,0,0,50,0,-50
18707,1,1,441,1271,830
18708,1,0,50,0,-50
18709,1,0,84,0,-84
18710,0,0,128,0,-128
18711,0,0,61,0,-61
18712,1,0,3,0,-3
18713,1,0,9,0,-9
18714,1,0,8,0,-8
18715,1,0,56,0,-56
18716,1,1,519,1618,1099
18717,1,1,71,1959,1888
18718,1,1,44,1696,1652
18719,0,0,115,0,-115
18720,0,0,20,0,-20
18721,0,0,18,0,-18
18722,0,0,103,0,-103
18723,1,0,107,0,-107
18724,1,1,612,1326,714
18725,1,1,1213,1902,689
18726,1,1,303,1488,1185
18727,1,1,540,1554,1014
18728,0,0,62,0,-62
18729,0,0,0,0,0
18730,0,0,7,0,-7
18731,1,0,11,0,-11
18732,0,0,1,0,-1
18733,1,0,3,0,-3
18734,1,0,10,0,-10
18735,0,0,3,0,-3
18736,1,0,78,0,-78
18737,0,0,39,0,-39
18738,1,0,27,0,-27
18739,0,0,20,0,-20
18740,1,1,1404,1876,472
18741,1,0,17,0,-17
18742,1,1,860,1491,631
18743,0,0,91,0,-91
18744,1,0,2,0,-2
18745,0,0,29,0,-29
18746,0,0,15,0,-15
18747,1,1,23,1314,1291
18748,0,0,10,0,-10
18749,0,0,1,0,-1
18750,1,0,2,0,-2
18751,0,0,29,0,-29
18752,1,1,314,1626,1312
18753,0,0,82,0,-82
18754,0,0,1,0,-1
18755,0,0,94,0,-94
18756,0,0,31,0,-31
18757,0,0,18,0,-18
18758,1,0,31,0,-31
18759,0,0,129,0,-129
18760,1,1,624,1267,643
18761,1,1,759,1377,618
18762,1,1,621,1344,723
18763,1,0,4,0,-4
18764,1,0,21,0,-21
18765,1,1,287,1838,1551
18766,1,1,465,2014,1549
18767,0,0,33,0,-33
18768,1,1,529,2147,1618
18769,0,0,54,0,-54
18770,1,0,70,0,-70
18771,0,0,112,0,-112
18772,0,0,89,0,-89
18773,1,0,160,0,-160
18774,0,0,65,0,-65
18775,1,1,2374,1270,-1104
18776,1,1,390,1313,923
18777,1,0,28,0,-28
18778,1,1,432,1583,1151
18779,1,1,99,2297,2198
18780,1,0,19,0,-19
18781,1,0,45,0,-45
18782,1,1,244,2312,2068
18783,1,1,565,1737,1172
18784,1,0,46,0,-46
18785,1,1,120,1233,1113
18786,0,0,12,0,-12
18787,1,0,22,0,-22
18788,0,0,49,0,-49
18789,0,0,92,0,-92
18790,1,0,25,0,-25
18791,1,1,164,1497,1333
18792,0,0,44,0,-44
18793,1,0,45,0,-45
18794,1,0,51,0,-51
18795,0,0,46,0,-46
18796,1,1,233,1229,996
18797,1,1,358,1891,1533
18798,1,1,700,2074,1374
18799,1,0,32,0,-32
18800,0,0,12,0,-12
18801,0,0,16,0,-16
18802,1,0,2,0,-2
18803,0,0,149,0,-149
18804,1,0,41,0,-41
18805,0,0,8,0,-8
18806,0,0,14,0,-14
18807,0,0,10,0,-10
18808,1,1,492,1477,985
18809,1,0,22,0,-22
18810,1,1,190,3028,2838
18811,1,0,351,0,-351
18812,1,0,111,0,-111
18813,1,1,353,1458,1105
18814,0,0,36,0,-36
18815,1,0,55,0,-55
18816,1,0,6,0,-6
18817,1,1,949,2853,1904
18818,1,0,140,0,-140
18819,1,1,58,2543,2485
18820,1,1,190,2714,2524
18821,1,0,18,0,-18
18822,1,1,1312,1202,-110
18823,1,1,25,1652,1627
18824,1,1,439,1882,1443
18825,0,0,72,0,-72
18826,1,0,22,0,-22
18827,1,1,1265,1208,-57
18828,0,0,6,0,-6
18829,1,1,102,1327,1225
18830,0,0,14,0,-14
18831,0,0,31,0,-31
18832,0,0,207,0,-207
18833,1,0,51,0,-51
18834,1,0,20,0,-20
18835,1,1,556,2178,1622
18836,0,0,53,0,-53
18837,0,0,56,0,-56
18838,1,0,7,0,-7
18839,1,0,86,0,-86
18840,0,0,17,0,-17
18841,0,0,3,0,-3
18842,0,0,24,0,-24
18843,1,1,521,3469,2948
18844,1,1,316,1548,1232
18845,0,0,27,0,-27
18846,0,0,127,0,-127
18847,1,0,20,0,-20
18848,1,1,1752,1511,-241
18849,1,0,0,0,0
18850,0,0,101,0,-101
18851,1,1,2480,2578,98
18852,0,0,14,0,-14
18853,0,0,13,0,-13
18854,0,0,34,0,-34
18855,0,0,15,0,-15
18856,1,1,66,1229,1163
18857,0,0,100,0,-100
18858,1,1,134,1211,1077
18859,1,1,1426,1203,-223
18860,0,0,16,0,-16
18861,1,1,694,1497,803
18862,0,0,7,0,-7
18863,0,0,20,0,-20
18864,1,1,507,3404,2897
18865,1,1,137,1283,1146
18866,1,0,3,0,-3
18867,0,0,14,0,-14
18868,1,1,907,1589,682
18869,0,0,7,0,-7
18870,1,0,29,0,-29
18871,1,1,641,1255,614
18872,0,0,10,0,-10
18873,1,1,134,3024,2890
18874,1,1,695,1244,549
18875,0,0,217,0,-217
18876,0,0,118,0,-118
18877,1,0,38,0,-38
18878,0,0,10,0,-10
18879,0,0,45,0,-45
18880,1,0,138,0,-138
18881,0,0,20,0,-20
18882,0,0,92,0,-92
18883,0,0,266,0,-266
18884,1,0,47,0,-47
18885,1,1,671,1582,911
18886,1,1,65,1414,1349
18887,1,0,80,0,-80
18888,1,1,98,1445,1347
18889,1,1,526,1289,763
18890,1,0,98,0,-98
18891,0,0,81,0,-81
18892,1,1,841,1259,418
18893,0,0,4,0,-4
18894,1,1,395,1309,914
18895,1,1,499,1325,826
18896,0,0,23,0,-23
18897,0,0,26,0,-26
18898,1,0,13,0,-13
18899,1,1,596,1573,977
18900,0,0,14,0,-14
18901,0,0,24,0,-24
18902,1,1,497,1486,989
18903,1,0,72,0,-72
18904,0,0,11,0,-11
18905,1,0,145,0,-145
18906,0,0,148,0,-148
18907,1,0,198,0,-198
18908,1,1,279,1562,1283
18909,1,0,1,0,-1
18910,0,0,90,0,-90
18911,1,1,87,1618,1531
18912,1,1,294,1203,909
18913,0,0,41,0,-41
18914,0,0,7,0,-7
18915,1,0,280,0,-280
18916,1,1,371,1668,1297
18917,0,0,72,0,-72
18918,1,1,913,2137,1224
18919,1,0,24,0,-24
18920,0,0,42,0,-42
18921,0,0,42,0,-42
18922,1,1,288,3607,3319
18923,0,0,145,0,-145
18924,1,1,290,1223,933
18925,1,1,386,1757,1371
18926,1,1,375,1347,972
18927,1,0,3,0,-3
18928,0,0,39,0,-39
18929,1,1,169,1822,1653
18930,0,0,11,0,-11
18931,0,0,45,0,-45
18932,1,0,25,0,-25
18933,0,0,19,0,-19
18934,1,1,618,1265,647
18935,0,0,19,0,-19
18936,0,0,60,0,-60
18937,1,0,171,0,-171
18938,1,0,53,0,-53
18939,1,1,701,1396,695
18940,0,0,9,0,-9
18941,1,1,992,1426,434
18942,1,1,47,1300,1253
18943,1,1,612,2448,1836
18944,1,0,287,0,-287
18945,0,0,16,0,-16
18946,0,0,6,0,-6
18947,0,0,3,0,-3
18948,0,0,49,0,-49
18949,1,1,66,1562,1496
18950,0,0,24,0,-24
18951,0,0,46,0,-46
18952,0,0,136,0,-136
18953,1,1,1858,1233,-625
18954,0,0,33,0,-33
18955,0,0,44,0,-44
18956,0,0,74,0,-74
18957,0,0,24,0,-24
18958,1,1,693,2032,1339
18959,1,1,168,1248,1080
18960,1,1,602,1205,603
18961,1,1,779,1572,793
18962,1,1,749,1510,761
18963,1,0,2,0,-2
18964,1,1,237,3567,3330
18965,1,0,10,0,-10
18966,1,0,19,0,-19
18967,0,0,79,0,-79
18968,0,0,21,0,-21
18969,0,0,22,0,-22
18970,1,0,52,0,-52
18971,0,0,74,0,-74
18972,0,0,104,0,-104
18973,1,1,308,1293,985
18974,1,1,1505,1304,-201
18975,1,0,17,0,-17
18976,1,0,6,0,-6
18977,1,0,5,0,-5
18978,1,1,666,1355,689
18979,1,0,115,0,-115
18980,1,0,113,0,-113
18981,0,0,83,0,-83
18982,1,1,167,1273,1106
18983,0,0,29,0,-29
18984,1,0,125,0,-125
18985,1,1,1402,1640,238
18986,0,0,39,0,-39
18987,1,1,799,1615,816
18988,1,1,114,1225,1111
18989,1,0,41,0,-41
18990,0,0,26,0,-26
18991,1,1,10,1409,1399
18992,0,0,24,0,-24
18993,1,1,649,1233,584
18994,1,1,596,1443,847
18995,1,0,172,0,-172
18996,1,0,27,0,-27
18997,0,0,5,0,-5
18998,1,0,84,0,-84
18999,0,0,88,0,-88
19000,0,0,24,0,-24
19001,0,0,115,0,-115
19002,1,0,30,0,-30
19003,1,1,95,1256,1161
19004,0,0,24,0,-24
19005,0,0,64,0,-64
19006,1,0,207,0,-207
19007,1,0,9,0,-9
19008,1,0,10,0,-10
19009,0,0,2,0,-2
19010,1,1,206,1615,1409
19011,1,1,209,1339,1130
19012,0,0,21,0,-21
19013,0,0,19,0,-19
19014,0,0,72,0,-72
19015,1,0,30,0,-30
19016,1,0,1,0,-1
19017,0,0,27,0,-27
19018,1,0,60,0,-60
19019,1,0,0,0,0
19020,1,0,79,0,-79
19021,1,1,77,1369,1292
19022,1,1,1792,1735,-57
19023,0,0,6,0,-6
19024,0,0,168,0,-168
19025,1,0,36,0,-36
19026,1,0,129,0,-129
19027,1,0,53,0,-53
19028,0,0,73,0,-73
19029,1,0,16,0,-16
19030,1,0,48,0,-48
19031,0,0,219,0,-219
19032,0,0,30,0,-30
19033,1,0,42,0,-42
19034,1,1,377,1218,841
19035,1,0,22,0,-22
19036,1,1,266,1337,1071
19037,1,0,39,0,-39
19038,0,0,79,0,-79
19039,1,0,38,0,-38
19040,1,1,355,1314,959
19041,1,0,49,0,-49
19042,1,1,970,1213,243
19043,0,0,92,0,-92
19044,1,0,1,0,-1
19045,1,0,12,0,-12
19046,1,0,1,0,-1
19047,1,0,10,0,-10
19048,0,0,21,0,-21
19049,1,1,1023,1270,247
19050,1,1,40,1238,1198
19051,1,0,31,0,-31
19052,0,0,32,0,-32
19053,0,0,18,0,-18
19054,0,0,20,0,-20
19055,0,0,70,0,-70
19056,1,1,212,1685,1473
19057,0,0,59,0,-59
19058,1,1,319,1577,1258
19059,1,1,125,1258,1133
19060,1,0,2,0,-2
19061,1,0,29,0,-29
19062,1,1,263,1565,1302
19063,0,0,87,0,-87
19064,0,0,156,0,-156
19065,1,1,925,1267,342
19066,0,0,22,0,-22
19067,1,0,137,0,-137
19068,0,0,69,0,-69
19069,1,0,24,0,-24
19070,1,1,256,1859,1603
19071,1,0,99,0,-99
19072,0,0,24,0,-24
19073,1,1,176,1349,1173
19074,0,0,29,0,-29
19075,1,1,1092,1692,600
19076,0,0,1,0,-1
19077,1,1,27,1354,1327
19078,1,1,378,1550,1172
19079,0,0,6,0,-6
19080,1,1,69,1918,1849
19081,0,0,24,0,-24
19082,1,1,21,1732,1711
19083,0,0,10,0,-10
19084,0,0,34,0,-34
19085,1,1,329,1860,1531
19086,0,0,10,0,-10
19087,0,0,5,0,-5
19088,1,1,93,1525,1432
19089,1,1,437,1714,1277
19090,1,0,92,0,-92
19091,1,1,284,4297,4013
19092,0,0,13,0,-13
19093,1,0,62,0,-62
19094,0,0,77,0,-77
19095,1,1,176,1641,1465
19096,0,0,108,0,-108
19097,1,0,1,0,-1
19098,1,1,92,1240,1148
19099,0,0,175,0,-175
19100,0,0,10,0,-10
19101,0,0,4,0,-4
19102,1,0,44,0,-44
19103,1,0,32,0,-32
19104,0,0,182,0,-182
19105,1,1,995,1497,502
19106,1,0,1,0,-1
19107,1,1,1177,1617,440
19108,1,0,37,0,-37
19109,0,0,10,0,-10
19110,1,0,2,0,-2
19111,0,0,58,0,-58
19112,1,0,41,0,-41
19113,0,0,21,0,-21
19114,0,0,13,0,-13
19115,1,1,273,1349,1076
19116,0,0,2,0,-2
19117,1,1,318,1276,958
19118,1,1,563,1350,787
19119,1,1,1741,1345,-396
19120,0,0,8,0,-8
19121,0,0,9,0,-9
19122,1,1,1067,1812,745
19123,0,0,20,0,-20
19124,0,0,3,0,-3
19125,1,1,597,1247,650
19126,0,0,34,0,-34
19127,1,0,63,0,-63
19128,1,1,57,2050,1993
19129,1,0,27,0,-27
19130,0,0,126,0,-126
19131,1,0,2,0,-2
19132,1,0,77,0,-77
19133,0,0,112,0,-112
19134,0,0,75,0,-75
19135,0,0,47,0,-47
19136,1,1,127,1962,1835
19137,1,0,19,0,-19
19138,0,0,48,0,-48
19139,0,0,30,0,-30
19140,1,0,36,0,-36
19141,1,1,1623,1203,-420
19142,0,0,23,0,-23
19143,1,0,120,0,-120
19144,0,0,14,0,-14
19145,0,0,4,0,-4
19146,1,1,55,1315,1260
19147,1,0,6,0,-6
19148,0,0,47,0,-47
19149,0,0,25,0,-25
19150,1,0,27,0,-27
19151,0,0,0,0,0
19152,1,1,634,1759,1125
19153,0,0,62,0,-62
19154,0,0,22,0,-22
19155,1,1,158,1211,1053
19156,1,0,62,0,-62
19157,1,0,142,0,-142
19158,0,0,133,0,-133
19159,0,0,4,0,-4
19160,1,0,5,0,-5
19161,1,1,315,1654,1339
19162,0,0,12,0,-12
19163,1,1,344,1253,909
19164,1,0,88,0,-88
19165,0,0,25,0,-25
19166,1,1,426,1564,1138
19167,1,0,18,0,-18
19168,1,1,293,2628,2335
19169,1,0,82,0,-82
19170,1,0,7,0,-7
19171,0,0,14,0,-14
19172,0,0,238,0,-238
19173,1,0,5,0,-5
19174,1,1,290,1251,961
19175,1,0,30,0,-30
19176,0,0,3,0,-3
19177,1,0,28,0,-28
19178,0,0,9,0,-9
19179,1,0,33,0,-33
19180,0,0,19,0,-19
19181,1,0,76,0,-76
19182,1,1,84,1243,1159
19183,0,0,21,0,-21
19184,1,0,27,0,-27
19185,0,0,37,0,-37
19186,0,0,139,0,-139
19187,1,1,49,1606,1557
19188,1,1,713,1246,533
19189,0,0,41,0,-41
19190,1,0,74,0,-74
19191,0,0,20,0,-20
19192,1,1,99,2153,2054
19193,1,1,219,1253,1034
19194,1,0,28,0,-28
19195,0,0,13,0,-13
19196,0,0,139,0,-139
19197,0,0,66,0,-66
19198,1,0,133,0,-133
19199,0,0,27,0,-27
19200,1,1,260,1283,1023
19201,1,1,170,1221,1051
19202,1,1,3211,1439,-1772
19203,0,0,79,0,-79
19204,1,1,62,1298,1236
19205,1,0,144,0,-144
19206,0,0,73,0,-73
19207,0,0,2,0,-2
19208,1,0,136,0,-136
19209,0,0,91,0,-91
19210,1,1,899,1361,462
19211,0,0,121,0,-121
19212,0,0,97,0,-97
19213,0,0,142,0,-142
19214,1,0,28,0,-28
19215,1,1,2741,2587,-154
19216,1,1,871,1239,368
19217,1,0,9,0,-9
19218,0,0,69,0,-69
19219,1,1,63,2326,2263
19220,1,1,141,1583,1442
19221,0,0,29,0,-29
19222,1,0,105,0,-105
19223,1,0,4,0,-4
19224,0,0,99,0,-99
19225,0,0,4,0,-4
19226,1,0,37,0,-37
19227,1,0,3,0,-3
19228,0,0,177,0,-177
19229,1,1,470,1305,835
19230,0,0,51,0,-51
19231,0,0,13,0,-13
19232,0,0,11,0,-11
19233,1,0,2,0,-2
19234,0,0,17,0,-17
19235,1,1,246,1677,1431
19236,1,1,693,1422,729
19237,0,0,20,0,-20
19238,1,1,330,1619,1289
19239,1,0,28,0,-28
19240,1,1,270,1242,972
19241,1,1,474,1273,799
19242,1,1,104,1239,1135
19243,0,0,4,0,-4
19244,1,0,46,0,-46
19245,1,1,93,1270,1177
19246,1,1,107,1270,1163
19247,1,0,3,0,-3
19248,0,0,12,0,-12
19249,1,0,163,0,-163
19250,1,0,67,0,-67
19251,1,1,131,1897,1766
19252,1,1,256,2342,2086
19253,1,0,59,0,-59
19254,1,0,12,0,-12
19255,1,0,76,0,-76
19256,1,1,1487,1758,271
19257,0,0,2,0,-2
19258,1,0,32,0,-32
19259,1,1,433,1654,1221
19260,1,0,2,0,-2
19261,1,0,1,0,-1
19262,0,0,34,0,-34
19263,1,0,7,0,-7
19264,1,1,117,1293,1176
19265,1,0,8,0,-8
19266,1,0,15,0,-15
19267,0,0,65,0,-65
19268,0,0,1,0,-1
19269,1,1,950,2248,1298
19270,1,1,370,1427,1057
19271,0,0,13,0,-13
19272,0,0,25,0,-25
19273,1,1,1239,1314,75
19274,1,0,151,0,-151
19275,1,0,59,0,-59
19276,1,1,45,1946,1901
19277,1,1,717,1562,845
19278,1,1,669,1317,648
19279,1,1,454,1881,1427
19280,0,0,85,0,-85
19281,1,0,30,0,-30
19282,0,0,57,0,-57
19283,1,0,20,0,-20
19284,1,0,0,0,0
19285,1,1,1126,3064,1938
19286,1,1,57,1482,1425
19287,0,0,88,0,-88
19288,0,0,63,0,-63
19289,1,0,17,0,-17
19290,1,1,605,1850,1245
19291,1,0,42,0,-42
19292,0,0,35,0,-35
19293,1,0,48,0,-48
19294,0,0,37,0,-37
19295,1,0,69,0,-69
19296,0,0,23,0,-23
19297,1,1,612,1591,979
19298,1,0,3,0,-3
19299,0,0,65,0,-65
19300,1,1,740,1566,826
19301,1,1,1174,1324,150
19302,0,0,49,0,-49
19303,1,1,92,1285,1193
19304,0,0,24,0,-24
19305,0,0,70,0,-70
19306,1,0,0,0,0
19307,0,0,58,0,-58
19308,1,1,2528,1628,-900
19309,0,0,70,0,-70
19310,0,0,29,0,-29
19311,1,1,518,1938,1420
19312,0,0,166,0,-166
19313,1,1,386,4102,3716
19314,0,0,79,0,-79
19315,0,0,20,0,-20
19316,1,1,301,1727,1426
19317,1,1,338,1510,1172
19318,1,1,867,1326,459
19319,1,1,216,1234,1018
19320,0,0,28,0,-28
19321,0,0,163,0,-163
19322,0,0,29,0,-29
19323,1,0,24,0,-24
19324,1,0,31,0,-31
19325,0,0,29,0,-29
19326,0,0,9,0,-9
19327,1,0,61,0,-61
19328,1,1,1065,1477,412
19329,1,1,395,1262,867
19330,0,0,14,0,-14
19331,1,1,153,1308,1155
19332,1,1,768,1759,991
19333,0,0,2,0,-2
19334,1,0,145,0,-145
19335,1,1,157,1370,1213
19336,1,0,61,0,-61
19337,1,0,157,0,-157
19338,1,1,87,2101,2014
19339,0,0,16,0,-16
19340,1,0,62,0,-62
19341,1,1,520,1246,726
19342,1,0,69,0,-69
19343,1,1,327,1527,1200
19344,0,0,107,0,-107
19345,0,0,10,0,-10
19346,1,0,38,0,-38
19347,1,0,42,0,-42
19348,1,0,18,0,-18
19349,0,0,16,0,-16
19350,0,0,90,0,-90
19351,1,0,53,0,-53
19352,1,1,821,1233,412
19353,1,0,97,0,-97
19354,1,1,562,1241,679
19355,1,1,569,1340,771
19356,0,0,13,0,-13
19357,1,1,680,1387,707
19358,0,0,11,0,-11
19359,1,0,105,0,-105
19360,1,0,3,0,-3
19361,0,0,1,0,-1
19362,1,1,1908,1620,-288
19363,1,0,2,0,-2
19364,1,0,81,0,-81
19365,0,0,13,0,-13
19366,0,0,5,0,-5
19367,1,0,2,0,-2
19368,0,0,4,0,-4
19369,0,0,42,0,-42
19370,1,1,1882,3674,1792
19371,0,0,26,0,-26
19372,0,0,6,0,-6
19373,1,1,2021,1284,-737
19374,0,0,28,0,-28
19375,1,0,1,0,-1
19376,1,1,360,1646,1286
19377,0,0,4,0,-4
19378,1,0,75,0,-75
19379,1,1,410,1327,917
19380,0,0,96,0,-96
19381,0,0,42,0,-42
19382,1,0,29,0,-29
19383,0,0,43,0,-43
19384,0,0,31,0,-31
19385,0,0,5,0,-5
19386,0,0,5,0,-5
19387,0,0,141,0,-141
19388,1,0,10,0,-10
19389,1,1,256,1529,1273
19390,0,0,6,0,-6
19391,1,1,47,6145,6098
19392,0,0,93,0,-93
19393,0,0,50,0,-50
19394,1,1,701,1568,867
19395,0,0,6,0,-6
19396,1,1,424,1912,1488
19397,0,0,26,0,-26
19398,1,1,242,1413,1171
19399,1,0,60,0,-60
19400,1,0,50,0,-50
19401,0,0,4,0,-4
19402,0,0,70,0,-70
19403,1,1,607,1294,687
19404,0,0,45,0,-45
19405,1,1,218,1688,1470
19406,1,0,86,0,-86
19407,1,0,3,0,-3
19408,0,0,1,0,-1
19409,1,1,322,1240,918
19410,0,0,34,0,-34
19411,0,0,58,0,-58
19412,1,0,69,0,-69
19413,0,0,4,0,-4
19414,1,1,222,2505,2283
19415,1,0,20,0,-20
19416,0,0,3,0,-3
19417,1,0,77,0,-77
19418,0,0,65,0,-65
19419,0,0,130,0,-130
19420,1,0,128,0,-128
19421,1,1,943,1298,355
19422,0,0,0,0,0
19423,0,0,64,0,-64
19424,0,0,54,0,-54
19425,0,0,0,0,0
19426,1,1,1093,1310,217
19427,0,0,56,0,-56
19428,1,1,84,1252,1168
19429,1,1,248,1358,1110
19430,0,0,17,0,-17
19431,0,0,18,0,-18
19432,1,0,89,0,-89
19433,0,0,13,0,-13
19434,0,0,11,0,-11
19435,0,0,20,0,-20
19436,1,1,64,1675,1611
19437,1,0,28,0,-28
19438,1,1,182,1222,1040
19439,0,0,3,0,-3
19440,0,0,3,0,-3
19441,1,0,95,0,-95
19442,1,1,208,1963,1755
19443,0,0,4,0,-4
19444,0,0,12,0,-12
19445,1,0,128,0,-128
19446,0,0,53,0,-53
19447,0,0,67,0,-67
19448,1,1,663,3042,2379
19449,1,1,178,1386,1208
19450,0,0,1,0,-1
19451,1,0,48,0,-48
19452,0,0,100,0,-100
19453,1,0,26,0,-26
19454,0,0,85,0,-85
19455,1,1,735,1222,487
19456,0,0,38,0,-38
19457,0,0,46,0,-46
19458,0,0,16,0,-16
19459,0,0,132,0,-132
19460,1,1,729,1410,681
19461,1,0,87,0,-87
19462,1,0,17,0,-17
19463,1,1,132,1404,1272
19464,0,0,148,0,-148
19465,1,0,20,0,-20
19466,0,0,29,0,-29
19467,0,0,54,0,-54
19468,1,1,138,1205,1067
19469,1,1,740,1429,689
19470,1,0,158,0,-158
19471,0,0,75,0,-75
19472,0,0,23,0,-23
19473,0,0,35,0,-35
19474,1,0,0,0,0
19475,1,0,9,0,-9
19476,1,1,626,2392,1766
19477,0,0,14,0,-14
19478,1,0,18,0,-18
19479,0,0,55,0,-55
19480,1,1,190,1500,1310
19481,0,0,9,0,-9
19482,1,0,99,0,-99
19483,0,0,7,0,-7
19484,1,1,119,2521,2402
19485,1,0,74,0,-74
19486,1,1,724,1565,841
19487,1,0,16,0,-16
19488,1,0,33,0,-33
19489,1,0,8,0,-8
19490,1,1,351,1254,903
19491,0,0,22,0,-22
19492,1,1,69,1231,1162
19493,1,1,261,1535,1274
19494,1,0,55,0,-55
19495,0,0,60,0,-60
19496,1,0,9,0,-9
19497,1,1,729,1367,638
19498,1,1,720,1428,708
19499,0,0,32,0,-32
19500,1,0,71,0,-71
19501,1,0,3,0,-3
19502,0,0,54,0,-54
19503,0,0,21,0,-21
19504,1,1,214,1240,1026
19505,1,0,5,0,-5
19506,1,1,831,1381,550
19507,0,0,25,0,-25
19508,1,1,998,1640,642
19509,0,0,67,0,-67
19510,1,1,393,1426,1033
19511,1,0,17,0,-17
19512,1,0,25,0,-25
19513,0,0,11,0,-11
19514,1,0,51,0,-51
19515,0,0,171,0,-171
19516,1,1,326,1284,958
19517,1,0,43,0,-43
19518,1,0,12,0,-12
19519,0,0,1,0,-1
19520,0,0,36,0,-36
19521,1,1,608,1490,882
19522,0,0,12,0,-12
19523,1,1,397,1419,1022
19524,1,0,88,0,-88
19525,1,0,4,0,-4
19526,1,1,306,1272,966
19527,1,1,856,1249,393
19528,1,0,51,0,-51
19529,0,0,38,0,-38
19530,0,0,44,0,-44
19531,0,0,3,0,-3
19532,0,0,10,0,-10
19533,0,0,65,0,-65
19534,1,0,16,0,-16
19535,1,0,20,0,-20
19536,0,0,59,0,-59
19537,0,0,37,0,-37
19538,0,0,60,0,-60
19539,1,1,374,1207,833
19540,1,1,671,1276,605
19541,0,0,18,0,-18
19542,0,0,80,0,-80
19543,0,0,143,0,-143
19544,1,0,19,0,-19
19545,1,0,83,0,-83
19546,1,0,2,0,-2
19547,0,0,81,0,-81
19548,1,0,65,0,-65
19549,1,0,22,0,-22
19550,0,0,21,0,-21
19551,1,0,73,0,-73
19552,0,0,29,0,-29
19553,1,1,483,1316,833
19554,1,1,300,1239,939
19555,1,0,0,0,0
19556,0,0,55,0,-55
19557,0,0,2,0,-2
19558,0,0,8,0,-8
19559,1,0,72,0,-72
19560,1,1,188,1312,1124
19561,0,0,45,0,-45
19562,1,1,375,1332,957
19563,0,0,99,0,-99
19564,1,0,5,0,-5
19565,1,0,9,0,-9
19566,0,0,99,0,-99
19567,0,0,19,0,-19
19568,0,0,70,0,-70
19569,0,0,69,0,-69
19570,1,0,28,0,-28
19571,1,1,406,1571,1165
19572,1,0,62,0,-62
19573,0,0,25,0,-25
19574,1,1,779,3065,2286
19575,1,1,852,2512,1660
19576,0,0,20,0,-20
19577,0,0,203,0,-203
19578,1,0,41,0,-41
19579,0,0,113,0,-113
19580,1,0,39,0,-39
19581,1,0,26,0,-26
19582,0,0,99,0,-99
19583,0,0,69,0,-69
19584,1,0,41,0,-41
19585,0,0,2,0,-2
19586,1,1,362,1345,983
19587,1,1,1405,1937,532
19588,0,0,60,0,-60
19589,1,1,472,1528,1056
19590,0,0,8,0,-8
19591,1,1,228,1520,1292
19592,0,0,106,0,-106
19593,1,0,3,0,-3
19594,0,0,29,0,-29
19595,0,0,149,0,-149
19596,0,0,10,0,-10
19597,1,1,1429,1288,-141
19598,1,0,19,0,-19
19599,0,0,13,0,-13
19600,1,1,424,1484,1060
19601,0,0,10,0,-10
19602,1,0,13,0,-13
19603,1,1,216,1424,1208
19604,1,1,692,1350,658
19605,1,1,165,1505,1340
19606,1,1,968,1535,567
19607,1,0,35,0,-35
19608,0,0,199,0,-199
19609,1,0,100,0,-100
19610,1,1,218,1213,995
19611,1,0,2,0,-2
19612,0,0,1,0,-1
19613,0,0,7,0,-7
19614,0,0,92,0,-92
19615,0,0,158,0,-158
19616,1,1,348,1235,887
19617,1,1,825,2339,1514
19618,0,0,5,0,-5
19619,1,1,71,1331,1260
19620,0,0,38,0,-38
19621,1,0,15,0,-15
19622,1,0,111,0,-111
19623,1,1,116,2275,2159
19624,0,0,154,0,-154
19625,0,0,67,0,-67
19626,0,0,13,0,-13
19627,1,0,29,0,-29
19628,1,1,44,1990,1946
19629,1,0,53,0,-53
19630,1,1,540,1413,873
19631,0,0,48,0,-48
19632,0,0,14,0,-14
19633,0,0,141,0,-141
19634,1,0,61,0,-61
19635,1,0,9,0,-9
19636,1,0,21,0,-21
19637,0,0,39,0,-39
19638,1,1,88,2268,2180
19639,0,0,65,0,-65
19640,0,0,6,0,-6
19641,1,0,150,0,-150
19642,1,1,378,1866,1488
19643,0,0,17,0,-17
19644,1,0,20,0,-20
19645,1,1,1030,2072,1042
19646,1,1,282,1533,1251
19647,1,0,40,0,-40
19648,0,0,46,0,-46
19649,1,0,69,0,-69
19650,1,0,30,0,-30
19651,1,0,73,0,-73
19652,1,0,21,0,-21
19653,1,0,16,0,-16
19654,0,0,140,0,-140
19655,1,0,19,0,-19
19656,0,0,75,0,-75
19657,1,1,52,1583,1531
19658,0,0,120,0,-120
19659,0,0,30,0,-30
19660,0,0,10,0,-10
19661,1,0,164,0,-164
19662,1,0,113,0,-113
19663,0,0,91,0,-91
19664,1,1,679,1334,655
19665,1,1,170,1236,1066
19666,0,0,22,0,-22
19667,1,0,24,0,-24
19668,1,1,240,2523,2283
19669,0,0,21,0,-21
19670,1,1,153,1613,1460
19671,0,0,76,0,-76
19672,0,0,72,0,-72
19673,1,1,297,1434,1137
19674,1,0,90,0,-90
19675,1,1,38,1300,1262
19676,1,0,12,0,-12
19677,0,0,89,0,-89
19678,0,0,142,0,-142
19679,1,0,5,0,-5
19680,1,0,88,0,-88
19681,1,0,50,0,-50
19682,1,0,77,0,-77
19683,1,0,2,0,-2
19684,0,0,20,0,-20
19685,1,0,25,0,-25
19686,0,0,44,0,-44
19687,0,0,59,0,-59
19688,1,0,252,0,-252
19689,1,1,154,1537,1383
19690,1,0,81,0,-81
19691,1,1,49,1272,1223
19692,0,0,85,0,-85
19693,0,0,72,0,-72
19694,1,1,81,1406,1325
19695,0,0,45,0,-45
19696,0,0,80,0,-80
19697,1,0,34,0,-34
19698,1,1,7,1328,1321
19699,0,0,36,0,-36
19700,0,0,126,0,-126
19701,1,1,974,1437,463
19702,0,0,77,0,-77
19703,1,0,0,0,0
19704,1,0,18,0,-18
19705,1,0,12,0,-12
19706,1,1,445,1494,1049
19707,0,0,28,0,-28
19708,0,0,159,0,-159
19709,1,1,156,1535,1379
19710,0,0,10,0,-10
19711,1,1,1714,1226,-488
19712,1,0,33,0,-33
19713,1,0,5,0,-5
19714,1,0,70,0,-70
19715,1,0,5,0,-5
19716,1,1,88,1233,1145
19717,0,0,193,0,-193
19718,1,1,478,1914,1436
19719,0,0,87,0,-87
19720,0,0,78,0,-78
19721,1,0,27,0,-27
19722,1,1,251,1729,1478
19723,0,0,161,0,-161
19724,1,1,200,1665,1465
19725,0,0,68,0,-68
19726,1,1,277,4993,4716
19727,1,0,67,0,-67
19728,1,0,102,0,-102
19729,0,0,33,0,-33
19730,1,1,408,1290,882
19731,0,0,5,0,-5
19732,0,0,9,0,-9
19733,0,0,30,0,-30
19734,0,0,38,0,-38
19735,0,0,28,0,-28
19736,0,0,24,0,-24
19737,1,0,16,0,-16
19738,0,0,32,0,-32
19739,0,0,53,0,-53
19740,1,1,173,1258,1085
19741,1,1,45,1204,1159
19742,1,0,83,0,-83
19743,1,0,18,0,-18
19744,0,0,47,0,-47
19745,1,0,67,0,-67
19746,1,0,25,0,-25
19747,0,0,97,0,-97
19748,1,1,153,1295,1142
19749,1,1,188,1625,1437
19750,1,1,199,1796,1597
19751,0,0,15,0,-15
19752,1,1,265,1262,997
19753,1,1,167,1361,1194
19754,1,0,60,0,-60
19755,1,0,35,0,-35
19756,1,1,591,1593,1002
19757,0,0,13,0,-13
19758,0,0,39,0,-39
19759,1,1,536,1548,1012
19760,0,0,41,0,-41
19761,1,1,349,1721,1372
19762,0,0,141,0,-141
19763,1,0,149,0,-149
19764,1,1,950,1938,988
19765,0,0,76,0,-76
19766,0,0,3,0,-3
19767,1,0,8,0,-8
19768,0,0,81,0,-81
19769,0,0,29,0,-29
19770,1,0,24,0,-24
19771,0,0,40,0,-40
19772,0,0,30,0,-30
19773,0,0,140,0,-140
19774,1,0,61,0,-61
19775,0,0,29,0,-29
19776,1,1,96,1456,1360
19777,1,0,77,0,-77
19778,0,0,7,0,-7
19779,1,0,34,0,-34
19780,0,0,46,0,-46
19781,0,0,34,0,-34
19782,0,0,25,0,-25
19783,1,1,93,1363,1270
19784,0,0,137,0,-137
19785,1,0,61,0,-61
19786,1,1,1171,1389,218
19787,1,0,15,0,-15
19788,1,1,1179,1213,34
19789,0,0,9,0,-9
19790,0,0,65,0,-65
19791,0,0,8,0,-8
19792,1,1,63,1611,1548
19793,1,1,1108,1737,629
19794,1,0,63,0,-63
19795,0,0,48,0,-48
19796,0,0,81,0,-81
19797,1,1,575,1400,825
19798,0,0,7,0,-7
19799,1,1,568,1211,643
19800,1,0,4,0,-4
19801,0,0,74,0,-74
19802,1,1,584,1477,893
19803,1,1,550,1551,1001
19804,0,0,94,0,-94
19805,0,0,24,0,-24
19806,1,0,5,0,-5
19807,1,1,408,1914,1506
19808,1,0,20,0,-20
19809,0,0,39,0,-39
19810,0,0,1,0,-1
19811,0,0,29,0,-29
19812,1,0,29,0,-29
19813,0,0,55,0,-55
19814,1,1,348,1366,1018
19815,1,0,28,0,-28
19816,1,0,64,0,-64
19817,1,0,3,0,-3
19818,1,1,48,1240,1192
19819,1,0,54,0,-54
19820,1,0,88,0,-88
19821,0,0,133,0,-133
19822,0,0,8,0,-8
19823,1,1,576,1714,1138
19824,1,0,39,0,-39
19825,0,0,52,0,-52
19826,1,0,67,0,-67
19827,1,1,194,1375,1181
19828,0,0,82,0,-82
19829,1,0,21,0,-21
19830,0,0,49,0,-49
19831,1,0,33,0,-33
19832,0,0,19,0,-19
19833,1,1,384,1521,1137
19834,0,0,52,0,-52
19835,0,0,2,0,-2
19836,1,1,2192,1998,-194
19837,1,0,7,0,-7
19838,0,0,83,0,-83
19839,0,0,8,0,-8
19840,1,0,7,0,-7
19841,0,0,28,0,-28
19842,1,1,109,1266,1157
19843,1,0,9,0,-9
19844,0,0,29,0,-29
19845,1,1,1693,3323,1630
19846,1,0,58,0,-58
19847,1,1,241,1429,1188
19848,1,0,8,0,-8
19849,1,1,173,1444,1271
19850,1,1,770,1256,486
19851,1,1,932,1496,564
19852,0,0,65,0,-65
19853,1,1,568,1466,898
19854,1,1,405,1940,1535
19855,0,0,33,0,-33
19856,1,1,224,1843,1619
19857,0,0,38,0,-38
19858,1,1,661,2684,2023
19859,1,1,739,1783,1044
19860,1,1,1423,1386,-37
19861,1,1,690,1715,1025
19862,1,1,1035,1920,885
19863,0,0,27,0,-27
19864,1,0,66,0,-66
19865,1,0,107,0,-107
19866,1,1,343,1401,1058
19867,0,0,51,0,-51
19868,0,0,4,0,-4
19869,1,1,157,1770,1613
19870,0,0,40,0,-40
19871,0,0,73,0,-73
19872,0,0,56,0,-56
19873,0,0,20,0,-20
19874,0,0,12,0,-12
19875,0,0,15,0,-15
19876,0,0,5,0,-5
19877,0,0,19,0,-19
19878,0,0,96,0,-96
19879,0,0,56,0,-56
19880,1,1,271,4870,4599
19881,1,0,128,0,-128
19882,0,0,16,0,-16
19883,1,0,83,0,-83
19884,0,0,0,0,0
19885,1,1,475,2638,2163
19886,0,0,10,0,-10
19887,1,0,8,0,-8
19888,1,1,730,1261,531
19889,0,0,31,0,-31
19890,1,1,677,1387,710
19891,0,0,11,0,-11
19892,0,0,18,0,-18
19893,1,0,23,0,-23
19894,1,0,64,0,-64
19895,0,0,19,0,-19
19896,1,1,653,2187,1534
19897,1,0,29,0,-29
19898,0,0,65,0,-65
19899,1,1,428,2200,1772
19900,0,0,18,0,-18
19901,0,0,42,0,-42
19902,0,0,2,0,-2
19903,0,0,188,0,-188
19904,1,0,46,0,-46
19905,0,0,77,0,-77
19906,1,1,93,1458,1365
19907,1,0,30,0,-30
19908,1,0,13,0,-13
19909,1,0,44,0,-44
19910,1,0,43,0,-43
19911,1,1,269,1340,1071
19912,0,0,26,0,-26
19913,1,1,168,2202,2034
19914,1,1,62,1292,1230
19915,1,0,34,0,-34
19916,1,0,54,0,-54
19917,1,0,65,0,-65
19918,0,0,79,0,-79
19919,1,0,65,0,-65
19920,0,0,8,0,-8
19921,0,0,75,0,-75
19922,0,0,63,0,-63
19923,0,0,80,0,-80
19924,1,1,318,1820,1502
19925,0,0,36,0,-36
19926,1,1,1615,1310,-305
19927,0,0,17,0,-17
19928,1,0,17,0,-17
19929,1,1,257,1260,1003
19930,0,0,61,0,-61
19931,0,0,40,0,-40
19932,1,1,113,1854,1741
19933,1,0,29,0,-29
19934,0,0,35,0,-35
19935,1,0,22,0,-22
19936,1,1,81,1398,1317
19937,0,0,30,0,-30
19938,1,1,196,2207,2011
19939,1,0,69,0,-69
19940,1,0,23,0,-23
19941,1,0,8,0,-8
19942,0,0,52,0,-52
19943,1,0,77,0,-77
19944,1,0,5,0,-5
19945,1,0,86,0,-86
19946,1,0,76,0,-76
19947,1,1,1852,1446,-406
19948,1,0,8,0,-8
19949,1,1,814,2339,1525
19950,0,0,17,0,-17
19951,1,1,255,1241,986
19952,1,1,290,3034,2744
19953,0,0,29,0,-29
19954,0,0,8,0,-8
19955,0,0,20,0,-20
19956,0,0,107,0,-107
19957,1,1,271,1232,961
19958,1,1,129,1518,1389
19959,0,0,21,0,-21
19960,1,1,370,1332,962
19961,0,0,43,0,-43
19962,1,1,329,1964,1635
19963,1,1,194,1906,1712
19964,1,1,635,1910,1275
19965,0,0,16,0,-16
19966,0,0,1,0,-1
19967,0,0,112,0,-112
19968,0,0,15,0,-15
19969,1,1,101,1426,1325
19970,0,0,271,0,-271
19971,1,0,76,0,-76
19972,1,1,1351,1519,168
19973,1,1,57,1254,1197
19974,0,0,39,0,-39
19975,1,1,208,1294,1086
19976,0,0,96,0,-96
19977,1,1,801,1497,696
19978,0,0,74,0,-74
19979,0,0,98,0,-98
19980,1,0,9,0,-9
19981,0,0,78,0,-78
19982,1,0,61,0,-61
19983,1,1,586,1373,787
19984,1,0,9,0,-9
19985,0,0,43,0,-43
19986,0,0,19,0,-19
19987,1,1,396,1564,1168
19988,0,0,27,0,-27
19989,1,1,108,1750,1642
19990,0,0,27,0,-27
19991,0,0,22,0,-22
19992,1,1,2674,2383,-291
19993,1,1,633,1918,1285
19994,1,0,45,0,-45
19995,0,0,1,0,-1
19996,1,1,1153,1286,133
19997,0,0,17,0,-17
19998,0,0,53,0,-53
19999,1,1,969,1815,846
20000,1,1,127,1477,1350
20001,1,0,184,0,-184
20002,1,1,251,1592,1341
20003,1,0,7,0,-7
20004,0,0,77,0,-77
20005,1,0,0,0,0
20006,0,0,58,0,-58
20007,0,0,27,0,-27
20008,1,1,905,1319,414
20009,0,0,8,0,-8
20010,1,0,52,0,-52
20011,0,0,130,0,-130
20012,1,1,1034,1291,257
20013,0,0,61,0,-61
20014,1,1,292,1232,940
20015,1,0,57,0,-57
20016,0,0,10,0,-10
20017,0,0,50,0,-50
20018,1,1,131,2218,2087
20019,1,1,728,1908,1180
20020,1,0,50,0,-50
20021,1,1,148,1324,1176
20022,0,0,29,0,-29
20023,1,1,50,1744,1694
20024,1,1,668,1292,624
20025,1,1,390,1231,841
20026,1,1,133,1377,1244
20027,0,0,22,0,-22
20028,1,0,129,0,-129
20029,1,0,22,0,-22
20030,1,1,94,1244,1150
20031,1,1,264,1779,1515
20032,1,0,15,0,-15
20033,0,0,11,0,-11
20034,1,1,100,1746,1646
20035,1,1,914,1346,432
20036,1,1,573,1576,1003
20037,1,0,147,0,-147
20038,1,1,454,2261,1807
20039,1,1,281,1619,1338
20040,1,0,2,0,-2
20041,1,0,219,0,-219
20042,1,1,373,1491,1118
20043,0,0,100,0,-100
20044,1,0,24,0,-24
20045,0,0,44,0,-44
20046,0,0,4,0,-4
20047,1,1,264,1216,952
20048,1,0,16,0,-16
20049,0,0,179,0,-179
20050,1,1,748,1517,769
20051,0,0,23,0,-23
20052,1,0,14,0,-14
20053,1,0,10,0,-10
20054,1,1,388,1396,1008
20055,1,1,224,1250,1026
20056,1,0,25,0,-25
20057,0,0,29,0,-29
20058,0,0,74,0,-74
20059,0,0,64,0,-64
20060,1,1,181,1346,1165
20061,1,1,551,1221,670
20062,1,0,11,0,-11
20063,1,1,116,1349,1233
20064,0,0,73,0,-73
20065,1,1,237,1207,970
20066,1,0,38,0,-38
20067,0,0,7,0,-7
20068,1,1,203,1260,1057
20069,0,0,76,0,-76
20070,0,0,21,0,-21
20071,0,0,9,0,-9
20072,1,1,1496,2540,1044
20073,0,0,23,0,-23
20074,0,0,34,0,-34
20075,0,0,14,0,-14
20076,0,0,46,0,-46
20077,0,0,15,0,-15
20078,1,1,224,3161,2937
20079,1,1,406,1339,933
20080,0,0,236,0,-236
20081,1,0,10,0,-10
20082,1,1,1462,1564,102
20083,1,0,78,0,-78
20084,1,1,1068,1773,705
20085,0,0,13,0,-13
20086,0,0,16,0,-16
20087,1,0,13,0,-13
20088,1,0,7,0,-7
20089,1,0,12,0,-12
20090,1,0,41,0,-41
20091,0,0,76,0,-76
20092,1,0,5,0,-5
20093,1,0,7,0,-7
20094,1,1,203,1292,1089
20095,1,1,294,1310,1016
20096,1,0,44,0,-44
20097,1,0,25,0,-25
20098,1,1,120,1321,1201
20099,1,1,350,1298,948
20100,1,1,2627,1374,-1253
20101,0,0,2,0,-2
20102,1,1,184,1562,1378
20103,0,0,26,0,-26
20104,1,1,2561,1286,-1275
20105,1,0,64,0,-64
20106,0,0,66,0,-66
20107,1,0,10,0,-10
20108,0,0,6,0,-6
20109,0,0,0,0,0
20110,1,1,549,1672,1123
20111,0,0,4,0,-4
20112,1,1,1367,1304,-63
20113,0,0,24,0,-24
20114,1,1,148,1319,1171
20115,1,1,143,1320,1177
20116,1,1,2166,2129,-37
20117,1,0,117,0,-117
20118,1,1,889,1274,385
20119,1,0,15,0,-15
20120,1,1,150,1538,1388
20121,1,1,768,1317,549
20122,0,0,45,0,-45
20123,0,0,50,0,-50
20124,0,0,75,0,-75
20125,1,1,2572,1886,-686
20126,1,1,934,1314,380
20127,0,0,61,0,-61
20128,0,0,74,0,-74
20129,1,0,24,0,-24
20130,0,0,100,0,-100
20131,0,0,33,0,-33
20132,1,0,44,0,-44
20133,1,0,57,0,-57
20134,0,0,87,0,-87
20135,1,1,123,1710,1587
20136,1,1,257,1668,1411
20137,0,0,70,0,-70
20138,0,0,7,0,-7
20139,1,0,68,0,-68
20140,0,0,105,0,-105
20141,0,0,2,0,-2
20142,1,0,18,0,-18
20143,0,0,167,0,-167
20144,1,0,76,0,-76
20145,0,0,15,0,-15
20146,0,0,3,0,-3
20147,0,0,24,0,-24
20148,1,0,75,0,-75
20149,0,0,54,0,-54
20150,0,0,97,0,-97
20151,1,0,30,0,-30
20152,1,0,4,0,-4
20153,0,0,9,0,-9
20154,1,0,3,0,-3
20155,0,0,18,0,-18
20156,1,1,507,1388,881
20157,1,1,1033,1502,469
20158,1,0,9,0,-9
20159,0,0,41,0,-41
20160,1,1,539,1301,762
20161,1,1,57,1278,1221
20162,1,0,14,0,-14
20163,1,1,395,2117,1722
20164,1,1,197,1495,1298
20165,0,0,0,0,0
20166,0,0,31,0,-31
20167,1,0,16,0,-16
20168,0,0,3,0,-3
20169,0,0,14,0,-14
20170,0,0,30,0,-30
20171,0,0,187,0,-187
20172,0,0,12,0,-12
20173,0,0,17,0,-17
20174,0,0,40,0,-40
20175,1,0,63,0,-63
20176,1,1,456,1436,980
20177,1,0,2,0,-2
20178,1,1,49,1570,1521
20179,0,0,7,0,-7
20180,0,0,3,0,-3
20181,1,1,612,1304,692
20182,1,0,25,0,-25
20183,0,0,41,0,-41
20184,0,0,33,0,-33
20185,1,1,263,1403,1140
20186,0,0,81,0,-81
20187,0,0,13,0,-13
20188,1,0,123,0,-123
20189,1,1,293,1226,933
20190,1,0,13,0,-13
20191,1,1,503,1212,709
20192,1,0,53,0,-53
20193,0,0,20,0,-20
20194,1,0,13,0,-13
20195,1,0,54,0,-54
20196,0,0,27,0,-27
20197,1,0,67,0,-67
20198,1,1,925,1945,1020
20199,0,0,1,0,-1
20200,1,1,939,1602,663
20201,1,1,179,1268,1089
20202,1,0,58,0,-58
20203,0,0,8,0,-8
20204,0,0,7,0,-7
20205,0,0,49,0,-49
20206,0,0,206,0,-206
20207,1,0,73,0,-73
20208,0,0,24,0,-24
20209,1,1,398,1954,1556
20210,1,0,25,0,-25
20211,0,0,10,0,-10
20212,0,0,23,0,-23
20213,0,0,7,0,-7
20214,1,1,1501,1666,165
20215,1,0,7,0,-7
20216,0,0,26,0,-26
20217,1,1,304,1338,1034
20218,1,1,821,1414,593
20219,1,1,616,1548,932
20220,1,1,736,1545,809
20221,1,1,1979,1916,-63
20222,1,0,13,0,-13
20223,0,0,7,0,-7
20224,0,0,20,0,-20
20225,0,0,75,0,-75
20226,1,0,26,0,-26
20227,1,1,2125,1388,-737
20228,0,0,13,0,-13
20229,1,0,92,0,-92
20230,1,0,5,0,-5
20231,0,0,52,0,-52
20232,1,1,250,1332,1082
20233,1,1,186,1911,1725
20234,1,1,1382,1384,2
20235,0,0,1,0,-1
20236,1,1,739,1997,1258
20237,0,0,30,0,-30
20238,0,0,50,0,-50
20239,1,0,9,0,-9
20240,0,0,41,0,-41
20241,1,0,24,0,-24
20242,1,0,123,0,-123
20243,0,0,84,0,-84
20244,1,0,67,0,-67
20245,1,1,434,1610,1176
20246,0,0,6,0,-6
20247,1,1,456,1542,1086
20248,0,0,12,0,-12
20249,1,1,19,1542,1523
20250,1,0,5,0,-5
20251,1,0,53,0,-53
20252,1,0,151,0,-151
20253,0,0,28,0,-28
20254,1,0,20,0,-20
20255,1,0,19,0,-19
20256,1,1,192,1303,1111
20257,1,1,344,1366,1022
20258,1,1,512,1244,732
20259,1,1,113,1513,1400
20260,0,0,22,0,-22
20261,0,0,1,0,-1
20262,0,0,39,0,-39
20263,0,0,80,0,-80
20264,1,0,2,0,-2
20265,0,0,16,0,-16
20266,0,0,58,0,-58
20267,1,1,973,1422,449
20268,1,1,285,1605,1320
20269,1,1,659,1401,742
20270,0,0,8,0,-8
20271,0,0,38,0,-38
20272,0,0,49,0,-49
20273,1,0,17,0,-17
20274,1,1,664,1333,669
20275,1,0,14,0,-14
20276,1,1,171,1256,1085
20277,1,1,486,1561,1075
20278,0,0,32,0,-32
20279,0,0,38,0,-38
20280,0,0,8,0,-8
20281,1,0,155,0,-155
20282,1,1,597,2137,1540
20283,0,0,27,0,-27
20284,0,0,79,0,-79
20285,1,1,653,1216,563
20286,0,0,0,0,0
20287,1,1,414,1356,942
20288,1,1,158,1767,1609
20289,0,0,108,0,-108
20290,1,1,415,1458,1043
20291,0,0,25,0,-25
20292,1,1,1241,1352,111
20293,1,1,234,1303,1069
20294,1,1,121,1346,1225
20295,0,0,39,0,-39
20296,0,0,67,0,-67
20297,1,1,111,1331,1220
20298,0,0,391,0,-391
20299,1,0,169,0,-169
20300,0,0,18,0,-18
20301,1,1,1822,1272,-550
20302,1,0,136,0,-136
20303,0,0,104,0,-104
20304,0,0,36,0,-36
20305,0,0,27,0,-27
20306,0,0,16,0,-16
20307,1,0,21,0,-21
20308,1,0,6,0,-6
20309,1,0,2,0,-2
20310,0,0,2,0,-2
20311,1,1,490,1299,809
20312,1,0,58,0,-58
20313,0,0,4,0,-4
20314,1,1,196,1327,1131
20315,1,1,148,5229,5081
20316,1,0,43,0,-43
20317,1,0,8,0,-8
20318,1,0,98,0,-98
20319,1,0,16,0,-16
20320,1,1,74,1760,1686
20321,0,0,40,0,-40
20322,0,0,30,0,-30
20323,1,1,1085,1413,328
20324,0,0,4,0,-4
20325,1,0,19,0,-19
20326,1,1,186,1208,1022
20327,0,0,73,0,-73
20328,1,0,184,0,-184
20329,1,1,184,1434,1250
20330,1,1,95,2154,2059
20331,1,1,2137,1285,-852
20332,1,0,9,0,-9
20333,1,1,374,1795,1421
20334,1,1,552,2692,2140
20335,1,1,816,1731,915
20336,1,1,273,1672,1399
20337,0,0,44,0,-44
20338,1,0,1,0,-1
20339,0,0,11,0,-11
20340,1,0,12,0,-12
20341,1,0,20,0,-20
20342,1,0,0,0,0
20343,0,0,62,0,-62
20344,0,0,11,0,-11
20345,0,0,7,0,-7
20346,1,0,136,0,-136
20347,1,1,460,1232,772
20348,0,0,7,0,-7
20349,1,1,791,1221,430
20350,1,0,137,0,-137
20351,1,0,51,0,-51
20352,1,0,2,0,-2
20353,0,0,5,0,-5
20354,1,1,104,1752,1648
20355,1,0,61,0,-61
20356,0,0,15,0,-15
20357,1,1,402,2053,1651
20358,0,0,109,0,-109
20359,0,0,8,0,-8
20360,0,0,19,0,-19
20361,1,1,183,1317,1134
20362,0,0,100,0,-100
20363,0,0,58,0,-58
20364,0,0,7,0,-7
20365,1,1,680,2178,1498
20366,1,1,533,1282,749
20367,1,0,157,0,-157
20368,1,0,107,0,-107
20369,1,0,46,0,-46
20370,0,0,116,0,-116
20371,0,0,115,0,-115
20372,1,0,75,0,-75
20373,0,0,86,0,-86
20374,1,0,82,0,-82
20375,0,0,62,0,-62
20376,1,0,83,0,-83
20377,0,0,13,0,-13
20378,1,0,53,0,-53
20379,0,0,17,0,-17
20380,1,0,12,0,-12
20381,1,1,182,1333,1151
20382,1,1,1011,1350,339
20383,0,0,10,0,-10
20384,1,0,19,0,-19
20385,0,0,24,0,-24
20386,1,0,102,0,-102
20387,0,0,18,0,-18
20388,1,1,261,2262,2001
20389,1,1,1815,1288,-527
20390,1,0,10,0,-10
20391,1,1,315,1292,977
20392,0,0,43,0,-43
20393,0,0,24,0,-24
20394,1,1,313,1248,935
20395,0,0,24,0,-24
20396,1,0,57,0,-57
20397,0,0,26,0,-26
20398,1,1,294,1321,1027
20399,0,0,95,0,-95
20400,1,1,237,1466,1229
20401,1,0,23,0,-23
20402,1,1,636,1279,643
20403,0,0,35,0,-35
20404,1,1,159,1515,1356
20405,1,0,15,0,-15
20406,1,1,150,1786,1636
20407,0,0,21,0,-21
20408,1,1,869,1246,377
20409,1,0,144,0,-144
20410,1,1,619,1354,735
20411,1,0,24,0,-24
20412,0,0,36,0,-36
20413,1,0,112,0,-112
20414,0,0,67,0,-67
20415,0,0,67,0,-67
20416,1,0,24,0,-24
20417,0,0,77,0,-77
20418,0,0,131,0,-131
20419,1,0,49,0,-49
20420,1,0,14,0,-14
20421,1,1,123,1503,1380
20422,1,1,87,1206,1119
20423,0,0,48,0,-48
20424,1,1,196,1414,1218
20425,0,0,35,0,-35
20426,0,0,44,0,-44
20427,0,0,34,0,-34
20428,1,0,0,0,0
20429,1,0,64,0,-64
20430,1,1,344,1425,1081
20431,0,0,152,0,-152
20432,1,0,6,0,-6
20433,1,0,52,0,-52
20434,1,0,19,0,-19
20435,0,0,42,0,-42
20436,0,0,9,0,-9
20437,1,1,1179,1234,55
20438,1,0,8,0,-8
20439,0,0,20,0,-20
20440,0,0,11,0,-11
20441,1,0,13,0,-13
20442,0,0,86,0,-86
20443,1,1,277,1582,1305
20444,0,0,120,0,-120
20445,1,0,19,0,-19
20446,1,0,43,0,-43
20447,1,1,361,1280,919
20448,1,0,7,0,-7
20449,0,0,51,0,-51
20450,1,0,140,0,-140
20451,1,0,6,0,-6
20452,1,1,2190,1803,-387
20453,1,1,1648,1685,37
20454,0,0,15,0,-15
20455,1,0,23,0,-23
20456,1,1,221,1247,1026
20457,1,1,699,1632,933
20458,0,0,22,0,-22
20459,1,1,991,1211,220
20460,1,0,24,0,-24
20461,1,0,60,0,-60
20462,1,1,894,1303,409
20463,1,1,58,1548,1490
20464,1,0,206,0,-206
20465,1,0,24,0,-24
20466,1,0,11,0,-11
20467,0,0,15,0,-15
20468,1,0,21,0,-21
20469,1,1,461,2154,1693
20470,1,1,1051,1402,351
20471,0,0,100,0,-100
20472,1,1,537,1364,827
20473,1,1,1121,1750,629
20474,1,1,733,1656,923
20475,1,0,30,0,-30
20476,0,0,27,0,-27
20477,1,1,138,1389,1251
20478,1,1,343,1305,962
20479,0,0,14,0,-14
20480,0,0,177,0,-177
20481,0,0,41,0,-41
20482,1,0,15,0,-15
20483,0,0,64,0,-64
20484,1,0,135,0,-135
20485,1,0,1,0,-1
20486,1,1,655,1544,889
20487,0,0,25,0,-25
20488,1,0,78,0,-78
20489,0,0,17,0,-17
20490,1,1,618,1263,645
20491,0,0,40,0,-40
20492,1,1,152,2726,2574
20493,1,1,106,1600,1494
20494,1,1,42,1468,1426
20495,0,0,56,0,-56
20496,1,0,32,0,-32
20497,1,1,562,1246,684
20498,1,0,40,0,-40
20499,1,1,232,1564,1332
20500,1,1,260,1693,1433
20501,1,1,297,1396,1099
20502,1,0,46,0,-46
20503,0,0,133,0,-133
20504,0,0,2,0,-2
20505,1,1,1403,1641,238
20506,0,0,54,0,-54
20507,1,0,12,0,-12
20508,0,0,106,0,-106
20509,1,1,63,1344,1281
20510,0,0,26,0,-26
20511,1,0,61,0,-61
20512,1,0,20,0,-20
20513,1,0,137,0,-137
20514,0,0,77,0,-77
20515,0,0,256,0,-256
20516,1,1,1275,1479,204
20517,1,0,106,0,-106
20518,1,0,119,0,-119
20519,0,0,24,0,-24
20520,0,0,42,0,-42
20521,1,1,835,1701,866
20522,1,1,302,1249,947
20523,1,0,1,0,-1
20524,1,1,170,1905,1735
20525,0,0,51,0,-51
20526,0,0,14,0,-14
20527,0,0,4,0,-4
20528,1,0,21,0,-21
20529,1,0,79,0,-79
20530,0,0,6,0,-6
20531,0,0,139,0,-139
20532,1,1,1665,1589,-76
20533,1,1,1235,1221,-14
20534,1,1,181,1485,1304
20535,1,1,620,2303,1683
20536,0,0,2,0,-2
20537,1,1,229,1349,1120
20538,1,0,35,0,-35
20539,0,0,73,0,-73
20540,1,0,22,0,-22
20541,1,1,117,2210,2093
20542,1,0,56,0,-56
20543,1,0,0,0,0
20544,1,0,12,0,-12
20545,0,0,31,0,-31
20546,1,1,103,1724,1621
20547,0,0,4,0,-4
20548,0,0,29,0,-29
20549,0,0,46,0,-46
20550,0,0,22,0,-22
20551,0,0,40,0,-40
20552,0,0,37,0,-37
20553,1,1,549,1394,845
20554,1,0,13,0,-13
20555,1,1,337,1465,1128
20556,1,1,117,1445,1328
20557,0,0,13,0,-13
20558,0,0,11,0,-11
20559,1,1,149,1565,1416
20560,1,0,72,0,-72
20561,1,1,59,1322,1263
20562,1,0,12,0,-12
20563,1,0,2,0,-2
20564,0,0,67,0,-67
20565,0,0,93,0,-93
20566,1,1,411,1575,1164
20567,0,0,64,0,-64
20568,1,0,277,0,-277
20569,1,1,262,1389,1127
20570,0,0,82,0,-82
20571,1,1,86,2345,2259
20572,1,0,55,0,-55
20573,1,0,35,0,-35
20574,0,0,173,0,-173
20575,0,0,80,0,-80
20576,1,1,50,1287,1237
20577,1,0,58,0,-58
20578,1,0,63,0,-63
20579,0,0,96,0,-96
20580,0,0,149,0,-149
20581,1,0,120,0,-120
20582,1,0,62,0,-62
20583,0,0,19,0,-19
20584,1,1,144,1633,1489
20585,0,0,72,0,-72
20586,0,0,20,0,-20
20587,1,1,101,3534,3433
20588,0,0,92,0,-92
20589,1,1,248,1202,954
20590,0,0,28,0,-28
20591,0,0,1,0,-1
20592,1,0,157,0,-157
20593,1,1,29,1341,1312
20594,1,1,188,1463,1275
20595,1,0,15,0,-15
20596,0,0,1,0,-1
20597,1,1,47,1215,1168
20598,1,1,464,2427,1963
20599,1,0,11,0,-11
20600,0,0,52,0,-52
20601,1,0,141,0,-141
20602,1,0,69,0,-69
20603,0,0,2,0,-2
20604,0,0,10,0,-10
20605,0,0,37,0,-37
20606,1,0,29,0,-29
20607,1,0,18,0,-18
20608,1,1,1330,1213,-117
20609,1,0,25,0,-25
20610,1,0,70,0,-70
20611,1,0,21,0,-21
20612,1,1,185,1209,1024
20613,0,0,148,0,-148
20614,0,0,20,0,-20
20615,0,0,58,0,-58
20616,1,1,140,1878,1738
20617,1,1,244,1421,1177
20618,1,0,0,0,0
20619,0,0,9,0,-9
20620,1,0,14,0,-14
20621,0,0,24,0,-24
20622,0,0,20,0,-20
20623,0,0,21,0,-21
20624,1,0,2,0,-2
20625,1,1,59,1309,1250
20626,0,0,140,0,-140
20627,0,0,14,0,-14
20628,1,0,2,0,-2
20629,0,0,158,0,-158
20630,1,1,76,1306,1230
20631,0,0,52,0,-52
20632,1,0,75,0,-75
20633,1,0,1,0,-1
20634,1,0,20,0,-20
20635,0,0,9,0,-9
20636,1,0,93,0,-93
20637,0,0,48,0,-48
20638,0,0,56,0,-56
20639,1,0,1,0,-1
20640,1,1,137,1385,1248
20641,1,1,1770,1269,-501
20642,1,1,688,1880,1192
20643,1,0,85,0,-85
20644,1,1,336,1223,887
20645,0,0,9,0,-9
20646,1,0,18,0,-18
20647,0,0,109,0,-109
20648,1,1,305,1864,1559
20649,0,0,14,0,-14
20650,1,0,28,0,-28
20651,1,1,61,1546,1485
20652,1,1,131,1519,1388
20653,0,0,28,0,-28
20654,1,1,156,1413,1257
20655,1,0,4,0,-4
20656,0,0,6,0,-6
20657,1,0,22,0,-22
20658,0,0,71,0,-71
20659,0,0,109,0,-109
20660,1,0,125,0,-125
20661,0,0,30,0,-30
20662,1,0,6,0,-6
20663,1,1,14,1806,1792
20664,0,0,40,0,-40
20665,1,1,1109,1294,185
20666,1,1,75,1380,1305
20667,0,0,3,0,-3
20668,0,0,28,0,-28
20669,1,0,12,0,-12
20670,1,1,137,1754,1617
20671,0,0,5,0,-5
20672,0,0,24,0,-24
20673,1,1,262,1208,946
20674,1,0,65,0,-65
20675,1,1,325,1316,991
20676,0,0,12,0,-12
20677,1,1,110,4633,4523
20678,0,0,12,0,-12
20679,1,1,574,1333,759
20680,1,0,0,0,0
20681,1,1,414,1842,1428
20682,1,1,452,1433,981
20683,0,0,7,0,-7
20684,0,0,54,0,-54
20685,0,0,37,0,-37
20686,0,0,4,0,-4
20687,1,0,71,0,-71
20688,0,0,42,0,-42
20689,1,0,28,0,-28
20690,0,0,8,0,-8
20691,1,0,30,0,-30
20692,1,1,597,1419,822
20693,1,1,445,1580,1135
20694,1,0,30,0,-30
20695,0,0,45,0,-45
20696,0,0,12,0,-12
20697,1,0,122,0,-122
20698,0,0,12,0,-12
20699,1,1,211,1741,1530
20700,1,0,21,0,-21
20701,1,0,27,0,-27
20702,0,0,18,0,-18
20703,1,0,184,0,-184
20704,1,0,49,0,-49
20705,0,0,18,0,-18
20706,1,0,14,0,-14
20707,0,0,44,0,-44
20708,1,1,75,1381,1306
20709,1,0,30,0,-30
20710,1,1,136,1371,1235
20711,1,0,111,0,-111
20712,0,0,73,0,-73
20713,1,1,1565,1272,-293
20714,1,0,46,0,-46
20715,1,0,52,0,-52
20716,1,0,12,0,-12
20717,1,1,1208,1494,286
20718,1,1,899,1551,652
20719,1,1,174,1414,1240
20720,1,0,150,0,-150
20721,1,1,183,1235,1052
20722,0,0,36,0,-36
20723,1,1,287,2214,1927
20724,1,1,166,2222,2056
20725,1,1,197,1258,1061
20726,1,1,250,1258,1008
20727,1,0,11,0,-11
20728,0,0,18,0,-18
20729,0,0,7,0,-7
20730,1,0,1,0,-1
20731,1,1,68,1214,1146
20732,1,1,89,1648,1559
20733,1,1,389,1755,1366
20734,1,1,400,1978,1578
20735,0,0,69,0,-69
20736,1,0,21,0,-21
20737,0,0,9,0,-9
20738,1,0,28,0,-28
20739,1,0,12,0,-12
20740,1,0,52,0,-52
20741,1,1,356,1846,1490
20742,1,1,500,1211,711
20743,1,0,2,0,-2
20744,1,1,281,1486,1205
20745,1,1,74,1251,1177
20746,0,0,45,0,-45
20747,1,0,46,0,-46
20748,0,0,22,0,-22
20749,1,1,348,2759,2411
20750,1,1,515,1793,1278
20751,1,0,95,0,-95
20752,0,0,127,0,-127
20753,0,0,27,0,-27
20754,1,0,62,0,-62
20755,1,1,36,1849,1813
20756,1,0,19,0,-19
20757,0,0,57,0,-57
20758,0,0,13,0,-13
20759,1,0,82,0,-82
20760,1,0,50,0,-50
20761,1,1,475,1442,967
20762,0,0,26,0,-26
20763,0,0,29,0,-29
20764,1,1,1339,1339,0
20765,1,0,41,0,-41
20766,1,1,1107,1323,216
20767,0,0,50,0,-50
20768,1,1,430,2052,1622
20769,1,1,1160,1284,124
20770,1,0,295,0,-295
20771,1,1,883,1294,411
20772,1,0,106,0,-106
20773,1,0,22,0,-22
20774,1,0,13,0,-13
20775,0,0,8,0,-8
20776,1,1,348,1387,1039
20777,1,0,14,0,-14
20778,1,0,22,0,-22
20779,1,1,178,1844,1666
20780,1,0,26,0,-26
20781,1,1,240,1791,1551
20782,0,0,81,0,-81
20783,1,0,79,0,-79
20784,0,0,137,0,-137
20785,0,0,53,0,-53
20786,0,0,65,0,-65
20787,1,1,126,1413,1287
20788,0,0,3,0,-3
20789,1,1,708,1201,493
20790,1,0,63,0,-63
20791,0,0,19,0,-19
20792,0,0,33,0,-33
20793,1,0,45,0,-45
20794,1,0,39,0,-39
20795,1,0,5,0,-5
20796,1,0,76,0,-76
20797,1,1,2292,1598,-694
20798,1,1,349,2171,1822
20799,0,0,31,0,-31
20800,1,0,49,0,-49
20801,1,1,143,1289,1146
20802,0,0,42,0,-42
20803,1,1,1021,1232,211
20804,1,1,229,1417,1188
20805,1,1,570,4060,3490
20806,1,0,2,0,-2
20807,1,0,21,0,-21
20808,1,1,492,1652,1160
20809,0,0,115,0,-115
20810,1,1,38,1410,1372
20811,1,0,87,0,-87
20812,1,0,15,0,-15
20813,0,0,1,0,-1
20814,1,0,10,0,-10
20815,1,1,168,1310,1142
20816,1,1,712,1672,960
20817,1,1,140,1817,1677
20818,1,1,393,1231,838
20819,0,0,61,0,-61
20820,1,0,9,0,-9
20821,0,0,25,0,-25
20822,1,0,1,0,-1
20823,1,0,47,0,-47
20824,1,1,543,1516,973
20825,1,1,2282,1288,-994
20826,0,0,124,0,-124
20827,1,0,64,0,-64
20828,0,0,40,0,-40
20829,1,0,105,0,-105
20830,1,1,1661,1315,-346
20831,0,0,142,0,-142
20832,1,1,1714,1434,-280
20833,0,0,127,0,-127
20834,1,0,24,0,-24
20835,1,1,511,1430,919
20836,1,0,9,0,-9
20837,0,0,25,0,-25
20838,1,0,37,0,-37
20839,0,0,23,0,-23
20840,0,0,33,0,-33
20841,0,0,18,0,-18
20842,1,1,675,1307,632
20843,0,0,79,0,-79
20844,1,1,341,2302,1961
20845,0,0,44,0,-44
20846,1,1,475,1402,927
20847,0,0,108,0,-108
20848,0,0,32,0,-32
20849,1,0,10,0,-10
20850,1,0,191,0,-191
20851,0,0,50,0,-50
20852,1,1,573,2238,1665
20853,0,0,28,0,-28
20854,1,0,63,0,-63
20855,1,0,124,0,-124
20856,1,0,43,0,-43
20857,1,1,279,1389,1110
20858,1,0,15,0,-15
20859,1,0,17,0,-17
20860,0,0,24,0,-24
20861,0,0,118,0,-118
20862,0,0,94,0,-94
20863,0,0,19,0,-19
20864,1,0,5,0,-5
20865,1,1,147,1223,1076
20866,0,0,15,0,-15
20867,1,0,5,0,-5
20868,1,0,13,0,-13
20869,1,1,2061,1229,-832
20870,0,0,12,0,-12
20871,0,0,53,0,-53
20872,1,0,18,0,-18
20873,1,0,91,0,-91
20874,0,0,1,0,-1
20875,1,0,62,0,-62
20876,1,1,127,1202,1075
20877,1,1,1575,1359,-216
20878,0,0,221,0,-221
20879,1,1,482,1333,851
20880,1,0,225,0,-225
20881,1,1,154,1244,1090
20882,0,0,7,0,-7
20883,0,0,46,0,-46
20884,1,1,1876,1534,-342
20885,0,0,82,0,-82
20886,1,1,1274,2132,858
20887,1,0,30,0,-30
20888,1,0,63,0,-63
20889,1,0,160,0,-160
20890,1,0,14,0,-14
20891,0,0,34,0,-34
20892,1,1,463,1668,1205
20893,1,0,70,0,-70
20894,0,0,29,0,-29
20895,1,1,249,1453,1204
20896,0,0,170,0,-170
20897,1,0,9,0,-9
20898,1,1,1155,1247,92
20899,0,0,1,0,-1
20900,1,0,145,0,-145
20901,1,1,149,1774,1625
20902,0,0,98,0,-98
20903,0,0,41,0,-41
20904,1,0,126,0,-126
20905,0,0,44,0,-44
20906,0,0,55,0,-55
20907,1,1,1973,1319,-654
20908,1,1,101,1614,1513
20909,0,0,0,0,0
20910,1,1,756,2413,1657
20911,1,1,1824,1230,-594
20912,0,0,4,0,-4
20913,1,1,565,1429,864
20914,0,0,6,0,-6
20915,1,0,1,0,-1
20916,1,1,266,1665,1399
20917,1,0,7,0,-7
20918,1,0,13,0,-13
20919,1,0,6,0,-6
20920,1,0,11,0,-11
20921,1,1,381,1230,849
20922,1,0,44,0,-44
20923,1,1,213,1268,1055
20924,0,0,70,0,-70
20925,1,0,50,0,-50
20926,1,1,126,1312,1186
20927,1,1,53,1605,1552
20928,0,0,2,0,-2
20929,0,0,16,0,-16
20930,1,1,1299,1373,74
20931,1,1,711,1662,951
20932,1,1,166,1653,1487
20933,1,1,208,1444,1236
20934,0,0,14,0,-14
20935,1,1,22,1626,1604
20936,0,0,40,0,-40
20937,0,0,196,0,-196
20938,1,1,994,1361,367
20939,1,0,11,0,-11
20940,0,0,66,0,-66
20941,0,0,31,0,-31
20942,0,0,19,0,-19
20943,1,0,12,0,-12
20944,0,0,24,0,-24
20945,1,1,205,1333,1128
20946,1,0,0,0,0
20947,0,0,34,0,-34
20948,1,1,403,1441,1038
20949,1,1,403,1594,1191
20950,1,1,181,1221,1040
20951,0,0,40,0,-40
20952,0,0,71,0,-71
20953,1,1,274,1427,1153
20954,0,0,7,0,-7
20955,0,0,93,0,-93
20956,0,0,20,0,-20
20957,0,0,10,0,-10
20958,1,1,315,1471,1156
20959,0,0,56,0,-56
20960,1,0,1,0,-1
20961,0,0,130,0,-130
20962,0,0,9,0,-9
20963,1,1,405,1227,822
20964,0,0,53,0,-53
20965,1,0,0,0,0
20966,1,1,1924,1250,-674
20967,1,1,138,1296,1158
20968,1,1,133,1401,1268
20969,0,0,107,0,-107
20970,0,0,144,0,-144
20971,1,1,129,1270,1141
20972,1,1,289,1226,937
20973,0,0,117,0,-117
20974,1,0,82,0,-82
20975,0,0,2,0,-2
20976,1,1,624,1326,702
20977,0,0,81,0,-81
20978,1,0,126,0,-126
20979,1,1,581,1412,831
20980,1,0,36,0,-36
20981,1,0,2,0,-2
20982,0,0,48,0,-48
20983,1,0,150,0,-150
20984,0,0,49,0,-49
20985,1,1,1004,1823,819
20986,0,0,2,0,-2
20987,1,1,111,1239,1128
20988,1,1,1395,1307,-88
20989,1,0,40,0,-40
20990,1,0,1,0,-1
20991,1,0,89,0,-89
20992,0,0,149,0,-149
20993,1,1,456,1479,1023
20994,1,0,27,0,-27
20995,1,1,359,1211,852
20996,0,0,8,0,-8
20997,1,0,32,0,-32
20998,1,1,1688,1229,-459
20999,1,1,386,1572,1186
21000,1,1,995,1433,438
21001,0,0,31,0,-31
21002,1,0,56,0,-56
21003,0,0,6,0,-6
21004,0,0,6,0,-6
21005,1,1,349,1229,880
21006,1,1,590,1659,1069
21007,1,1,868,1408,540
21008,1,0,91,0,-91
21009,0,0,36,0,-36
21010,1,1,541,3248,2707
21011,1,0,17,0,-17
21012,0,0,17,0,-17
21013,0,0,135,0,-135
21014,1,0,54,0,-54
21015,0,0,77,0,-77
21016,1,1,594,1241,647
21017,1,0,7,0,-7
21018,1,0,66,0,-66
21019,0,0,119,0,-119
21020,1,0,22,0,-22
21021,0,0,27,0,-27
21022,1,1,894,1334,440
21023,0,0,151,0,-151
21024,1,0,65,0,-65
21025,1,0,23,0,-23
21026,1,0,50,0,-50
21027,0,0,0,0,0
21028,0,0,51,0,-51
21029,1,0,7,0,-7
21030,1,1,1264,1353,89
21031,1,1,179,1236,1057
21032,0,0,87,0,-87
21033,0,0,55,0,-55
21034,1,0,43,0,-43
21035,1,0,56,0,-56
21036,1,0,0,0,0
21037,1,0,76,0,-76
21038,0,0,14,0,-14
21039,0,0,121,0,-121
21040,1,1,1360,1229,-131
21041,0,0,115,0,-115
21042,1,0,58,0,-58
21043,0,0,181,0,-181
21044,0,0,26,0,-26
21045,1,1,229,2721,2492
21046,0,0,77,0,-77
21047,1,0,1,0,-1
21048,1,1,403,1326,923
21049,1,1,772,1803,1031
21050,1,0,24,0,-24
21051,1,1,156,1244,1088
21052,0,0,6,0,-6
21053,1,1,461,1678,1217
21054,1,0,37,0,-37
21055,1,0,30,0,-30
21056,0,0,73,0,-73
21057,1,0,34,0,-34
21058,1,1,285,2352,2067
21059,1,1,10,1515,1505
21060,0,0,0,0,0
21061,0,0,18,0,-18
21062,1,1,40,2044,2004
21063,0,0,124,0,-124
21064,1,0,5,0,-5
21065,1,1,2098,1485,-613
21066,0,0,4,0,-4
21067,1,1,189,1516,1327
21068,1,1,527,1526,999
21069,0,0,32,0,-32
21070,0,0,24,0,-24
21071,0,0,34,0,-34
21072,0,0,40,0,-40
21073,1,1,623,1514,891
21074,0,0,33,0,-33
21075,1,0,121,0,-121
21076,1,1,242,1338,1096
21077,0,0,16,0,-16
21078,0,0,147,0,-147
21079,1,0,68,0,-68
21080,1,1,861,1613,752
21081,0,0,27,0,-27
21082,0,0,16,0,-16
21083,1,1,295,1878,1583
21084,0,0,5,0,-5
21085,1,1,48,1208,1160
21086,0,0,35,0,-35
21087,1,0,45,0,-45
21088,0,0,55,0,-55
21089,0,0,72,0,-72
21090,0,0,11,0,-11
21091,1,0,60,0,-60
21092,1,0,1,0,-1
21093,1,1,450,1584,1134
21094,1,0,1,0,-1
21095,1,0,34,0,-34
21096,0,0,0,0,0
21097,1,0,0,0,0
21098,1,0,29,0,-29
21099,0,0,29,0,-29
21100,0,0,19,0,-19
21101,1,0,36,0,-36
21102,1,1,157,1258,1101
21103,0,0,38,0,-38
21104,1,0,12,0,-12
21105,1,1,297,1366,1069
21106,1,1,128,1899,1771
21107,1,1,400,1791,1391
21108,0,0,7,0,-7
21109,1,0,39,0,-39
21110,0,0,63,0,-63
21111,1,1,339,1595,1256
21112,1,1,1883,1277,-606
21113,0,0,66,0,-66
21114,0,0,17,0,-17
21115,1,0,46,0,-46
21116,1,0,39,0,-39
21117,1,1,1362,1203,-159
21118,0,0,10,0,-10
21119,0,0,63,0,-63
21120,0,0,144,0,-144
21121,1,0,23,0,-23
21122,1,1,308,1311,1003
21123,1,1,1069,2170,1101
21124,1,0,3,0,-3
21125,1,0,14,0,-14
21126,1,1,523,4133,3610
21127,1,1,67,1591,1524
21128,0,0,20,0,-20
21129,0,0,45,0,-45
21130,1,1,102,1257,1155
21131,1,0,39,0,-39
21132,1,0,57,0,-57
21133,1,0,125,0,-125
21134,1,0,50,0,-50
21135,1,0,42,0,-42
21136,1,0,2,0,-2
21137,1,1,846,1414,568
21138,1,0,126,0,-126
21139,1,1,135,1204,1069
21140,0,0,38,0,-38
21141,0,0,18,0,-18
21142,0,0,27,0,-27
21143,0,0,42,0,-42
21144,0,0,9,0,-9
21145,0,0,17,0,-17
21146,0,0,112,0,-112
21147,1,1,447,1742,1295
21148,1,0,4,0,-4
21149,1,0,32,0,-32
21150,1,0,13,0,-13
21151,1,0,125,0,-125
21152,1,1,1076,2493,1417
21153,1,1,497,3228,2731
21154,0,0,13,0,-13
21155,1,1,278,1206,928
21156,1,1,318,1487,1169
21157,0,0,0,0,0
21158,1,1,376,1228,852
21159,0,0,60,0,-60
21160,0,0,27,0,-27
21161,0,0,40,0,-40
21162,1,0,107,0,-107
21163,0,0,3,0,-3
21164,1,0,2,0,-2
21165,1,0,41,0,-41
21166,0,0,7,0,-7
21167,1,1,129,1837,1708
21168,1,0,34,0,-34
21169,0,0,31,0,-31
21170,1,0,76,0,-76
21171,1,0,6,0,-6
21172,1,1,195,3120,2925
21173,0,0,90,0,-90
21174,0,0,44,0,-44
21175,1,0,0,0,0
21176,1,0,66,0,-66
21177,1,1,178,2210,2032
21178,1,0,21,0,-21
21179,1,1,193,1214,1021
21180,1,0,3,0,-3
21181,0,0,5,0,-5
21182,1,0,5,0,-5
21183,0,0,36,0,-36
21184,0,0,20,0,-20
21185,0,0,48,0,-48
21186,1,1,296,1241,945
21187,1,0,55,0,-55
21188,1,1,341,1550,1209
21189,0,0,122,0,-122
21190,1,1,538,1402,864
21191,0,0,16,0,-16
21192,0,0,55,0,-55
21193,1,1,45,1353,1308
21194,1,1,828,1539,711
21195,0,0,90,0,-90
21196,1,0,119,0,-119
21197,1,1,179,1546,1367
21198,1,1,943,4837,3894
21199,1,0,16,0,-16
21200,1,1,349,1687,1338
21201,1,1,454,1477,1023
21202,0,0,71,0,-71
21203,1,1,407,1714,1307
21204,1,0,18,0,-18
21205,1,1,1451,1203,-248
21206,1,1,107,1460,1353
21207,0,0,144,0,-144
21208,0,0,45,0,-45
21209,1,0,24,0,-24
21210,0,0,2,0,-2
21211,1,1,621,1244,623
21212,1,0,4,0,-4
21213,1,1,228,1730,1502
21214,1,1,801,1417,616
21215,1,0,79,0,-79
21216,1,0,94,0,-94
21217,0,0,28,0,-28
21218,1,0,13,0,-13
21219,1,1,810,2570,1760
21220,1,1,221,2236,2015
21221,1,0,7,0,-7
21222,0,0,53,0,-53
21223,1,0,1,0,-1
21224,0,0,16,0,-16
21225,1,1,1017,1449,432
21226,1,0,107,0,-107
21227,1,1,761,4657,3896
21228,0,0,41,0,-41
21229,1,1,1777,1859,82
21230,1,1,628,1215,587
21231,0,0,87,0,-87
21232,1,1,1718,1560,-158
21233,1,0,8,0,-8
21234,0,0,0,0,0
21235,1,1,763,1432,669
21236,1,0,100,0,-100
21237,1,0,8,0,-8
21238,0,0,73,0,-73
21239,1,1,446,1633,1187
21240,0,0,2,0,-2
21241,1,1,257,1723,1466
21242,1,0,23,0,-23
21243,0,0,15,0,-15
21244,0,0,4,0,-4
21245,1,1,561,1260,699
21246,1,0,52,0,-52
21247,1,0,6,0,-6
21248,0,0,13,0,-13
21249,0,0,175,0,-175
21250,0,0,61,0,-61
21251,0,0,113,0,-113
21252,1,0,75,0,-75
21253,1,1,84,1439,1355
21254,1,0,75,0,-75
21255,0,0,23,0,-23
21256,1,1,1067,1326,259
21257,0,0,12,0,-12
21258,1,0,17,0,-17
21259,0,0,89,0,-89
21260,1,1,468,2761,2293
21261,1,1,374,1997,1623
21262,1,0,37,0,-37
21263,1,0,4,0,-4
21264,0,0,7,0,-7
21265,0,0,44,0,-44
21266,0,0,45,0,-45
21267,1,0,10,0,-10
21268,0,0,13,0,-13
21269,0,0,19,0,-19
21270,1,1,1350,1353,3
21271,1,1,586,1406,820
21272,1,1,326,1468,1142
21273,0,0,6,0,-6
21274,0,0,51,0,-51
21275,0,0,12,0,-12
21276,1,1,96,2593,2497
21277,1,1,824,1404,580
21278,1,0,19,0,-19
21279,0,0,47,0,-47
21280,1,1,230,1410,1180
21281,1,0,1,0,-1
21282,0,0,33,0,-33
21283,1,0,5,0,-5
21284,0,0,67,0,-67
21285,1,1,601,1776,1175
21286,1,0,25,0,-25
21287,1,1,322,1452,1130
21288,1,1,650,1527,877
21289,0,0,13,0,-13
21290,0,0,92,0,-92
21291,1,1,307,1344,1037
21292,0,0,2,0,-2
21293,0,0,52,0,-52
21294,1,0,206,0,-206
21295,1,1,133,2553,2420
21296,1,1,762,1425,663
21297,0,0,32,0,-32
21298,0,0,18,0,-18
21299,0,0,8,0,-8
21300,1,0,80,0,-80
21301,1,1,1376,1218,-158
21302,0,0,62,0,-62
21303,1,1,298,1317,1019
21304,0,0,43,0,-43
21305,1,1,1205,2259,1054
21306,1,1,507,1224,717
21307,1,0,169,0,-169
21308,1,0,141,0,-141
21309,1,0,2,0,-2
21310,0,0,66,0,-66
21311,1,0,56,0,-56
21312,1,1,165,2542,2377
21313,0,0,175,0,-175
21314,0,0,48,0,-48
21315,0,0,86,0,-86
21316,0,0,124,0,-124
21317,1,1,6,1341,1335
21318,0,0,62,0,-62
21319,1,0,58,0,-58
21320,0,0,5,0,-5
21321,1,0,24,0,-24
21322,1,0,105,0,-105
21323,1,0,91,0,-91
21324,0,0,10,0,-10
21325,1,0,34,0,-34
21326,1,1,230,1441,1211
21327,0,0,9,0,-9
21328,0,0,7,0,-7
21329,0,0,24,0,-24
21330,1,1,32,1901,1869
21331,0,0,61,0,-61
21332,1,1,438,2598,2160
21333,0,0,20,0,-20
21334,0,0,97,0,-97
21335,0,0,30,0,-30
21336,1,0,2,0,-2
21337,0,0,13,0,-13
21338,1,1,656,1515,859
21339,0,0,85,0,-85
21340,1,1,15,1300,1285
21341,1,0,17,0,-17
21342,1,1,2281,1231,-1050
21343,1,0,6,0,-6
21344,1,1,1237,1599,362
21345,1,1,125,1716,1591
21346,1,1,217,1482,1265
21347,0,0,69,0,-69
21348,1,0,112,0,-112
21349,0,0,12,0,-12
21350,0,0,8,0,-8
21351,1,1,512,1463,951
21352,1,0,0,0,0
21353,1,1,928,1595,667
21354,1,0,25,0,-25
21355,1,0,11,0,-11
21356,1,0,32,0,-32
21357,0,0,12,0,-12
21358,0,0,31,0,-31
21359,1,0,21,0,-21
21360,0,0,64,0,-64
21361,1,0,53,0,-53
21362,0,0,1,0,-1
21363,1,0,29,0,-29
21364,1,0,134,0,-134
21365,1,0,33,0,-33
21366,1,0,57,0,-57
21367,0,0,84,0,-84
21368,1,0,12,0,-12
21369,0,0,142,0,-142
21370,0,0,191,0,-191
21371,0,0,61,0,-61
21372,1,1,168,1254,1086
21373,1,0,233,0,-233
21374,1,1,150,1445,1295
21375,0,0,35,0,-35
21376,1,0,143,0,-143
21377,0,0,48,0,-48
21378,1,1,743,2158,1415
21379,0,0,31,0,-31
21380,1,0,112,0,-112
21381,1,0,118,0,-118
21382,0,0,146,0,-146
21383,1,0,38,0,-38
21384,1,0,6,0,-6
21385,0,0,45,0,-45
21386,1,0,36,0,-36
21387,0,0,151,0,-151
21388,0,0,10,0,-10
21389,1,0,41,0,-41
21390,1,0,26,0,-26
21391,1,0,26,0,-26
21392,0,0,38,0,-38
21393,0,0,13,0,-13
21394,0,0,28,0,-28
21395,0,0,7,0,-7
21396,0,0,39,0,-39
21397,0,0,110,0,-110
21398,1,0,50,0,-50
21399,1,1,765,1205,440
21400,1,1,163,1729,1566
21401,0,0,15,0,-15
21402,1,0,62,0,-62
21403,1,1,807,1336,529
21404,1,0,53,0,-53
21405,1,1,516,1263,747
21406,1,0,27,0,-27
21407,0,0,66,0,-66
21408,0,0,56,0,-56
21409,1,1,569,1284,715
21410,1,0,83,0,-83
21411,1,1,175,1948,1773
21412,0,0,16,0,-16
21413,1,1,12,1351,1339
21414,1,1,367,1213,846
21415,1,0,263,0,-263
21416,1,0,159,0,-159
21417,1,0,32,0,-32
21418,0,0,73,0,-73
21419,0,0,113,0,-113
21420,1,1,1870,1892,22
21421,1,0,40,0,-40
21422,1,0,25,0,-25
21423,1,0,21,0,-21
21424,1,1,109,1631,1522
21425,1,0,22,0,-22
21426,0,0,28,0,-28
21427,1,1,2575,1285,-1290
21428,1,0,64,0,-64
21429,1,0,7,0,-7
21430,1,0,10,0,-10
21431,1,0,8,0,-8
21432,1,1,300,1215,915
21433,1,1,368,1267,899
21434,1,0,9,0,-9
21435,0,0,119,0,-119
21436,1,1,43,1220,1177
21437,1,0,57,0,-57
21438,0,0,27,0,-27
21439,1,0,26,0,-26
21440,1,1,78,1278,1200
21441,1,1,210,1724,1514
21442,0,0,9,0,-9
21443,0,0,59,0,-59
21444,0,0,101,0,-101
21445,0,0,56,0,-56
21446,0,0,52,0,-52
21447,1,1,313,1418,1105
21448,1,0,14,0,-14
21449,1,0,50,0,-50
21450,1,0,24,0,-24
21451,0,0,1,0,-1
21452,1,1,351,1517,1166
21453,1,1,176,1425,1249
21454,1,1,256,1351,1095
21455,1,0,11,0,-11
21456,0,0,20,0,-20
21457,0,0,37,0,-37
21458,1,1,663,1329,666
21459,0,0,58,0,-58
21460,1,1,1378,1695,317
21461,1,1,836,1547,711
21462,0,0,27,0,-27
21463,1,1,68,1453,1385
21464,0,0,65,0,-65
21465,1,1,362,2540,2178
21466,1,0,104,0,-104
21467,1,1,161,1321,1160
21468,0,0,171,0,-171
21469,1,1,103,1354,1251
21470,1,1,403,1632,1229
21471,1,1,979,1777,798
21472,1,1,870,1472,602
21473,1,0,36,0,-36
21474,1,0,14,0,-14
21475,1,1,407,1596,1189
21476,0,0,45,0,-45
21477,1,1,106,1420,1314
21478,1,0,43,0,-43
21479,1,1,693,1257,564
21480,1,0,99,0,-99
21481,1,1,183,1330,1147
21482,1,1,136,2197,2061
21483,1,0,64,0,-64
21484,0,0,8,0,-8
21485,0,0,57,0,-57
21486,1,0,100,0,-100
21487,0,0,71,0,-71
21488,1,1,105,1346,1241
21489,0,0,37,0,-37
21490,1,0,44,0,-44
21491,0,0,44,0,-44
21492,0,0,105,0,-105
21493,0,0,13,0,-13
21494,1,0,101,0,-101
21495,1,0,0,0,0
21496,0,0,78,0,-78
21497,0,0,33,0,-33
21498,1,1,450,1956,1506
21499,0,0,126,0,-126
21500,1,0,72,0,-72
21501,1,0,139,0,-139
21502,1,0,230,0,-230
21503,0,0,68,0,-68
21504,1,0,30,0,-30
21505,0,0,93,0,-93
21506,1,1,1514,1487,-27
21507,0,0,20,0,-20
21508,1,0,35,0,-35
21509,0,0,170,0,-170
21510,1,0,38,0,-38
21511,0,0,27,0,-27
21512,1,1,559,1336,777
21513,0,0,48,0,-48
21514,1,0,48,0,-48
21515,0,0,91,0,-91
21516,0,0,18,0,-18
21517,1,1,569,1200,631
21518,1,0,24,0,-24
21519,1,1,195,1358,1163
21520,0,0,27,0,-27
21521,0,0,192,0,-192
21522,1,1,1023,1382,359
21523,1,0,28,0,-28
21524,1,0,45,0,-45
21525,1,0,3,0,-3
21526,1,0,73,0,-73
21527,0,0,16,0,-16
21528,0,0,9,0,-9
21529,1,1,1512,1820,308
21530,1,1,281,1289,1008
21531,1,1,2258,1308,-950
21532,1,0,148,0,-148
21533,1,1,270,2556,2286
21534,1,0,14,0,-14
21535,0,0,5,0,-5
21536,0,0,6,0,-6
21537,1,0,16,0,-16
21538,1,1,82,1571,1489
21539,0,0,210,0,-210
21540,1,1,215,1442,1227
21541,1,0,31,0,-31
21542,1,1,1175,1296,121
21543,1,0,53,0,-53
21544,1,0,1,0,-1
21545,0,0,22,0,-22
21546,1,0,47,0,-47
21547,0,0,183,0,-183
21548,1,0,53,0,-53
21549,1,0,69,0,-69
21550,0,0,8,0,-8
21551,0,0,21,0,-21
21552,0,0,267,0,-267
21553,0,0,20,0,-20
21554,0,0,81,0,-81
21555,0,0,68,0,-68
21556,1,0,5,0,-5
21557,1,0,46,0,-46
21558,0,0,41,0,-41
21559,1,1,383,1204,821
21560,1,1,506,1233,727
21561,1,1,40,1959,1919
21562,1,0,68,0,-68
21563,1,1,412,1257,845
21564,1,0,0,0,0
21565,1,1,542,1390,848
21566,1,0,65,0,-65
21567,1,0,71,0,-71
21568,0,0,73,0,-73
21569,0,0,67,0,-67
21570,1,0,9,0,-9
21571,0,0,21,0,-21
21572,1,1,602,1246,644
21573,0,0,130,0,-130
21574,0,0,0,0,0
21575,0,0,2,0,-2
21576,0,0,7,0,-7
21577,0,0,10,0,-10
21578,0,0,4,0,-4
21579,1,1,115,1220,1105
21580,0,0,34,0,-34
21581,1,0,44,0,-44
21582,0,0,1,0,-1
21583,0,0,25,0,-25
21584,1,1,133,1230,1097
21585,1,1,1275,1667,392
21586,0,0,0,0,0
21587,0,0,120,0,-120
21588,1,1,279,1251,972
21589,1,0,17,0,-17
21590,1,0,19,0,-19
21591,0,0,17,0,-17
21592,0,0,2,0,-2
21593,0,0,94,0,-94
21594,0,0,4,0,-4
21595,0,0,48,0,-48
21596,0,0,1,0,-1
21597,1,0,66,0,-66
21598,1,0,64,0,-64
21599,1,0,27,0,-27
21600,1,1,89,1353,1264
21601,1,0,84,0,-84
21602,1,0,43,0,-43
21603,1,0,43,0,-43
21604,1,1,788,1463,675
21605,0,0,54,0,-54
21606,1,1,834,1216,382
21607,0,0,185,0,-185
21608,1,0,97,0,-97
21609,1,1,31,1678,1647
21610,1,0,116,0,-116
21611,0,0,5,0,-5
21612,0,0,42,0,-42
21613,1,1,585,1310,725
21614,1,0,229,0,-229
21615,1,1,160,1703,1543
21616,0,0,88,0,-88
21617,1,1,408,1936,1528
21618,1,0,10,0,-10
21619,1,0,72,0,-72
21620,0,0,125,0,-125
21621,1,1,178,1665,1487
21622,0,0,11,0,-11
21623,1,0,56,0,-56
21624,0,0,12,0,-12
21625,1,0,14,0,-14
21626,0,0,7,0,-7
21627,1,1,5357,1384,-3973
21628,1,1,134,2723,2589
21629,1,0,89,0,-89
21630,1,1,16,1801,1785
21631,0,0,30,0,-30
21632,0,0,134,0,-134
21633,0,0,48,0,-48
21634,1,1,218,1418,1200
21635,1,1,294,1217,923
21636,0,0,59,0,-59
21637,1,0,72,0,-72
21638,1,0,60,0,-60
21639,1,0,37,0,-37
21640,0,0,163,0,-163
21641,1,0,57,0,-57
21642,1,0,21,0,-21
21643,1,1,212,2515,2303
21644,0,0,168,0,-168
21645,0,0,17,0,-17
21646,1,0,36,0,-36
21647,1,0,15,0,-15
21648,0,0,38,0,-38
21649,1,0,51,0,-51
21650,0,0,9,0,-9
21651,1,1,971,1374,403
21652,1,0,102,0,-102
21653,1,0,15,0,-15
21654,0,0,5,0,-5
21655,1,1,288,1461,1173
21656,0,0,3,0,-3
21657,0,0,40,0,-40
21658,1,0,34,0,-34
21659,0,0,187,0,-187
21660,1,1,404,1593,1189
21661,0,0,45,0,-45
21662,1,1,912,2810,1898
21663,1,0,6,0,-6
21664,1,1,139,1418,1279
21665,0,0,0,0,0
21666,1,1,314,1945,1631
21667,1,0,3,0,-3
21668,1,0,7,0,-7
21669,1,0,14,0,-14
21670,1,1,1551,1201,-350
21671,1,0,14,0,-14
21672,0,0,39,0,-39
21673,0,0,52,0,-52
21674,1,0,104,0,-104
21675,0,0,158,0,-158
21676,1,0,68,0,-68
21677,1,0,225,0,-225
21678,1,0,75,0,-75
21679,1,0,15,0,-15
21680,0,0,4,0,-4
21681,1,0,55,0,-55
21682,1,1,192,1677,1485
21683,1,1,270,1408,1138
21684,1,1,727,1966,1239
21685,1,0,31,0,-31
21686,1,1,302,1371,1069
21687,1,1,171,2406,2235
21688,0,0,58,0,-58
21689,1,1,541,1721,1180
21690,1,1,1120,1756,636
21691,1,1,1521,1228,-293
21692,0,0,46,0,-46
21693,1,0,126,0,-126
21694,0,0,75,0,-75
21695,1,1,364,1447,1083
21696,1,0,16,0,-16
21697,1,1,973,1526,553
21698,0,0,0,0,0
21699,1,0,62,0,-62
21700,1,1,1628,1810,182
21701,1,1,131,1387,1256
21702,0,0,185,0,-185
21703,0,0,26,0,-26
21704,1,1,1233,1423,190
21705,1,0,106,0,-106
21706,1,1,246,1287,1041
21707,1,1,316,1310,994
21708,0,0,26,0,-26
21709,1,0,11,0,-11
21710,1,1,359,1477,1118
21711,0,0,16,0,-16
21712,0,0,52,0,-52
21713,1,1,555,1824,1269
21714,0,0,56,0,-56
21715,0,0,20,0,-20
21716,1,1,727,1394,667
21717,1,0,34,0,-34
21718,1,0,33,0,-33
21719,0,0,36,0,-36
21720,0,0,2,0,-2
21721,1,1,655,1472,817
21722,0,0,0,0,0
21723,0,0,10,0,-10
21724,0,0,15,0,-15
21725,1,1,1333,1238,-95
21726,1,0,32,0,-32
21727,0,0,25,0,-25
21728,1,1,1142,1324,182
21729,0,0,229,0,-229
21730,0,0,12,0,-12
21731,0,0,40,0,-40
21732,1,1,564,1518,954
21733,1,0,6,0,-6
21734,0,0,162,0,-162
21735,1,0,49,0,-49
21736,1,0,2,0,-2
21737,0,0,17,0,-17
21738,1,0,43,0,-43
21739,1,0,7,0,-7
21740,1,1,322,2053,1731
21741,1,0,39,0,-39
21742,1,0,123,0,-123
21743,0,0,6,0,-6
21744,0,0,4,0,-4
21745,0,0,22,0,-22
21746,0,0,16,0,-16
21747,1,1,84,1230,1146
21748,1,0,18,0,-18
21749,0,0,31,0,-31
21750,1,0,32,0,-32
21751,0,0,58,0,-58
21752,0,0,116,0,-116
21753,0,0,315,0,-315
21754,1,1,632,1717,1085
21755,0,0,120,0,-120
21756,1,1,195,2115,1920
21757,1,1,463,1593,1130
21758,0,0,16,0,-16
21759,0,0,6,0,-6
21760,1,1,122,2473,2351
21761,1,1,658,1305,647
21762,0,0,32,0,-32
21763,1,1,469,1451,982
21764,0,0,17,0,-17
21765,1,0,28,0,-28
21766,1,1,335,1462,1127
21767,1,0,31,0,-31
21768,1,0,12,0,-12
21769,0,0,0,0,0
21770,1,1,55,1327,1272
21771,1,1,194,1308,1114
21772,1,1,1149,1330,181
21773,1,0,22,0,-22
21774,0,0,72,0,-72
21775,0,0,32,0,-32
21776,1,0,14,0,-14
21777,0,0,110,0,-110
21778,0,0,25,0,-25
21779,0,0,64,0,-64
21780,0,0,10,0,-10
21781,1,1,158,1290,1132
21782,1,1,781,1468,687
21783,1,1,790,1808,1018
21784,0,0,67,0,-67
21785,0,0,18,0,-18
21786,1,0,16,0,-16
21787,1,0,108,0,-108
21788,0,0,117,0,-117
21789,0,0,76,0,-76
21790,0,0,3,0,-3
21791,1,1,599,1234,635
21792,1,0,16,0,-16
21793,0,0,71,0,-71
21794,0,0,10,0,-10
21795,1,1,1364,1499,135
21796,1,0,30,0,-30
21797,0,0,23,0,-23
21798,1,0,2,0,-2
21799,1,0,17,0,-17
21800,1,1,326,1341,1015
21801,1,1,1280,1485,205
21802,1,0,106,0,-106
21803,0,0,76,0,-76
21804,1,1,754,1227,473
21805,1,1,44,1357,1313
21806,1,0,12,0,-12
21807,0,0,73,0,-73
21808,0,0,43,0,-43
21809,0,0,40,0,-40
21810,1,1,353,1639,1286
21811,1,0,111,0,-111
21812,1,0,27,0,-27
21813,1,0,38,0,-38
21814,0,0,56,0,-56
21815,0,0,28,0,-28
21816,1,1,54,2034,1980
21817,0,0,73,0,-73
21818,0,0,22,0,-22
21819,1,1,511,1220,709
21820,0,0,0,0,0
21821,1,0,5,0,-5
21822,0,0,59,0,-59
21823,1,1,1088,1461,373
21824,0,0,25,0,-25
21825,0,0,5,0,-5
21826,0,0,27,0,-27
21827,1,0,170,0,-170
21828,1,0,117,0,-117
21829,0,0,25,0,-25
21830,0,0,16,0,-16
21831,1,0,49,0,-49
21832,1,1,129,1389,1260
21833,1,0,161,0,-161
21834,1,1,1105,1336,231
21835,1,1,806,1869,1063
21836,0,0,68,0,-68
21837,0,0,109,0,-109
21838,1,1,168,1266,1098
21839,1,0,7,0,-7
21840,1,1,379,1235,856
21841,1,1,253,1977,1724
21842,1,0,79,0,-79
21843,1,0,50,0,-50
21844,0,0,7,0,-7
21845,0,0,296,0,-296
21846,1,0,62,0,-62
21847,1,0,17,0,-17
21848,0,0,26,0,-26
21849,0,0,0,0,0
21850,0,0,116,0,-116
21851,1,0,0,0,0
21852,1,0,4,0,-4
21853,1,0,91,0,-91
21854,0,0,48,0,-48
21855,1,1,1535,1229,-306
21856,0,0,20,0,-20
21857,0,0,47,0,-47
21858,1,0,52,0,-52
21859,1,1,138,1307,1169
21860,1,1,279,1362,1083
21861,0,0,18,0,-18
21862,1,1,49,1312,1263
21863,0,0,17,0,-17
21864,1,1,698,1649,951
21865,1,1,465,2715,2250
21866,1,0,8,0,-8
21867,1,0,94,0,-94
21868,1,0,121,0,-121
21869,1,1,183,1783,1600
21870,0,0,92,0,-92
21871,1,1,1093,1219,126
21872,0,0,26,0,-26
21873,0,0,23,0,-23
21874,0,0,50,0,-50
21875,1,1,347,1645,1298
21876,1,1,1635,2261,626
21877,1,0,299,0,-299
21878,1,0,103,0,-103
21879,1,1,245,1206,961
21880,0,0,1,0,-1
21881,1,1,434,1461,1027
21882,0,0,198,0,-198
21883,0,0,6,0,-6
21884,1,1,571,2787,2216
21885,1,1,124,1520,1396
21886,1,0,12,0,-12
21887,1,0,67,0,-67
21888,0,0,47,0,-47
21889,1,1,347,1240,893
21890,1,1,104,1289,1185
21891,1,1,931,2276,1345
21892,1,1,64,1336,1272
21893,1,1,2247,1302,-945
21894,0,0,24,0,-24
21895,0,0,9,0,-9
21896,1,0,103,0,-103
21897,1,1,227,1480,1253
21898,1,0,56,0,-56
21899,0,0,3,0,-3
21900,1,1,137,2390,2253
21901,1,0,123,0,-123
21902,0,0,3,0,-3
21903,1,0,101,0,-101
21904,1,1,290,1387,1097
21905,0,0,32,0,-32
21906,1,1,1077,1763,686
21907,0,0,112,0,-112
21908,1,1,285,1708,1423
21909,1,0,24,0,-24
21910,1,0,13,0,-13
21911,1,0,12,0,-12
21912,0,0,13,0,-13
21913,1,1,84,1341,1257
21914,1,1,565,1340,775
21915,0,0,21,0,-21
21916,1,0,5,0,-5
21917,0,0,40,0,-40
21918,0,0,37,0,-37
21919,1,0,4,0,-4
21920,0,0,35,0,-35
21921,0,0,68,0,-68
21922,1,1,1042,1219,177
21923,1,1,238,1201,963
21924,1,0,31,0,-31
21925,0,0,70,0,-70
21926,1,0,15,0,-15
21927,1,0,36,0,-36
21928,0,0,37,0,-37
21929,0,0,37,0,-37
21930,1,1,447,1206,759
21931,1,1,994,1377,383
21932,0,0,7,0,-7
21933,1,1,251,1218,967
21934,1,0,14,0,-14
21935,1,1,676,1201,525
21936,1,0,20,0,-20
21937,1,0,9,0,-9
21938,1,1,134,2898,2764
21939,0,0,30,0,-30
21940,1,1,223,1734,1511
21941,0,0,59,0,-59
21942,1,0,19,0,-19
21943,0,0,20,0,-20
21944,0,0,191,0,-191
21945,0,0,20,0,-20
21946,0,0,82,0,-82
21947,0,0,12,0,-12
21948,0,0,31,0,-31
21949,1,0,32,0,-32
21950,0,0,23,0,-23
21951,0,0,69,0,-69
21952,0,0,18,0,-18
21953,1,1,775,1485,710
21954,1,0,77,0,-77
21955,1,0,100,0,-100
21956,1,1,898,1478,580
21957,1,0,51,0,-51
21958,0,0,131,0,-131
21959,1,1,1597,1707,110
21960,1,0,11,0,-11
21961,1,0,4,0,-4
21962,1,0,41,0,-41
21963,1,0,25,0,-25
21964,1,0,83,0,-83
21965,0,0,38,0,-38
21966,1,0,98,0,-98
21967,0,0,34,0,-34
21968,0,0,57,0,-57
21969,1,0,74,0,-74
21970,0,0,32,0,-32
21971,1,1,147,1551,1404
21972,1,1,2490,1442,-1048
21973,1,0,58,0,-58
21974,1,0,51,0,-51
21975,0,0,74,0,-74
21976,1,0,5,0,-5
21977,1,0,79,0,-79
21978,0,0,3,0,-3
21979,1,0,67,0,-67
21980,1,0,11,0,-11
21981,0,0,177,0,-177
21982,1,1,653,1761,1108
21983,1,0,225,0,-225
21984,0,0,51,0,-51
21985,0,0,5,0,-5
21986,1,1,376,1349,973
21987,1,1,871,1380,509
21988,0,0,7,0,-7
21989,0,0,44,0,-44
21990,0,0,13,0,-13
21991,1,1,127,1499,1372
21992,0,0,29,0,-29
21993,0,0,7,0,-7
21994,0,0,94,0,-94
21995,1,1,230,1377,1147
21996,1,0,57,0,-57
21997,1,1,339,1704,1365
21998,0,0,6,0,-6
21999,1,0,6,0,-6
22000,1,1,491,1709,1218
22001,1,0,9,0,-9
22002,0,0,15,0,-15
22003,0,0,98,0,-98
22004,1,1,1024,1446,422
22005,0,0,4,0,-4
22006,0,0,29,0,-29
22007,1,0,18,0,-18
22008,1,0,13,0,-13
22009,0,0,3,0,-3
22010,0,0,12,0,-12
22011,1,1,223,1265,1042
22012,1,1,320,1347,1027
22013,1,1,2446,1291,-1155
22014,1,0,4,0,-4
22015,1,1,865,1373,508
22016,0,0,140,0,-140
22017,1,1,98,1666,1568
22018,0,0,9,0,-9
22019,0,0,28,0,-28
22020,1,0,58,0,-58
22021,1,0,51,0,-51
22022,1,0,8,0,-8
22023,0,0,9,0,-9
22024,1,1,1162,1480,318
22025,1,1,732,1294,562
22026,0,0,44,0,-44
22027,1,1,631,1218,587
22028,1,1,171,1958,1787
22029,1,1,212,1290,1078
22030,1,0,149,0,-149
22031,1,1,1843,1252,-591
22032,0,0,40,0,-40
22033,0,0,6,0,-6
22034,0,0,60,0,-60
22035,1,1,148,1704,1556
22036,0,0,31,0,-31
22037,1,0,7,0,-7
22038,1,1,20,1625,1605
22039,1,1,1563,2256,693
22040,0,0,22,0,-22
22041,1,1,1287,1202,-85
22042,0,0,5,0,-5
22043,1,0,21,0,-21
22044,1,1,69,1360,1291
22045,0,0,170,0,-170
22046,1,0,59,0,-59
22047,1,1,131,2755,2624
22048,0,0,63,0,-63
22049,0,0,12,0,-12
22050,1,1,148,1566,1418
22051,1,1,792,1293,501
22052,1,1,105,1278,1173
22053,0,0,46,0,-46
22054,0,0,405,0,-405
22055,1,1,515,1219,704
22056,1,0,50,0,-50
22057,0,0,26,0,-26
22058,0,0,9,0,-9
22059,1,0,18,0,-18
22060,0,0,136,0,-136
22061,0,0,55,0,-55
22062,1,1,450,2109,1659
22063,0,0,9,0,-9
22064,0,0,12,0,-12
22065,0,0,32,0,-32
22066,1,0,11,0,-11
22067,1,1,94,1201,1107
22068,1,0,13,0,-13
22069,0,0,22,0,-22
22070,1,0,5,0,-5
22071,1,1,35,1747,1712
22072,1,0,80,0,-80
22073,1,0,17,0,-17
22074,1,1,684,1384,700
22075,1,0,6,0,-6
22076,0,0,7,0,-7
22077,1,0,6,0,-6
22078,1,1,589,2009,1420
22079,1,0,15,0,-15
22080,1,0,12,0,-12
22081,1,0,191,0,-191
22082,1,1,152,1249,1097
22083,1,0,25,0,-25
22084,0,0,48,0,-48
22085,0,0,11,0,-11
22086,1,1,813,1728,915
22087,0,0,120,0,-120
22088,1,1,272,1372,1100
22089,0,0,10,0,-10
22090,0,0,2,0,-2
22091,0,0,93,0,-93
22092,0,0,110,0,-110
22093,0,0,15,0,-15
22094,1,0,18,0,-18
22095,0,0,15,0,-15
22096,0,0,29,0,-29
22097,1,1,82,1715,1633
22098,1,1,180,1716,1536
22099,1,1,343,1211,868
22100,1,0,89,0,-89
22101,0,0,94,0,-94
22102,1,1,709,1644,935
22103,1,0,50,0,-50
22104,1,1,90,1386,1296
22105,1,1,49,1513,1464
22106,0,0,5,0,-5
22107,0,0,23,0,-23
22108,0,0,45,0,-45
22109,1,1,111,1495,1384
22110,1,0,57,0,-57
22111,1,0,62,0,-62
22112,0,0,15,0,-15
22113,1,1,854,1245,391
22114,1,0,29,0,-29
22115,1,1,213,1473,1260
22116,0,0,150,0,-150
22117,1,0,27,0,-27
22118,1,1,190,1286,1096
22119,1,1,289,1494,1205
22120,0,0,25,0,-25
22121,0,0,1,0,-1
22122,1,1,163,1568,1405
22123,0,0,103,0,-103
22124,0,0,18,0,-18
22125,1,1,50,1210,1160
22126,0,0,20,0,-20
22127,0,0,46,0,-46
22128,1,0,29,0,-29
22129,1,0,233,0,-233
22130,0,0,9,0,-9
22131,0,0,51,0,-51
22132,0,0,15,0,-15
22133,0,0,52,0,-52
22134,0,0,13,0,-13
22135,1,1,169,1423,1254
22136,0,0,3,0,-3
22137,0,0,2,0,-2
22138,1,1,256,1523,1267
22139,1,0,10,0,-10
22140,0,0,5,0,-5
22141,1,1,46,1622,1576
22142,1,1,50,2696,2646
22143,0,0,14,0,-14
22144,1,0,67,0,-67
22145,1,0,60,0,-60
22146,1,0,77,0,-77
22147,0,0,14,0,-14
22148,1,1,443,2364,1921
22149,0,0,8,0,-8
22150,0,0,17,0,-17
22151,0,0,11,0,-11
22152,0,0,130,0,-130
22153,0,0,77,0,-77
22154,1,1,1269,1884,615
22155,1,1,1175,1219,44
22156,0,0,55,0,-55
22157,1,1,347,1920,1573
22158,0,0,41,0,-41
22159,1,1,119,1358,1239
22160,1,0,11,0,-11
22161,1,1,709,1352,643
22162,1,0,15,0,-15
22163,1,1,665,1829,1164
22164,1,1,910,1232,322
22165,1,1,2077,1619,-458
22166,1,1,916,1255,339
22167,0,0,59,0,-59
22168,0,0,0,0,0
22169,0,0,6,0,-6
22170,1,1,338,1628,1290
22171,1,1,655,1470,815
22172,0,0,9,0,-9
22173,1,1,165,1200,1035
22174,1,0,32,0,-32
22175,1,0,15,0,-15
22176,1,1,432,1419,987
22177,1,0,78,0,-78
22178,0,0,7,0,-7
22179,0,0,1,0,-1
22180,1,0,36,0,-36
22181,1,1,425,1372,947
22182,0,0,17,0,-17
22183,0,0,37,0,-37
22184,1,0,19,0,-19
22185,0,0,0,0,0
22186,1,1,972,3755,2783
22187,0,0,16,0,-16
22188,1,0,15,0,-15
22189,0,0,32,0,-32
22190,1,0,9,0,-9
22191,1,0,30,0,-30
22192,0,0,6,0,-6
22193,0,0,49,0,-49
22194,1,0,46,0,-46
22195,1,1,210,2301,2091
22196,1,0,4,0,-4
22197,0,0,128,0,-128
22198,0,0,89,0,-89
22199,1,1,241,1849,1608
22200,0,0,79,0,-79
22201,1,0,65,0,-65
22202,1,1,366,1972,1606
22203,0,0,40,0,-40
22204,1,0,26,0,-26
22205,0,0,49,0,-49
22206,1,1,428,1939,1511
22207,0,0,43,0,-43
22208,0,0,9,0,-9
22209,1,1,413,1469,1056
22210,0,0,59,0,-59
22211,0,0,254,0,-254
22212,0,0,84,0,-84
22213,1,0,7,0,-7
22214,0,0,313,0,-313
22215,1,0,62,0,-62
22216,1,1,147,1319,1172
22217,0,0,69,0,-69
22218,1,0,26,0,-26
22219,0,0,19,0,-19
22220,1,0,114,0,-114
22221,1,0,9,0,-9
22222,1,1,973,1334,361
22223,1,1,601,1822,1221
22224,1,0,31,0,-31
22225,1,0,8,0,-8
22226,1,1,359,1245,886
22227,1,0,38,0,-38
22228,1,1,180,1420,1240
22229,1,1,546,2723,2177
22230,1,0,16,0,-16
22231,0,0,33,0,-33
22232,1,1,130,4670,4540
22233,1,1,927,1321,394
22234,0,0,28,0,-28
22235,0,0,21,0,-21
22236,0,0,62,0,-62
22237,1,1,350,2195,1845
22238,1,1,101,1566,1465
22239,0,0,22,0,-22
22240,1,0,17,0,-17
22241,1,0,41,0,-41
22242,0,0,32,0,-32
22243,1,1,482,1371,889
22244,1,1,30,2070,2040
22245,0,0,42,0,-42
22246,1,0,17,0,-17
22247,0,0,243,0,-243
22248,1,1,751,1711,960
22249,0,0,16,0,-16
22250,1,0,37,0,-37
22251,1,1,298,1893,1595
22252,1,1,1359,1675,316
22253,1,1,229,1337,1108
22254,0,0,18,0,-18
22255,0,0,75,0,-75
22256,0,0,109,0,-109
22257,1,1,910,1346,436
22258,1,0,10,0,-10
22259,1,1,340,1997,1657
22260,0,0,26,0,-26
22261,1,0,19,0,-19
22262,1,1,1212,1201,-11
22263,1,0,14,0,-14
22264,1,1,300,1607,1307
22265,1,1,346,1426,1080
22266,1,0,23,0,-23
22267,1,1,1140,1277,137
22268,1,1,347,1670,1323
22269,1,1,417,1952,1535
22270,1,0,8,0,-8
22271,0,0,124,0,-124
22272,0,0,49,0,-49
22273,0,0,4,0,-4
22274,1,1,126,1404,1278
22275,1,1,118,1889,1771
22276,0,0,241,0,-241
22277,0,0,24,0,-24
22278,0,0,41,0,-41
22279,1,1,598,1699,1101
22280,0,0,1,0,-1
22281,1,0,43,0,-43
22282,0,0,18,0,-18
22283,1,0,34,0,-34
22284,1,0,47,0,-47
22285,0,0,0,0,0
22286,0,0,39,0,-39
22287,0,0,27,0,-27
22288,1,1,207,1356,1149
22289,1,1,424,1280,856
22290,1,1,1240,1358,118
22291,1,0,47,0,-47
22292,0,0,15,0,-15
22293,0,0,20,0,-20
22294,0,0,59,0,-59
22295,0,0,61,0,-61
22296,1,1,102,1777,1675
22297,1,1,386,1603,1217
22298,0,0,41,0,-41
22299,0,0,0,0,0
22300,0,0,11,0,-11
22301,1,1,571,3787,3216
22302,0,0,100,0,-100
22303,0,0,19,0,-19
22304,1,0,112,0,-112
22305,1,1,175,1359,1184
22306,1,1,75,1349,1274
22307,1,1,157,1252,1095
22308,1,0,114,0,-114
22309,1,1,207,1263,1056
22310,0,0,28,0,-28
22311,1,1,72,1519,1447
22312,0,0,55,0,-55
22313,1,0,11,0,-11
22314,1,1,379,1387,1008
22315,0,0,20,0,-20
22316,0,0,53,0,-53
22317,0,0,42,0,-42
22318,0,0,30,0,-30
22319,1,0,40,0,-40
22320,1,0,11,0,-11
22321,0,0,110,0,-110
22322,1,1,1990,1354,-636
22323,1,0,74,0,-74
22324,0,0,84,0,-84
22325,0,0,68,0,-68
22326,0,0,143,0,-143
22327,1,1,237,1365,1128
22328,1,1,358,1601,1243
22329,1,1,816,1700,884
22330,0,0,9,0,-9
22331,0,0,3,0,-3
22332,0,0,24,0,-24
22333,0,0,145,0,-145
22334,1,0,117,0,-117
22335,1,0,24,0,-24
22336,1,0,16,0,-16
22337,1,0,14,0,-14
22338,1,0,14,0,-14
22339,1,1,331,1252,921
22340,1,0,3,0,-3
22341,1,1,1478,1211,-267
22342,0,0,41,0,-41
22343,1,1,207,1879,1672
22344,1,1,268,2164,1896
22345,0,0,14,0,-14
22346,1,0,29,0,-29
22347,1,0,24,0,-24
22348,1,1,173,1321,1148
22349,1,0,20,0,-20
22350,1,0,12,0,-12
22351,0,0,49,0,-49
22352,0,0,91,0,-91
22353,1,1,803,1286,483
22354,0,0,38,0,-38
22355,0,0,54,0,-54
22356,1,1,454,1225,771
22357,1,0,62,0,-62
22358,0,0,5,0,-5
22359,0,0,17,0,-17
22360,1,0,2,0,-2
22361,1,0,61,0,-61
22362,1,1,565,1434,869
22363,0,0,3,0,-3
22364,0,0,50,0,-50
22365,0,0,128,0,-128
22366,0,0,92,0,-92
22367,0,0,72,0,-72
22368,0,0,78,0,-78
22369,1,0,125,0,-125
22370,0,0,52,0,-52
22371,1,0,63,0,-63
22372,0,0,125,0,-125
22373,0,0,27,0,-27
22374,1,0,4,0,-4
22375,0,0,46,0,-46
22376,1,0,79,0,-79
22377,0,0,0,0,0
22378,1,1,189,1211,1022
22379,1,0,22,0,-22
22380,0,0,71,0,-71
22381,1,1,391,1218,827
22382,0,0,8,0,-8
22383,1,1,229,1380,1151
22384,0,0,25,0,-25
22385,1,1,868,1394,526
22386,0,0,130,0,-130
22387,1,0,54,0,-54
22388,0,0,35,0,-35
22389,1,1,2527,1314,-1213
22390,1,0,44,0,-44
22391,0,0,22,0,-22
22392,1,0,59,0,-59
22393,1,0,32,0,-32
22394,1,0,70,0,-70
22395,0,0,31,0,-31
22396,1,1,444,1496,1052
22397,1,0,30,0,-30
22398,0,0,64,0,-64
22399,1,1,316,1461,1145
22400,0,0,6,0,-6
22401,1,0,124,0,-124
22402,1,1,283,2052,1769
22403,1,1,601,1218,617
22404,1,1,296,1372,1076
22405,1,0,87,0,-87
22406,0,0,21,0,-21
22407,0,0,51,0,-51
22408,1,1,380,2717,2337
22409,1,1,218,1404,1186
22410,1,0,21,0,-21
22411,1,1,1291,1268,-23
22412,1,0,71,0,-71
22413,1,0,53,0,-53
22414,1,0,2,0,-2
22415,0,0,18,0,-18
22416,1,0,16,0,-16
22417,1,1,1031,1253,222
22418,1,1,213,1292,1079
22419,1,0,24,0,-24
22420,1,0,64,0,-64
22421,1,1,322,1940,1618
22422,1,1,130,1459,1329
22423,0,0,48,0,-48
22424,0,0,19,0,-19
22425,1,0,1,0,-1
22426,0,0,50,0,-50
22427,1,0,87,0,-87
22428,0,0,65,0,-65
22429,0,0,1,0,-1
22430,1,0,63,0,-63
22431,0,0,82,0,-82
22432,0,0,19,0,-19
22433,0,0,49,0,-49
22434,1,1,453,1457,1004
22435,0,0,8,0,-8
22436,1,0,10,0,-10
22437,1,0,33,0,-33
22438,1,0,28,0,-28
22439,1,0,21,0,-21
22440,1,0,0,0,0
22441,1,0,29,0,-29
22442,0,0,53,0,-53
22443,0,0,37,0,-37
22444,0,0,28,0,-28
22445,1,0,24,0,-24
22446,1,1,305,2134,1829
22447,1,0,21,0,-21
22448,0,0,4,0,-4
22449,1,0,74,0,-74
22450,1,0,1,0,-1
22451,1,1,48,1718,1670
22452,1,1,678,2074,1396
22453,0,0,12,0,-12
22454,1,1,1650,1879,229
22455,0,0,57,0,-57
22456,0,0,0,0,0
22457,0,0,26,0,-26
22458,1,1,983,1443,460
22459,0,0,105,0,-105
22460,1,1,468,1573,1105
22461,0,0,90,0,-90
22462,1,0,31,0,-31
22463,0,0,21,0,-21
22464,1,0,62,0,-62
22465,0,0,58,0,-58
22466,1,0,8,0,-8
22467,1,0,16,0,-16
22468,0,0,0,0,0
22469,0,0,110,0,-110
22470,1,0,6,0,-6
22471,1,1,934,1559,625
22472,1,0,6,0,-6
22473,0,0,100,0,-100
22474,1,0,6,0,-6
22475,1,0,86,0,-86
22476,0,0,142,0,-142
22477,1,1,1998,1612,-386
22478,1,1,1111,1311,200
22479,1,1,1300,1942,642
22480,1,1,505,1781,1276
22481,0,0,24,0,-24
22482,1,0,82,0,-82
22483,0,0,18,0,-18
22484,1,0,14,0,-14
22485,1,1,1261,1930,669
22486,1,1,349,1564,1215
22487,0,0,84,0,-84
22488,0,0,3,0,-3
22489,0,0,29,0,-29
22490,1,1,144,2466,2322
22491,1,1,383,1428,1045
22492,1,1,671,1209,538
22493,1,1,287,1406,1119
22494,1,0,31,0,-31
22495,1,0,21,0,-21
22496,1,1,123,2445,2322
22497,1,1,433,1372,939
22498,1,1,159,1403,1244
22499,1,1,679,1309,630
22500,1,1,177,1434,1257
22501,0,0,28,0,-28
22502,1,0,86,0,-86
22503,0,0,13,0,-13
22504,1,0,31,0,-31
22505,1,1,41,1399,1358
22506,0,0,64,0,-64
22507,0,0,22,0,-22
22508,1,1,133,1285,1152
22509,1,1,1258,1212,-46
22510,1,1,207,1424,1217
22511,1,0,96,0,-96
22512,1,1,273,1289,1016
22513,0,0,4,0,-4
22514,0,0,41,0,-41
22515,0,0,12,0,-12
22516,0,0,20,0,-20
22517,0,0,15,0,-15
22518,1,1,86,1510,1424
22519,0,0,14,0,-14
22520,0,0,1,0,-1
22521,0,0,4,0,-4
22522,1,0,74,0,-74
22523,1,0,83,0,-83
22524,0,0,93,0,-93
22525,0,0,41,0,-41
22526,0,0,12,0,-12
22527,1,1,1112,1229,117
22528,0,0,68,0,-68
22529,1,1,639,1911,1272
22530,1,0,6,0,-6
