ID,Флаг дозвона,Флаг продажи,Расходы,PV,NPV
0,1,1,1038,1891,853
1,0,0,25,0,-25
2,1,0,112,0,-112
3,1,1,240,1569,1329
4,0,0,116,0,-116
5,1,1,1435,2034,599
6,0,0,8,0,-8
7,0,0,111,0,-111
8,0,0,43,0,-43
9,0,0,4,0,-4
10,0,0,5,0,-5
11,1,0,3,0,-3
12,0,0,34,0,-34
13,1,0,53,0,-53
14,1,1,455,1241,786
15,1,0,72,0,-72
16,1,1,877,1269,392
17,1,0,33,0,-33
18,0,0,70,0,-70
19,1,1,740,1443,703
20,0,0,65,0,-65
21,1,0,5,0,-5
22,1,1,1097,1728,631
23,1,0,3,0,-3
24,1,0,21,0,-21
25,1,0,8,0,-8
26,1,0,81,0,-81
27,1,0,250,0,-250
28,1,0,25,0,-25
29,0,0,68,0,-68
30,0,0,228,0,-228
31,0,0,15,0,-15
32,0,0,37,0,-37
33,1,1,2144,1917,-227
34,0,0,75,0,-75
35,1,1,69,1258,1189
36,1,1,142,1307,1165
37,1,1,765,1373,608
38,1,1,397,1274,877
39,1,1,141,1206,1065
40,0,0,0,0,0
41,0,0,110,0,-110
42,1,0,85,0,-85
43,1,0,51,0,-51
44,1,0,16,0,-16
45,1,1,58,2428,2370
46,1,0,77,0,-77
47,1,1,245,2245,2000
48,1,0,21,0,-21
49,0,0,27,0,-27
50,1,0,78,0,-78
51,0,0,29,0,-29
52,0,0,145,0,-145
53,1,0,39,0,-39
54,0,0,17,0,-17
55,1,0,92,0,-92
56,0,0,61,0,-61
57,1,0,44,0,-44
58,1,0,41,0,-41
59,1,1,403,1724,1321
60,1,1,1624,1401,-223
61,1,1,309,1436,1127
62,1,0,38,0,-38
63,0,0,102,0,-102
64,1,1,210,1299,1089
65,0,0,78,0,-78
66,1,1,973,1328,355
67,1,0,32,0,-32
68,0,0,12,0,-12
69,1,0,111,0,-111
70,0,0,40,0,-40
71,1,1,135,1845,1710
72,1,0,36,0,-36
73,1,0,15,0,-15
74,1,1,377,1474,1097
75,0,0,155,0,-155
76,0,0,51,0,-51
77,1,1,293,1946,1653
78,0,0,17,0,-17
79,0,0,110,0,-110
80,0,0,41,0,-41
81,1,1,604,1357,753
82,1,0,116,0,-116
83,1,1,75,1985,1910
84,0,0,69,0,-69
85,0,0,30,0,-30
86,0,0,5,0,-5
87,0,0,2,0,-2
88,1,1,76,2795,2719
89,1,1,140,2091,1951
90,0,0,278,0,-278
91,0,0,17,0,-17
92,1,1,1570,1236,-334
93,1,0,16,0,-16
94,0,0,7,0,-7
95,1,0,23,0,-23
96,1,1,325,1289,964
97,1,1,165,1269,1104
98,1,0,144,0,-144
99,1,0,19,0,-19
100,1,0,37,0,-37
101,0,0,50,0,-50
102,1,0,4,0,-4
103,0,0,56,0,-56
104,1,1,431,1986,1555
105,0,0,6,0,-6
106,0,0,0,0,0
107,0,0,26,0,-26
108,0,0,59,0,-59
109,1,1,317,1428,1111
110,0,0,116,0,-116
111,0,0,195,0,-195
112,0,0,25,0,-25
113,1,0,0,0,0
114,0,0,29,0,-29
115,0,0,17,0,-17
116,1,1,286,1803,1517
117,1,0,45,0,-45
118,0,0,10,0,-10
119,1,0,158,0,-158
120,1,1,1260,2329,1069
121,1,1,1186,1863,677
122,0,0,28,0,-28
123,1,1,144,1433,1289
124,0,0,2,0,-2
125,1,0,197,0,-197
126,0,0,175,0,-175
127,1,0,73,0,-73
128,1,1,97,3034,2937
129,1,1,48,1330,1282
130,1,0,90,0,-90
131,1,0,16,0,-16
132,1,1,205,1318,1113
133,1,0,52,0,-52
134,1,1,560,1221,661
135,1,1,75,1334,1259
136,1,1,678,1264,586
137,0,0,44,0,-44
138,1,0,25,0,-25
139,0,0,116,0,-116
140,1,0,102,0,-102
141,1,1,466,1329,863
142,1,0,121,0,-121
143,1,1,66,1268,1202
144,1,0,99,0,-99
145,0,0,34,0,-34
146,1,0,75,0,-75
147,0,0,152,0,-152
148,0,0,36,0,-36
149,0,0,16,0,-16
150,0,0,116,0,-116
151,0,0,175,0,-175
152,1,0,155,0,-155
153,1,1,235,1385,1150
154,1,0,44,0,-44
155,0,0,83,0,-83
156,0,0,39,0,-39
157,1,0,55,0,-55
158,1,0,37,0,-37
159,0,0,41,0,-41
160,1,0,49,0,-49
161,1,1,119,1294,1175
162,0,0,20,0,-20
163,0,0,16,0,-16
164,0,0,2,0,-2
165,1,1,1895,1589,-306
166,1,1,893,1295,402
167,1,0,58,0,-58
168,1,1,624,1217,593
169,1,0,0,0,0
170,1,1,308,1596,1288
171,1,0,4,0,-4
172,0,0,8,0,-8
173,1,0,2,0,-2
174,0,0,57,0,-57
175,1,0,62,0,-62
176,1,1,611,2159,1548
177,1,1,1609,1273,-336
178,1,1,47,2138,2091
179,1,0,5,0,-5
180,1,1,147,1661,1514
181,0,0,21,0,-21
182,1,0,54,0,-54
183,0,0,117,0,-117
184,0,0,6,0,-6
185,0,0,8,0,-8
186,1,1,451,1285,834
187,1,1,59,1311,1252
188,1,1,269,1411,1142
189,1,1,109,1256,1147
190,1,0,250,0,-250
191,0,0,20,0,-20
192,0,0,135,0,-135
193,1,0,3,0,-3
194,0,0,17,0,-17
195,0,0,80,0,-80
196,1,1,85,1459,1374
197,1,0,16,0,-16
198,1,0,50,0,-50
199,1,0,31,0,-31
200,0,0,58,0,-58
201,1,0,87,0,-87
202,0,0,1,0,-1
203,0,0,143,0,-143
204,0,0,70,0,-70
205,0,0,4,0,-4
206,0,0,43,0,-43
207,0,0,115,0,-115
208,1,1,189,1628,1439
209,1,1,230,1209,979
210,1,0,3,0,-3
211,0,0,52,0,-52
212,1,0,8,0,-8
213,0,0,7,0,-7
214,1,1,36,1561,1525
215,0,0,34,0,-34
216,0,0,58,0,-58
217,0,0,51,0,-51
218,0,0,60,0,-60
219,1,0,123,0,-123
220,1,0,245,0,-245
221,0,0,32,0,-32
222,1,0,127,0,-127
223,1,1,760,1779,1019
224,0,0,16,0,-16
225,0,0,3,0,-3
226,0,0,32,0,-32
227,1,0,119,0,-119
228,1,1,705,1912,1207
229,1,0,2,0,-2
230,0,0,12,0,-12
231,1,1,697,1397,700
232,1,1,252,1939,1687
233,1,0,36,0,-36
234,0,0,118,0,-118
235,1,1,61,6384,6323
236,0,0,56,0,-56
237,1,1,425,1832,1407
238,1,1,864,1204,340
239,0,0,18,0,-18
240,0,0,9,0,-9
241,1,0,14,0,-14
242,0,0,67,0,-67
243,1,0,18,0,-18
244,1,0,16,0,-16
245,1,0,4,0,-4
246,1,1,98,1457,1359
247,1,1,460,3873,3413
248,0,0,71,0,-71
249,1,1,902,1229,327
250,0,0,71,0,-71
251,0,0,18,0,-18
252,1,1,539,1258,719
253,1,1,680,1449,769
254,1,1,475,1327,852
255,0,0,12,0,-12
256,0,0,32,0,-32
257,0,0,32,0,-32
258,0,0,30,0,-30
259,0,0,77,0,-77
260,1,0,27,0,-27
261,1,0,62,0,-62
262,1,1,577,2192,1615
263,1,1,446,1844,1398
264,1,0,3,0,-3
265,0,0,77,0,-77
266,1,0,40,0,-40
267,1,0,155,0,-155
268,1,0,92,0,-92
269,0,0,19,0,-19
270,1,0,31,0,-31
271,1,0,40,0,-40
272,0,0,2,0,-2
273,0,0,40,0,-40
274,1,1,423,1308,885
275,1,1,2012,1388,-624
276,0,0,17,0,-17
277,1,1,217,1420,1203
278,0,0,1,0,-1
279,0,0,148,0,-148
280,0,0,15,0,-15
281,1,0,30,0,-30
282,1,1,102,1285,1183
283,0,0,28,0,-28
284,1,0,24,0,-24
285,1,1,1307,1368,61
286,1,1,488,1524,1036
287,1,0,31,0,-31
288,0,0,0,0,0
289,1,0,51,0,-51
290,1,1,130,1870,1740
291,1,0,27,0,-27
292,1,0,42,0,-42
293,1,1,374,1281,907
294,0,0,16,0,-16
295,1,0,23,0,-23
296,1,1,456,1504,1048
297,1,1,432,1488,1056
298,0,0,12,0,-12
299,0,0,4,0,-4
300,1,0,86,0,-86
301,0,0,84,0,-84
302,1,1,455,1674,1219
303,1,1,777,1699,922
304,1,1,435,1213,778
305,0,0,36,0,-36
306,1,1,833,1256,423
307,0,0,40,0,-40
308,1,0,125,0,-125
309,1,1,362,1442,1080
310,0,0,15,0,-15
311,1,1,87,1215,1128
312,0,0,87,0,-87
313,0,0,75,0,-75
314,0,0,92,0,-92
315,0,0,143,0,-143
316,1,1,152,1404,1252
317,0,0,82,0,-82
318,1,1,14,2154,2140
319,0,0,48,0,-48
320,0,0,3,0,-3
321,1,1,389,1734,1345
322,1,0,0,0,0
323,1,1,578,1311,733
324,1,1,155,1228,1073
325,0,0,21,0,-21
326,1,1,116,1224,1108
327,1,0,112,0,-112
328,1,1,89,1301,1212
329,1,0,18,0,-18
330,1,1,168,5037,4869
331,0,0,239,0,-239
332,1,1,456,1380,924
333,0,0,72,0,-72
334,0,0,35,0,-35
335,0,0,324,0,-324
336,0,0,3,0,-3
337,0,0,5,0,-5
338,0,0,9,0,-9
339,0,0,6,0,-6
340,1,1,660,1210,550
341,0,0,73,0,-73
342,1,0,7,0,-7
343,1,0,15,0,-15
344,0,0,98,0,-98
345,1,0,53,0,-53
346,0,0,152,0,-152
347,1,0,19,0,-19
348,0,0,32,0,-32
349,0,0,43,0,-43
350,1,1,327,2215,1888
351,0,0,4,0,-4
352,1,1,469,1773,1304
353,1,0,54,0,-54
354,0,0,8,0,-8
355,0,0,5,0,-5
356,1,1,177,2245,2068
357,1,1,305,1220,915
358,1,1,806,3912,3106
359,0,0,58,0,-58
360,1,1,1316,1208,-108
361,1,1,625,1265,640
362,0,0,30,0,-30
363,1,1,1554,1304,-250
364,0,0,28,0,-28
365,1,0,61,0,-61
366,1,0,16,0,-16
367,0,0,112,0,-112
368,0,0,50,0,-50
369,0,0,2,0,-2
370,1,0,13,0,-13
371,1,1,75,1214,1139
372,1,1,646,1534,888
373,1,1,237,2213,1976
374,1,0,103,0,-103
375,0,0,83,0,-83
376,0,0,8,0,-8
377,1,1,488,2870,2382
378,1,1,7,1265,1258
379,0,0,69,0,-69
380,0,0,8,0,-8
381,1,1,193,1794,1601
382,1,1,520,1259,739
383,1,0,180,0,-180
384,1,1,1586,1575,-11
385,1,0,0,0,0
386,1,1,476,1247,771
387,1,1,368,1253,885
388,1,1,230,1619,1389
389,1,1,251,2916,2665
390,1,0,20,0,-20
391,0,0,89,0,-89
392,1,1,187,1250,1063
393,1,1,332,1513,1181
394,0,0,7,0,-7
395,1,0,26,0,-26
396,1,0,52,0,-52
397,1,0,17,0,-17
398,0,0,139,0,-139
399,1,1,375,1227,852
400,0,0,48,0,-48
401,0,0,38,0,-38
402,0,0,4,0,-4
403,0,0,19,0,-19
404,1,1,804,1398,594
405,0,0,64,0,-64
406,1,0,16,0,-16
407,0,0,29,0,-29
408,1,1,56,1224,1168
409,1,1,1608,1666,58
410,0,0,16,0,-16
411,1,0,21,0,-21
412,1,1,552,1459,907
413,0,0,80,0,-80
414,0,0,12,0,-12
415,1,1,209,1426,1217
416,0,0,42,0,-42
417,1,1,1152,1280,128
418,1,1,231,1380,1149
419,0,0,29,0,-29
420,1,0,71,0,-71
421,1,1,236,1868,1632
422,1,0,30,0,-30
423,1,1,73,1335,1262
424,1,1,71,3447,3376
425,1,0,27,0,-27
426,1,0,37,0,-37
427,1,0,37,0,-37
428,0,0,119,0,-119
429,1,0,212,0,-212
430,1,0,0,0,0
431,1,1,400,1518,1118
432,1,0,206,0,-206
433,1,1,278,1294,1016
434,1,1,20,1260,1240
435,1,0,17,0,-17
436,1,0,93,0,-93
437,0,0,21,0,-21
438,1,0,9,0,-9
439,0,0,8,0,-8
440,0,0,18,0,-18
441,1,0,18,0,-18
442,1,1,1266,2228,962
443,0,0,48,0,-48
444,1,1,1180,1371,191
445,1,0,1,0,-1
446,1,1,472,1664,1192
447,1,1,529,1507,978
448,1,1,183,1301,1118
449,1,0,1,0,-1
450,1,1,37,1398,1361
451,0,0,120,0,-120
452,1,1,333,1209,876
453,0,0,4,0,-4
454,0,0,117,0,-117
455,0,0,37,0,-37
456,0,0,51,0,-51
457,0,0,57,0,-57
458,0,0,140,0,-140
459,0,0,3,0,-3
460,1,1,426,1205,779
461,1,1,1225,1698,473
462,1,0,144,0,-144
463,0,0,1,0,-1
464,1,0,33,0,-33
465,0,0,49,0,-49
466,0,0,16,0,-16
467,0,0,3,0,-3
468,1,0,88,0,-88
469,1,0,48,0,-48
470,0,0,10,0,-10
471,0,0,80,0,-80
472,1,1,439,1744,1305
473,1,0,200,0,-200
474,0,0,97,0,-97
475,0,0,13,0,-13
476,0,0,67,0,-67
477,0,0,4,0,-4
478,0,0,23,0,-23
479,0,0,30,0,-30
480,0,0,150,0,-150
481,1,1,242,1465,1223
482,0,0,2,0,-2
483,1,0,20,0,-20
484,1,1,1560,1346,-214
485,1,0,63,0,-63
486,1,0,5,0,-5
487,1,0,90,0,-90
488,1,1,309,1824,1515
489,1,0,48,0,-48
490,1,1,189,1202,1013
491,0,0,37,0,-37
492,1,1,211,1412,1201
493,0,0,64,0,-64
494,1,0,114,0,-114
495,1,1,226,1540,1314
496,1,0,40,0,-40
497,1,1,823,1559,736
498,1,0,3,0,-3
499,1,1,190,1305,1115
500,1,0,29,0,-29
501,0,0,255,0,-255
502,0,0,17,0,-17
503,1,0,16,0,-16
504,0,0,5,0,-5
505,1,1,74,1205,1131
506,1,1,438,2390,1952
507,0,0,108,0,-108
508,1,0,33,0,-33
509,1,0,76,0,-76
510,1,1,736,1310,574
511,1,0,16,0,-16
512,1,0,124,0,-124
513,0,0,30,0,-30
514,0,0,53,0,-53
515,1,1,398,1445,1047
516,0,0,23,0,-23
517,0,0,114,0,-114
518,1,0,78,0,-78
519,0,0,60,0,-60
520,0,0,3,0,-3
521,0,0,0,0,0
522,1,0,22,0,-22
523,1,0,41,0,-41
524,1,0,26,0,-26
525,1,0,39,0,-39
526,0,0,11,0,-11
527,1,1,268,1438,1170
528,0,0,58,0,-58
529,1,1,331,1388,1057
530,0,0,95,0,-95
531,0,0,22,0,-22
532,0,0,12,0,-12
533,0,0,99,0,-99
534,0,0,7,0,-7
535,0,0,10,0,-10
536,1,0,56,0,-56
537,0,0,19,0,-19
538,0,0,1,0,-1
539,1,1,199,1286,1087
540,1,1,970,1531,561
541,0,0,93,0,-93
542,0,0,157,0,-157
543,0,0,20,0,-20
544,1,1,471,1286,815
545,1,0,118,0,-118
546,0,0,97,0,-97
547,0,0,31,0,-31
548,1,1,246,1320,1074
549,0,0,37,0,-37
550,0,0,42,0,-42
551,1,1,1440,1300,-140
552,1,0,9,0,-9
553,1,0,174,0,-174
554,1,0,33,0,-33
555,0,0,0,0,0
556,0,0,161,0,-161
557,1,1,301,1219,918
558,1,0,78,0,-78
559,0,0,26,0,-26
560,1,1,604,1561,957
561,0,0,14,0,-14
562,1,1,267,1266,999
563,0,0,203,0,-203
564,1,1,267,1279,1012
565,1,1,417,1226,809
566,1,1,296,1344,1048
567,0,0,27,0,-27
568,1,1,387,3454,3067
569,1,1,148,1441,1293
570,1,0,2,0,-2
571,1,1,1294,1517,223
572,1,0,29,0,-29
573,1,1,986,1243,257
574,1,1,833,1584,751
575,1,0,61,0,-61
576,1,0,175,0,-175
577,0,0,74,0,-74
578,1,1,333,1286,953
579,1,0,50,0,-50
580,0,0,7,0,-7
581,1,0,72,0,-72
582,1,0,49,0,-49
583,1,1,59,1219,1160
584,1,1,910,1536,626
585,0,0,16,0,-16
586,1,0,59,0,-59
587,0,0,3,0,-3
588,0,0,12,0,-12
589,1,0,202,0,-202
590,1,1,98,1420,1322
591,1,0,2,0,-2
592,1,1,148,1821,1673
593,1,1,137,1380,1243
594,0,0,114,0,-114
595,0,0,102,0,-102
596,1,0,50,0,-50
597,1,0,84,0,-84
598,0,0,12,0,-12
599,0,0,79,0,-79
600,0,0,30,0,-30
601,1,1,993,1221,228
602,1,1,565,1745,1180
603,0,0,6,0,-6
604,1,1,87,2724,2637
605,1,0,19,0,-19
606,0,0,147,0,-147
607,1,0,29,0,-29
608,1,1,2781,2131,-650
609,1,1,1013,4420,3407
610,0,0,16,0,-16
611,0,0,20,0,-20
612,0,0,49,0,-49
613,1,0,56,0,-56
614,1,0,99,0,-99
615,1,1,410,1222,812
616,0,0,7,0,-7
617,0,0,23,0,-23
618,0,0,20,0,-20
619,0,0,14,0,-14
620,1,1,297,1269,972
621,0,0,21,0,-21
622,1,0,12,0,-12
623,1,0,29,0,-29
624,1,1,996,2422,1426
625,0,0,55,0,-55
626,0,0,0,0,0
627,1,0,57,0,-57
628,1,0,18,0,-18
629,1,0,14,0,-14
630,1,0,0,0,0
631,0,0,19,0,-19
632,1,1,524,2328,1804
633,1,1,441,1466,1025
634,1,1,847,1422,575
635,0,0,11,0,-11
636,1,1,1074,1440,366
637,0,0,3,0,-3
638,1,1,123,1238,1115
639,0,0,75,0,-75
640,1,1,1519,3628,2109
641,1,1,683,1297,614
642,0,0,1,0,-1
643,1,0,61,0,-61
644,1,0,6,0,-6
645,1,0,57,0,-57
646,0,0,79,0,-79
647,0,0,36,0,-36
648,1,0,6,0,-6
649,1,0,7,0,-7
650,1,0,16,0,-16
651,1,0,42,0,-42
652,0,0,35,0,-35
653,0,0,55,0,-55
654,1,1,295,2124,1829
655,0,0,22,0,-22
656,0,0,34,0,-34
657,1,0,80,0,-80
658,1,0,39,0,-39
659,1,1,258,1390,1132
660,1,1,63,1410,1347
661,1,0,70,0,-70
662,1,1,111,1550,1439
663,1,1,132,3048,2916
664,0,0,50,0,-50
665,0,0,75,0,-75
666,0,0,39,0,-39
667,0,0,28,0,-28
668,1,0,6,0,-6
669,0,0,83,0,-83
670,1,1,322,1285,963
671,0,0,34,0,-34
672,1,0,26,0,-26
673,1,1,565,1327,762
674,0,0,57,0,-57
675,1,1,207,1352,1145
676,1,0,7,0,-7
677,1,0,4,0,-4
678,1,0,112,0,-112
679,1,0,12,0,-12
680,0,0,60,0,-60
681,1,1,470,1230,760
682,0,0,45,0,-45
683,1,1,559,1485,926
684,0,0,12,0,-12
685,1,1,886,1506,620
686,1,0,123,0,-123
687,1,1,358,1841,1483
688,0,0,9,0,-9
689,0,0,18,0,-18
690,0,0,51,0,-51
691,1,0,17,0,-17
692,1,0,32,0,-32
693,1,1,2092,1275,-817
694,0,0,25,0,-25
695,1,0,14,0,-14
696,1,0,9,0,-9
697,0,0,34,0,-34
698,0,0,40,0,-40
699,1,0,1,0,-1
700,1,0,11,0,-11
701,0,0,41,0,-41
702,1,0,4,0,-4
703,1,0,49,0,-49
704,0,0,92,0,-92
705,1,1,403,1254,851
706,0,0,138,0,-138
707,0,0,1,0,-1
708,1,0,52,0,-52
709,0,0,1,0,-1
710,1,1,482,1289,807
711,1,1,928,2301,1373
712,1,0,54,0,-54
713,0,0,13,0,-13
714,0,0,19,0,-19
715,1,1,159,1833,1674
716,0,0,83,0,-83
717,1,0,30,0,-30
718,1,1,1076,1323,247
719,1,1,112,1209,1097
720,1,1,128,1829,1701
721,1,1,406,1220,814
722,0,0,11,0,-11
723,1,1,1099,1422,323
724,0,0,64,0,-64
725,1,1,121,1578,1457
726,0,0,22,0,-22
727,0,0,2,0,-2
728,1,0,15,0,-15
729,1,1,31,1267,1236
730,0,0,75,0,-75
731,0,0,43,0,-43
732,1,1,144,1234,1090
733,1,0,16,0,-16
734,1,1,1101,1261,160
735,0,0,8,0,-8
736,0,0,84,0,-84
737,0,0,24,0,-24
738,1,0,6,0,-6
739,0,0,136,0,-136
740,0,0,54,0,-54
741,1,0,77,0,-77
742,1,0,15,0,-15
743,1,0,40,0,-40
744,1,0,24,0,-24
745,1,0,51,0,-51
746,0,0,21,0,-21
747,0,0,19,0,-19
748,0,0,23,0,-23
749,1,0,49,0,-49
750,0,0,12,0,-12
751,1,1,574,1855,1281
752,0,0,0,0,0
753,0,0,65,0,-65
754,0,0,25,0,-25
755,1,0,56,0,-56
756,0,0,32,0,-32
757,0,0,19,0,-19
758,1,0,45,0,-45
759,0,0,63,0,-63
760,1,0,186,0,-186
761,1,0,112,0,-112
762,0,0,10,0,-10
763,0,0,98,0,-98
764,1,1,1270,1615,345
765,0,0,34,0,-34
766,1,0,18,0,-18
767,0,0,57,0,-57
768,0,0,8,0,-8
769,1,1,170,1214,1044
770,0,0,12,0,-12
771,1,0,281,0,-281
772,0,0,16,0,-16
773,1,1,434,1394,960
774,0,0,85,0,-85
775,1,0,36,0,-36
776,1,0,25,0,-25
777,1,0,69,0,-69
778,1,0,26,0,-26
779,1,1,941,1764,823
780,0,0,22,0,-22
781,1,1,1373,1235,-138
782,1,0,22,0,-22
783,1,1,460,1497,1037
784,0,0,205,0,-205
785,1,0,8,0,-8
786,1,1,448,1880,1432
787,0,0,16,0,-16
788,1,1,243,1475,1232
789,1,1,1322,1237,-85
790,1,1,386,1220,834
791,0,0,17,0,-17
792,0,0,26,0,-26
793,1,1,173,1300,1127
794,0,0,67,0,-67
795,1,1,811,2083,1272
796,0,0,2,0,-2
797,1,1,159,2000,1841
798,0,0,46,0,-46
799,0,0,11,0,-11
800,1,0,73,0,-73
801,0,0,164,0,-164
802,1,0,57,0,-57
803,1,0,18,0,-18
804,1,1,473,1200,727
805,1,0,42,0,-42
806,0,0,0,0,0
807,0,0,54,0,-54
808,0,0,32,0,-32
809,1,0,14,0,-14
810,1,0,41,0,-41
811,0,0,19,0,-19
812,1,0,10,0,-10
813,1,1,344,1559,1215
814,0,0,88,0,-88
815,0,0,7,0,-7
816,0,0,33,0,-33
817,1,1,803,1339,536
818,0,0,0,0,0
819,1,1,1952,1210,-742
820,0,0,24,0,-24
821,1,1,49,2617,2568
822,1,1,189,1242,1053
823,1,0,12,0,-12
824,1,1,641,1499,858
825,1,1,213,1307,1094
826,0,0,15,0,-15
827,1,0,7,0,-7
828,1,1,990,1346,356
829,1,0,44,0,-44
830,1,0,163,0,-163
831,0,0,37,0,-37
832,0,0,15,0,-15
833,1,0,58,0,-58
834,0,0,14,0,-14
835,1,0,1,0,-1
836,0,0,6,0,-6
837,1,1,422,1451,1029
838,1,0,58,0,-58
839,1,1,259,2177,1918
840,1,1,123,1433,1310
841,0,0,80,0,-80
842,0,0,41,0,-41
843,0,0,71,0,-71
844,0,0,5,0,-5
845,1,0,86,0,-86
846,1,1,1096,1340,244
847,1,1,151,1783,1632
848,1,0,45,0,-45
849,0,0,92,0,-92
850,1,0,34,0,-34
851,0,0,94,0,-94
852,0,0,59,0,-59
853,1,0,27,0,-27
854,1,0,3,0,-3
855,1,0,38,0,-38
856,1,0,42,0,-42
857,0,0,37,0,-37
858,1,1,832,1284,452
859,0,0,95,0,-95
860,0,0,86,0,-86
861,1,1,370,1429,1059
862,0,0,37,0,-37
863,1,0,55,0,-55
864,0,0,93,0,-93
865,0,0,19,0,-19
866,1,0,1,0,-1
867,1,0,4,0,-4
868,0,0,38,0,-38
869,1,0,15,0,-15
870,0,0,7,0,-7
871,1,0,64,0,-64
872,1,0,112,0,-112
873,0,0,17,0,-17
874,1,1,147,1298,1151
875,1,0,107,0,-107
876,1,0,5,0,-5
877,0,0,40,0,-40
878,1,0,149,0,-149
879,0,0,10,0,-10
880,1,0,6,0,-6
881,1,1,142,2391,2249
882,1,1,459,1219,760
883,1,0,24,0,-24
884,0,0,15,0,-15
885,0,0,6,0,-6
886,0,0,65,0,-65
887,1,1,412,1322,910
888,1,0,119,0,-119
889,1,0,38,0,-38
890,1,1,180,1676,1496
891,1,0,24,0,-24
892,1,1,623,1238,615
893,1,0,82,0,-82
894,0,0,68,0,-68
895,1,1,462,1838,1376
896,0,0,9,0,-9
897,1,1,110,1327,1217
898,1,1,189,1590,1401
899,0,0,7,0,-7
900,1,0,4,0,-4
901,1,0,106,0,-106
902,1,1,465,1462,997
903,0,0,38,0,-38
904,0,0,87,0,-87
905,0,0,12,0,-12
906,1,0,50,0,-50
907,1,0,7,0,-7
908,0,0,141,0,-141
909,1,0,62,0,-62
910,1,0,34,0,-34
911,1,1,75,1421,1346
912,0,0,27,0,-27
913,1,1,375,1606,1231
914,1,0,39,0,-39
915,0,0,4,0,-4
916,0,0,30,0,-30
917,1,1,383,1690,1307
918,0,0,74,0,-74
919,0,0,18,0,-18
920,1,0,15,0,-15
921,1,0,28,0,-28
922,0,0,1,0,-1
923,0,0,86,0,-86
924,0,0,0,0,0
925,1,1,1320,1327,7
926,1,0,33,0,-33
927,0,0,12,0,-12
928,1,1,61,1248,1187
929,1,0,41,0,-41
930,0,0,20,0,-20
931,0,0,52,0,-52
932,0,0,33,0,-33
933,1,0,13,0,-13
934,1,1,409,2288,1879
935,1,1,275,1258,983
936,0,0,5,0,-5
937,0,0,8,0,-8
938,1,1,156,1341,1185
939,1,0,27,0,-27
940,0,0,35,0,-35
941,0,0,133,0,-133
942,0,0,4,0,-4
943,1,0,66,0,-66
944,1,0,57,0,-57
945,0,0,69,0,-69
946,1,0,132,0,-132
947,0,0,5,0,-5
948,0,0,120,0,-120
949,1,1,30,1209,1179
950,0,0,19,0,-19
951,0,0,165,0,-165
952,0,0,50,0,-50
953,1,1,174,1362,1188
954,1,0,38,0,-38
955,0,0,11,0,-11
956,0,0,8,0,-8
957,1,1,198,1282,1084
958,1,1,271,1485,1214
959,0,0,29,0,-29
960,1,1,81,1726,1645
961,0,0,34,0,-34
962,1,0,45,0,-45
963,1,1,17,1237,1220
964,0,0,68,0,-68
965,1,1,161,4597,4436
966,1,1,260,1671,1411
967,1,1,2782,1692,-1090
968,0,0,6,0,-6
969,1,1,826,1279,453
970,1,1,430,1229,799
971,0,0,8,0,-8
972,1,1,77,1291,1214
973,1,1,479,1485,1006
974,1,1,177,1610,1433
975,0,0,86,0,-86
976,0,0,55,0,-55
977,1,0,24,0,-24
978,1,0,54,0,-54
979,1,1,88,1927,1839
980,1,1,529,1325,796
981,0,0,39,0,-39
982,1,0,18,0,-18
983,1,0,12,0,-12
984,1,1,230,1465,1235
985,1,1,478,1497,1019
986,1,1,1128,1537,409
987,1,0,8,0,-8
988,0,0,69,0,-69
989,1,0,21,0,-21
990,0,0,51,0,-51
991,0,0,6,0,-6
992,0,0,22,0,-22
993,1,0,127,0,-127
994,0,0,8,0,-8
995,1,0,29,0,-29
996,1,1,525,1473,948
997,1,0,45,0,-45
998,0,0,6,0,-6
999,1,1,802,1771,969
1000,0,0,68,0,-68
1001,0,0,10,0,-10
1002,0,0,18,0,-18
1003,0,0,69,0,-69
1004,1,0,102,0,-102
1005,0,0,131,0,-131
1006,1,0,141,0,-141
1007,1,1,209,1224,1015
1008,1,1,174,1306,1132
1009,1,1,213,1491,1278
1010,1,0,3,0,-3
1011,0,0,101,0,-101
1012,1,0,6,0,-6
1013,1,0,43,0,-43
1014,0,0,13,0,-13
1015,1,0,88,0,-88
1016,1,1,154,1246,1092
1017,1,1,561,1702,1141
1018,0,0,11,0,-11
1019,1,1,262,1474,1212
1020,0,0,98,0,-98
1021,1,0,3,0,-3
1022,1,1,848,1889,1041
1023,1,0,53,0,-53
1024,0,0,26,0,-26
1025,0,0,20,0,-20
1026,0,0,87,0,-87
1027,1,0,37,0,-37
1028,1,1,16,2669,2653
1029,0,0,58,0,-58
1030,1,0,32,0,-32
1031,1,1,755,1321,566
1032,1,1,497,1326,829
1033,1,1,402,1212,810
1034,1,0,55,0,-55
1035,0,0,28,0,-28
1036,1,0,0,0,0
1037,1,1,1124,1455,331
1038,0,0,92,0,-92
1039,1,0,21,0,-21
1040,1,1,540,1403,863
1041,1,0,7,0,-7
1042,0,0,117,0,-117
1043,0,0,91,0,-91
1044,1,0,52,0,-52
1045,1,0,45,0,-45
1046,1,0,38,0,-38
1047,0,0,14,0,-14
1048,0,0,78,0,-78
1049,1,1,273,1912,1639
1050,0,0,23,0,-23
1051,0,0,71,0,-71
1052,1,1,431,1565,1134
1053,0,0,76,0,-76
1054,0,0,4,0,-4
1055,1,0,177,0,-177
1056,1,1,772,1200,428
1057,0,0,45,0,-45
1058,1,0,10,0,-10
1059,1,1,15,1408,1393
1060,1,1,235,1267,1032
1061,1,1,77,1342,1265
1062,1,0,4,0,-4
1063,1,0,108,0,-108
1064,0,0,101,0,-101
1065,1,1,227,2121,1894
1066,1,1,215,1424,1209
1067,0,0,53,0,-53
1068,1,1,106,1291,1185
1069,1,0,4,0,-4
1070,1,1,105,1309,1204
1071,0,0,23,0,-23
1072,0,0,2,0,-2
1073,1,1,237,1340,1103
1074,1,0,209,0,-209
1075,1,0,21,0,-21
1076,1,1,1008,7381,6373
1077,0,0,39,0,-39
1078,1,1,1239,1389,150
1079,1,0,8,0,-8
1080,1,0,15,0,-15
1081,0,0,2,0,-2
1082,1,0,26,0,-26
1083,0,0,0,0,0
1084,1,0,128,0,-128
1085,0,0,140,0,-140
1086,1,0,9,0,-9
1087,1,0,20,0,-20
1088,0,0,46,0,-46
1089,0,0,121,0,-121
1090,1,1,17,2099,2082
1091,1,1,1363,1263,-100
1092,0,0,18,0,-18
1093,1,0,8,0,-8
1094,0,0,26,0,-26
1095,0,0,5,0,-5
1096,1,1,351,1333,982
1097,1,0,94,0,-94
1098,1,1,172,1830,1658
1099,0,0,47,0,-47
1100,1,0,2,0,-2
1101,1,1,389,1618,1229
1102,1,0,0,0,0
1103,1,1,47,1246,1199
1104,1,1,821,1467,646
1105,1,0,8,0,-8
1106,1,0,91,0,-91
1107,1,0,17,0,-17
1108,1,1,56,1322,1266
1109,0,0,1,0,-1
1110,0,0,15,0,-15
1111,1,0,101,0,-101
1112,1,0,55,0,-55
1113,1,1,895,1685,790
1114,1,1,723,1702,979
1115,1,1,1777,1875,98
1116,1,1,778,2083,1305
1117,1,1,102,1349,1247
1118,0,0,79,0,-79
1119,1,1,171,1263,1092
1120,1,0,37,0,-37
1121,0,0,8,0,-8
1122,0,0,28,0,-28
1123,1,0,42,0,-42
1124,0,0,50,0,-50
1125,0,0,33,0,-33
1126,0,0,87,0,-87
1127,1,1,272,1204,932
1128,1,1,724,1342,618
1129,1,1,1922,1350,-572
1130,1,0,79,0,-79
1131,1,1,370,1545,1175
1132,1,1,121,3227,3106
1133,1,1,158,1218,1060
1134,0,0,19,0,-19
1135,1,1,83,1310,1227
1136,1,1,216,1255,1039
1137,0,0,56,0,-56
1138,0,0,38,0,-38
1139,1,0,1,0,-1
1140,0,0,3,0,-3
1141,0,0,36,0,-36
1142,0,0,140,0,-140
1143,1,0,13,0,-13
1144,1,0,17,0,-17
1145,1,0,296,0,-296
1146,1,0,54,0,-54
1147,0,0,59,0,-59
1148,1,1,79,2510,2431
1149,1,0,171,0,-171
1150,0,0,74,0,-74
1151,0,0,34,0,-34
1152,0,0,91,0,-91
1153,1,1,1175,1475,300
1154,1,1,778,2312,1534
1155,1,0,66,0,-66
1156,0,0,280,0,-280
1157,1,1,460,1625,1165
1158,0,0,2,0,-2
1159,0,0,87,0,-87
1160,0,0,24,0,-24
1161,0,0,64,0,-64
1162,1,1,54,1309,1255
1163,1,1,716,1538,822
1164,1,0,92,0,-92
1165,0,0,41,0,-41
1166,0,0,6,0,-6
1167,1,0,90,0,-90
1168,0,0,66,0,-66
1169,0,0,23,0,-23
1170,1,0,98,0,-98
1171,1,0,13,0,-13
1172,1,1,168,2091,1923
1173,0,0,10,0,-10
1174,0,0,134,0,-134
1175,1,1,383,2495,2112
1176,1,1,99,1292,1193
1177,0,0,4,0,-4
1178,1,1,276,1207,931
1179,1,0,36,0,-36
1180,1,1,197,1539,1342
1181,1,1,10,1308,1298
1182,1,1,198,1514,1316
1183,1,1,91,1991,1900
1184,1,1,816,1402,586
1185,0,0,23,0,-23
1186,1,0,10,0,-10
1187,1,0,5,0,-5
1188,1,0,52,0,-52
1189,0,0,31,0,-31
1190,0,0,33,0,-33
1191,0,0,87,0,-87
1192,0,0,21,0,-21
1193,0,0,27,0,-27
1194,1,1,316,1912,1596
1195,1,0,229,0,-229
1196,1,1,380,1501,1121
1197,1,0,45,0,-45
1198,0,0,12,0,-12
1199,1,1,560,1462,902
1200,0,0,80,0,-80
1201,0,0,18,0,-18
1202,0,0,35,0,-35
1203,1,0,0,0,0
1204,1,0,34,0,-34
1205,1,1,125,1228,1103
1206,1,1,917,1632,715
1207,1,0,25,0,-25
1208,0,0,33,0,-33
1209,0,0,65,0,-65
1210,1,0,20,0,-20
1211,0,0,33,0,-33
1212,0,0,10,0,-10
1213,1,0,47,0,-47
1214,1,1,236,1629,1393
1215,0,0,40,0,-40
1216,0,0,56,0,-56
1217,1,1,589,1252,663
1218,1,0,28,0,-28
1219,1,1,812,2091,1279
1220,0,0,60,0,-60
1221,1,1,142,1325,1183
1222,0,0,88,0,-88
1223,0,0,42,0,-42
1224,1,1,292,1348,1056
1225,1,1,731,1252,521
1226,1,0,18,0,-18
1227,1,1,803,1768,965
1228,0,0,17,0,-17
1229,0,0,83,0,-83
1230,1,0,36,0,-36
1231,0,0,17,0,-17
1232,0,0,68,0,-68
1233,0,0,13,0,-13
1234,1,1,743,1211,468
1235,0,0,11,0,-11
1236,0,0,160,0,-160
1237,1,1,461,1259,798
1238,1,0,93,0,-93
1239,0,0,108,0,-108
1240,1,1,34,1256,1222
1241,1,1,667,1228,561
1242,1,0,230,0,-230
1243,0,0,136,0,-136
1244,0,0,30,0,-30
1245,1,0,52,0,-52
1246,0,0,60,0,-60
1247,1,1,402,1673,1271
1248,1,1,868,1550,682
1249,0,0,18,0,-18
1250,1,0,80,0,-80
1251,1,0,132,0,-132
1252,0,0,3,0,-3
1253,0,0,92,0,-92
1254,0,0,3,0,-3
1255,1,0,10,0,-10
1256,0,0,36,0,-36
1257,1,0,115,0,-115
1258,1,0,39,0,-39
1259,1,1,586,1371,785
1260,1,1,301,1325,1024
1261,0,0,3,0,-3
1262,0,0,68,0,-68
1263,1,1,293,1354,1061
1264,1,0,0,0,0
1265,1,1,118,1509,1391
1266,1,0,14,0,-14
1267,0,0,98,0,-98
1268,1,1,270,2030,1760
1269,1,1,1274,1851,577
1270,0,0,9,0,-9
1271,1,1,614,1615,1001
1272,1,1,673,1353,680
1273,1,1,470,2108,1638
1274,1,0,50,0,-50
1275,1,1,867,1616,749
1276,1,0,75,0,-75
1277,1,0,45,0,-45
1278,0,0,206,0,-206
1279,1,0,2,0,-2
1280,0,0,40,0,-40
1281,1,1,395,1215,820
1282,0,0,0,0,0
1283,1,1,133,1200,1067
1284,0,0,41,0,-41
1285,1,0,98,0,-98
1286,0,0,3,0,-3
1287,1,1,149,1213,1064
1288,1,0,28,0,-28
1289,1,0,61,0,-61
1290,0,0,0,0,0
1291,1,0,2,0,-2
1292,1,0,94,0,-94
1293,0,0,199,0,-199
1294,1,1,2182,1379,-803
1295,1,0,6,0,-6
1296,1,1,79,1397,1318
1297,0,0,0,0,0
1298,1,0,102,0,-102
1299,0,0,1,0,-1
1300,0,0,18,0,-18
1301,0,0,18,0,-18
1302,0,0,11,0,-11
1303,0,0,96,0,-96
1304,0,0,78,0,-78
1305,1,1,802,1813,1011
1306,1,0,21,0,-21
1307,0,0,43,0,-43
1308,1,0,2,0,-2
1309,0,0,44,0,-44
1310,1,0,104,0,-104
1311,1,1,327,2314,1987
1312,0,0,9,0,-9
1313,1,0,28,0,-28
1314,1,1,232,1921,1689
1315,0,0,15,0,-15
1316,1,0,56,0,-56
1317,1,1,492,1201,709
1318,1,1,32,1853,1821
1319,0,0,13,0,-13
1320,1,1,210,1371,1161
1321,1,1,343,1635,1292
1322,0,0,82,0,-82
1323,1,0,4,0,-4
1324,0,0,37,0,-37
1325,1,0,134,0,-134
1326,1,0,27,0,-27
1327,1,0,163,0,-163
1328,0,0,47,0,-47
1329,0,0,42,0,-42
1330,1,0,23,0,-23
1331,0,0,62,0,-62
1332,1,0,157,0,-157
1333,1,1,204,1443,1239
1334,0,0,44,0,-44
1335,1,1,1644,1302,-342
1336,1,0,15,0,-15
1337,1,1,973,1319,346
1338,0,0,4,0,-4
1339,0,0,48,0,-48
1340,0,0,296,0,-296
1341,0,0,31,0,-31
1342,1,0,22,0,-22
1343,0,0,3,0,-3
1344,1,1,910,1296,386
1345,1,0,146,0,-146
1346,0,0,86,0,-86
1347,0,0,22,0,-22
1348,0,0,73,0,-73
1349,0,0,1,0,-1
1350,1,1,356,1924,1568
1351,1,1,160,1374,1214
1352,1,1,1291,1267,-24
1353,0,0,62,0,-62
1354,1,0,23,0,-23
1355,0,0,113,0,-113
1356,1,0,1,0,-1
1357,1,1,598,1592,994
1358,1,0,17,0,-17
1359,1,0,9,0,-9
1360,1,1,416,1316,900
1361,1,0,10,0,-10
1362,0,0,116,0,-116
1363,1,1,2251,1353,-898
1364,1,1,156,1206,1050
1365,0,0,19,0,-19
1366,0,0,19,0,-19
1367,1,1,338,5366,5028
1368,1,0,19,0,-19
1369,0,0,18,0,-18
1370,1,1,131,1572,1441
1371,1,1,138,1333,1195
1372,1,1,422,1229,807
1373,1,0,1,0,-1
1374,1,1,64,1216,1152
1375,1,1,484,1206,722
1376,1,0,186,0,-186
1377,1,1,69,1311,1242
1378,0,0,30,0,-30
1379,0,0,9,0,-9
1380,0,0,15,0,-15
1381,0,0,67,0,-67
1382,0,0,111,0,-111
1383,1,1,467,1340,873
1384,0,0,10,0,-10
1385,1,0,66,0,-66
1386,1,0,30,0,-30
1387,1,0,65,0,-65
1388,1,0,35,0,-35
1389,1,0,40,0,-40
1390,1,0,49,0,-49
1391,0,0,20,0,-20
1392,1,0,32,0,-32
1393,0,0,43,0,-43
1394,1,0,17,0,-17
1395,1,1,365,1686,1321
1396,0,0,106,0,-106
1397,1,1,1525,1362,-163
1398,0,0,29,0,-29
1399,0,0,6,0,-6
1400,1,1,807,1800,993
1401,0,0,38,0,-38
1402,1,0,13,0,-13
1403,1,0,35,0,-35
1404,1,0,2,0,-2
1405,1,0,175,0,-175
1406,0,0,109,0,-109
1407,1,1,161,1316,1155
1408,0,0,97,0,-97
1409,0,0,93,0,-93
1410,0,0,175,0,-175
1411,1,0,151,0,-151
1412,0,0,58,0,-58
1413,0,0,17,0,-17
1414,1,1,207,1338,1131
1415,1,0,21,0,-21
1416,1,1,409,1226,817
1417,1,1,505,1677,1172
1418,0,0,60,0,-60
1419,0,0,83,0,-83
1420,0,0,12,0,-12
1421,0,0,54,0,-54
1422,1,1,271,1874,1603
1423,1,1,2,1705,1703
1424,1,0,73,0,-73
1425,1,0,8,0,-8
1426,0,0,61,0,-61
1427,1,0,123,0,-123
1428,1,0,5,0,-5
1429,0,0,3,0,-3
1430,0,0,48,0,-48
1431,0,0,63,0,-63
1432,1,0,305,0,-305
1433,1,1,631,1235,604
1434,0,0,92,0,-92
1435,1,0,152,0,-152
1436,1,0,23,0,-23
1437,1,0,14,0,-14
1438,0,0,72,0,-72
1439,1,0,41,0,-41
1440,1,1,593,1284,691
1441,1,0,132,0,-132
1442,0,0,0,0,0
1443,0,0,8,0,-8
1444,1,0,73,0,-73
1445,1,0,20,0,-20
1446,0,0,31,0,-31
1447,0,0,16,0,-16
1448,0,0,124,0,-124
1449,1,0,17,0,-17
1450,0,0,31,0,-31
1451,1,0,32,0,-32
1452,1,1,308,1454,1146
1453,1,0,0,0,0
1454,1,0,65,0,-65
1455,0,0,44,0,-44
1456,1,0,9,0,-9
1457,0,0,17,0,-17
1458,0,0,29,0,-29
1459,1,0,94,0,-94
1460,1,0,4,0,-4
1461,1,0,7,0,-7
1462,0,0,73,0,-73
1463,1,1,938,1417,479
1464,0,0,0,0,0
1465,1,0,36,0,-36
1466,1,0,81,0,-81
1467,0,0,43,0,-43
1468,0,0,115,0,-115
1469,1,1,530,1231,701
1470,1,0,38,0,-38
1471,0,0,147,0,-147
1472,1,1,183,1371,1188
1473,1,1,41,1420,1379
1474,0,0,68,0,-68
1475,0,0,69,0,-69
1476,0,0,21,0,-21
1477,0,0,168,0,-168
1478,0,0,37,0,-37
1479,1,1,50,2036,1986
1480,0,0,43,0,-43
1481,1,0,68,0,-68
1482,0,0,17,0,-17
1483,1,1,171,1542,1371
1484,0,0,110,0,-110
1485,0,0,9,0,-9
1486,0,0,21,0,-21
1487,1,0,7,0,-7
1488,0,0,20,0,-20
1489,1,1,1487,1267,-220
1490,1,1,1236,1759,523
1491,1,0,44,0,-44
1492,1,0,108,0,-108
1493,0,0,6,0,-6
1494,1,1,347,1577,1230
1495,1,0,47,0,-47
1496,0,0,60,0,-60
1497,0,0,212,0,-212
1498,1,0,20,0,-20
1499,0,0,0,0,0
1500,0,0,123,0,-123
1501,1,1,599,1594,995
1502,1,0,111,0,-111
1503,1,1,337,1581,1244
1504,0,0,4,0,-4
1505,1,0,48,0,-48
1506,0,0,19,0,-19
1507,1,1,403,1432,1029
1508,0,0,0,0,0
1509,0,0,75,0,-75
1510,1,1,401,1303,902
1511,0,0,14,0,-14
1512,1,0,62,0,-62
1513,0,0,94,0,-94
1514,1,1,64,1445,1381
1515,0,0,0,0,0
1516,1,0,82,0,-82
1517,0,0,77,0,-77
1518,1,1,459,1297,838
1519,1,1,384,1520,1136
1520,0,0,19,0,-19
1521,1,0,44,0,-44
1522,1,0,20,0,-20
1523,0,0,120,0,-120
1524,0,0,30,0,-30
1525,0,0,114,0,-114
1526,0,0,112,0,-112
1527,1,0,17,0,-17
1528,0,0,79,0,-79
1529,0,0,38,0,-38
1530,1,0,98,0,-98
1531,1,1,355,1502,1147
1532,0,0,34,0,-34
1533,0,0,43,0,-43
1534,0,0,24,0,-24
1535,1,1,871,1492,621
1536,0,0,3,0,-3
1537,0,0,5,0,-5
1538,0,0,68,0,-68
1539,0,0,65,0,-65
1540,0,0,18,0,-18
1541,0,0,3,0,-3
1542,0,0,104,0,-104
1543,1,0,84,0,-84
1544,0,0,13,0,-13
1545,1,1,352,1293,941
1546,1,1,1148,1708,560
1547,1,1,1241,1283,42
1548,1,0,98,0,-98
1549,1,1,697,1320,623
1550,0,0,9,0,-9
1551,1,1,162,1814,1652
1552,0,0,46,0,-46
1553,0,0,89,0,-89
1554,0,0,120,0,-120
1555,1,0,17,0,-17
1556,1,0,33,0,-33
1557,1,0,67,0,-67
1558,1,1,1443,2153,710
1559,0,0,20,0,-20
1560,1,0,256,0,-256
1561,1,0,10,0,-10
1562,1,1,1467,1368,-99
1563,1,1,183,1228,1045
1564,1,1,108,1400,1292
1565,0,0,19,0,-19
1566,0,0,48,0,-48
1567,1,0,46,0,-46
1568,1,1,83,1305,1222
1569,0,0,55,0,-55
1570,0,0,25,0,-25
1571,0,0,51,0,-51
1572,1,0,60,0,-60
1573,1,1,574,2055,1481
1574,0,0,4,0,-4
1575,0,0,1,0,-1
1576,1,1,369,1423,1054
1577,0,0,18,0,-18
1578,0,0,84,0,-84
1579,1,1,448,1381,933
1580,0,0,2,0,-2
1581,0,0,39,0,-39
1582,1,0,72,0,-72
1583,1,1,134,1264,1130
1584,0,0,14,0,-14
1585,1,1,227,1286,1059
1586,1,0,32,0,-32
1587,0,0,3,0,-3
1588,0,0,14,0,-14
1589,1,1,280,1678,1398
1590,1,0,49,0,-49
1591,1,0,10,0,-10
1592,0,0,16,0,-16
1593,0,0,134,0,-134
1594,1,1,235,1222,987
1595,0,0,5,0,-5
1596,0,0,48,0,-48
1597,0,0,59,0,-59
1598,0,0,25,0,-25
1599,0,0,11,0,-11
1600,1,1,1318,1615,297
1601,0,0,37,0,-37
1602,0,0,66,0,-66
1603,1,0,25,0,-25
1604,1,1,1703,1316,-387
1605,1,0,6,0,-6
1606,0,0,5,0,-5
1607,0,0,36,0,-36
1608,1,0,29,0,-29
1609,1,0,166,0,-166
1610,0,0,33,0,-33
1611,1,1,1196,2272,1076
1612,1,1,1022,1364,342
1613,1,0,22,0,-22
1614,1,1,590,1374,784
1615,1,1,1186,1223,37
1616,1,0,123,0,-123
1617,1,0,3,0,-3
1618,0,0,60,0,-60
1619,0,0,97,0,-97
1620,1,0,96,0,-96
1621,1,1,186,1210,1024
1622,1,1,152,1200,1048
1623,0,0,72,0,-72
1624,1,0,43,0,-43
1625,1,1,396,1463,1067
1626,1,1,654,7328,6674
1627,1,1,622,1424,802
1628,1,1,258,1209,951
1629,0,0,102,0,-102
1630,1,1,120,1698,1578
1631,1,0,42,0,-42
1632,1,1,730,1494,764
1633,1,1,229,1433,1204
1634,1,0,18,0,-18
1635,0,0,71,0,-71
1636,0,0,139,0,-139
1637,0,0,12,0,-12
1638,1,1,149,1557,1408
1639,1,0,81,0,-81
1640,1,0,25,0,-25
1641,1,1,207,1297,1090
1642,1,0,5,0,-5
1643,1,1,336,1488,1152
1644,0,0,2,0,-2
1645,1,1,14,1260,1246
1646,0,0,2,0,-2
1647,1,1,347,2834,2487
1648,1,0,25,0,-25
1649,1,1,558,1245,687
1650,0,0,255,0,-255
1651,0,0,24,0,-24
1652,1,0,15,0,-15
1653,1,1,128,1660,1532
1654,0,0,57,0,-57
1655,1,1,584,1862,1278
1656,1,1,222,2006,1784
1657,1,1,1413,1219,-194
1658,1,0,23,0,-23
1659,1,0,73,0,-73
1660,0,0,13,0,-13
1661,1,1,121,1480,1359
1662,1,0,101,0,-101
1663,1,0,100,0,-100
1664,1,0,11,0,-11
1665,1,0,48,0,-48
1666,1,0,38,0,-38
1667,1,1,548,1280,732
1668,0,0,28,0,-28
1669,1,1,97,2288,2191
1670,0,0,52,0,-52
1671,1,1,507,1517,1010
1672,0,0,16,0,-16
1673,1,0,40,0,-40
1674,1,0,8,0,-8
1675,0,0,15,0,-15
1676,0,0,78,0,-78
1677,0,0,17,0,-17
1678,1,0,42,0,-42
1679,1,1,257,1582,1325
1680,1,1,368,1776,1408
1681,0,0,99,0,-99
1682,1,1,335,1339,1004
1683,1,0,22,0,-22
1684,1,1,221,2107,1886
1685,1,1,234,1455,1221
1686,0,0,0,0,0
1687,1,0,87,0,-87
1688,1,1,522,1295,773
1689,1,1,1110,2129,1019
1690,1,0,38,0,-38
1691,1,1,288,1307,1019
1692,0,0,33,0,-33
1693,1,1,1398,1661,263
1694,0,0,177,0,-177
1695,0,0,5,0,-5
1696,1,0,25,0,-25
1697,0,0,47,0,-47
1698,0,0,35,0,-35
1699,0,0,41,0,-41
1700,1,0,104,0,-104
1701,1,0,13,0,-13
1702,0,0,166,0,-166
1703,1,0,46,0,-46
1704,0,0,5,0,-5
1705,1,0,104,0,-104
1706,0,0,73,0,-73
1707,0,0,35,0,-35
1708,0,0,51,0,-51
1709,1,1,42,2069,2027
1710,1,0,122,0,-122
1711,1,0,52,0,-52
1712,1,1,770,1297,527
1713,0,0,19,0,-19
1714,0,0,3,0,-3
1715,0,0,95,0,-95
1716,1,0,10,0,-10
1717,1,1,393,1984,1591
1718,1,1,689,1379,690
1719,0,0,183,0,-183
1720,1,1,1340,1389,49
1721,0,0,43,0,-43
1722,1,0,52,0,-52
1723,1,0,41,0,-41
1724,1,0,46,0,-46
1725,1,0,66,0,-66
1726,1,1,570,1287,717
1727,1,0,47,0,-47
1728,0,0,47,0,-47
1729,0,0,60,0,-60
1730,0,0,19,0,-19
1731,0,0,56,0,-56
1732,0,0,16,0,-16
1733,0,0,243,0,-243
1734,1,1,858,1849,991
1735,1,1,447,1265,818
1736,0,0,94,0,-94
1737,1,0,5,0,-5
1738,1,1,714,1520,806
1739,0,0,102,0,-102
1740,1,1,728,1388,660
1741,0,0,54,0,-54
1742,1,1,395,2315,1920
1743,1,0,48,0,-48
1744,1,0,8,0,-8
1745,1,1,237,1276,1039
1746,0,0,9,0,-9
1747,1,0,165,0,-165
1748,1,0,74,0,-74
1749,0,0,8,0,-8
1750,1,0,14,0,-14
1751,0,0,21,0,-21
1752,1,0,222,0,-222
1753,1,1,382,1203,821
1754,0,0,19,0,-19
1755,0,0,19,0,-19
1756,0,0,7,0,-7
1757,1,1,639,1401,762
1758,1,0,11,0,-11
1759,1,0,9,0,-9
1760,0,0,84,0,-84
1761,1,1,531,1408,877
1762,1,1,341,1221,880
1763,1,1,408,1267,859
1764,1,0,11,0,-11
1765,1,1,112,2227,2115
1766,1,1,107,1315,1208
1767,1,0,43,0,-43
1768,1,0,139,0,-139
1769,0,0,106,0,-106
1770,0,0,0,0,0
1771,0,0,6,0,-6
1772,1,1,805,1226,421
1773,0,0,108,0,-108
1774,1,1,1401,1405,4
1775,1,1,223,1281,1058
1776,0,0,70,0,-70
1777,1,1,560,1226,666
1778,1,1,711,1580,869
1779,1,1,624,1431,807
1780,1,0,62,0,-62
1781,1,1,152,1470,1318
1782,1,0,76,0,-76
1783,0,0,29,0,-29
1784,1,1,287,1353,1066
1785,0,0,76,0,-76
1786,0,0,66,0,-66
1787,0,0,81,0,-81
1788,1,1,110,1325,1215
1789,0,0,52,0,-52
1790,1,1,166,1407,1241
1791,1,0,107,0,-107
1792,1,0,34,0,-34
1793,1,1,303,2607,2304
1794,0,0,43,0,-43
1795,1,1,328,1708,1380
1796,0,0,68,0,-68
1797,1,1,223,1324,1101
1798,0,0,19,0,-19
1799,0,0,52,0,-52
1800,1,1,155,1467,1312
1801,1,1,349,1262,913
1802,1,0,73,0,-73
1803,0,0,18,0,-18
1804,1,0,12,0,-12
1805,1,1,371,3300,2929
1806,1,0,51,0,-51
1807,1,0,17,0,-17
1808,1,0,154,0,-154
1809,1,0,85,0,-85
1810,1,0,11,0,-11
1811,1,1,328,1493,1165
1812,1,1,1651,1562,-89
1813,1,0,109,0,-109
1814,1,1,692,1246,554
1815,0,0,11,0,-11
1816,1,0,23,0,-23
1817,1,0,12,0,-12
1818,1,1,1349,1252,-97
1819,1,1,329,1305,976
1820,1,1,143,1365,1222
1821,1,1,279,1493,1214
1822,1,1,230,1904,1674
1823,0,0,45,0,-45
1824,0,0,14,0,-14
1825,1,0,16,0,-16
1826,1,0,195,0,-195
1827,0,0,9,0,-9
1828,0,0,35,0,-35
1829,0,0,184,0,-184
1830,0,0,77,0,-77
1831,1,0,88,0,-88
1832,1,0,71,0,-71
1833,0,0,54,0,-54
1834,1,0,64,0,-64
1835,0,0,4,0,-4
1836,1,0,10,0,-10
1837,0,0,8,0,-8
1838,0,0,35,0,-35
1839,0,0,14,0,-14
1840,1,1,41,1380,1339
1841,1,1,1048,2692,1644
1842,1,1,1479,1313,-166
1843,0,0,22,0,-22
1844,1,0,81,0,-81
1845,1,1,315,4043,3728
1846,0,0,14,0,-14
1847,0,0,298,0,-298
1848,1,0,19,0,-19
1849,1,1,17,1214,1197
1850,0,0,7,0,-7
1851,1,1,235,1884,1649
1852,1,1,888,2615,1727
1853,1,0,54,0,-54
1854,0,0,27,0,-27
1855,1,0,115,0,-115
1856,0,0,0,0,0
1857,1,0,9,0,-9
1858,1,1,276,1213,937
1859,0,0,199,0,-199
1860,0,0,68,0,-68
1861,1,0,126,0,-126
1862,1,1,504,1289,785
1863,0,0,112,0,-112
1864,1,0,24,0,-24
1865,1,0,7,0,-7
1866,1,1,63,1208,1145
1867,0,0,13,0,-13
1868,1,1,227,1281,1054
1869,1,1,140,1221,1081
1870,1,0,31,0,-31
1871,1,1,333,2189,1856
1872,1,0,99,0,-99
1873,1,0,40,0,-40
1874,1,0,44,0,-44
1875,1,0,12,0,-12
1876,1,0,46,0,-46
1877,0,0,50,0,-50
1878,1,1,217,1943,1726
1879,0,0,115,0,-115
1880,1,0,7,0,-7
1881,1,0,56,0,-56
1882,1,1,305,1747,1442
1883,0,0,53,0,-53
1884,1,0,1,0,-1
1885,1,0,6,0,-6
1886,0,0,24,0,-24
1887,1,1,477,1379,902
1888,1,1,444,1292,848
1889,0,0,108,0,-108
1890,0,0,19,0,-19
1891,0,0,72,0,-72
1892,1,1,689,1355,666
1893,1,0,7,0,-7
1894,1,1,564,2171,1607
1895,1,1,313,1429,1116
1896,1,0,88,0,-88
1897,0,0,82,0,-82
1898,1,0,153,0,-153
1899,0,0,34,0,-34
1900,1,1,79,1576,1497
1901,0,0,6,0,-6
1902,1,1,1377,1282,-95
1903,0,0,190,0,-190
1904,1,1,672,1313,641
1905,1,0,87,0,-87
1906,1,1,475,1439,964
1907,1,0,4,0,-4
1908,0,0,69,0,-69
1909,0,0,11,0,-11
1910,1,1,785,1207,422
1911,1,1,1806,1601,-205
1912,0,0,26,0,-26
1913,0,0,11,0,-11
1914,1,1,470,1278,808
1915,1,0,85,0,-85
1916,0,0,114,0,-114
1917,1,0,34,0,-34
1918,0,0,15,0,-15
1919,1,1,727,1700,973
1920,0,0,22,0,-22
1921,0,0,10,0,-10
1922,1,0,30,0,-30
1923,0,0,14,0,-14
1924,0,0,66,0,-66
1925,1,0,40,0,-40
1926,1,1,572,3586,3014
1927,0,0,4,0,-4
1928,0,0,48,0,-48
1929,0,0,9,0,-9
1930,1,1,157,1773,1616
1931,0,0,170,0,-170
1932,0,0,57,0,-57
1933,1,0,58,0,-58
1934,0,0,34,0,-34
1935,1,0,0,0,0
1936,0,0,116,0,-116
1937,1,0,8,0,-8
1938,1,1,463,1594,1131
1939,1,1,98,1253,1155
1940,0,0,198,0,-198
1941,0,0,18,0,-18
1942,0,0,131,0,-131
1943,1,0,0,0,0
1944,0,0,7,0,-7
1945,1,1,2114,1543,-571
1946,1,0,33,0,-33
1947,0,0,6,0,-6
1948,0,0,43,0,-43
1949,1,0,60,0,-60
1950,0,0,17,0,-17
1951,0,0,19,0,-19
1952,1,0,205,0,-205
1953,1,0,17,0,-17
1954,1,0,10,0,-10
1955,0,0,10,0,-10
1956,1,0,18,0,-18
1957,1,1,157,1369,1212
1958,1,0,26,0,-26
1959,1,1,580,2256,1676
1960,1,0,1,0,-1
1961,1,0,23,0,-23
1962,1,1,392,1241,849
1963,1,0,32,0,-32
1964,1,1,423,1245,822
1965,0,0,16,0,-16
1966,1,0,15,0,-15
1967,1,0,27,0,-27
1968,0,0,8,0,-8
1969,0,0,18,0,-18
1970,0,0,46,0,-46
1971,1,0,24,0,-24
1972,1,1,1842,1311,-531
1973,1,0,225,0,-225
1974,1,0,77,0,-77
1975,1,0,27,0,-27
1976,0,0,56,0,-56
1977,0,0,11,0,-11
1978,1,1,147,1393,1246
1979,1,0,24,0,-24
1980,1,1,346,2252,1906
1981,1,1,358,1221,863
1982,0,0,20,0,-20
1983,0,0,66,0,-66
1984,1,1,424,1694,1270
1985,0,0,5,0,-5
1986,1,1,61,1242,1181
1987,1,1,57,1425,1368
1988,0,0,8,0,-8
1989,1,0,81,0,-81
1990,1,0,277,0,-277
1991,1,1,395,1209,814
1992,1,0,23,0,-23
1993,1,1,709,1235,526
1994,1,1,807,1374,567
1995,1,1,141,1206,1065
1996,1,1,214,1229,1015
1997,1,1,961,2842,1881
1998,0,0,1,0,-1
1999,1,1,71,1303,1232
2000,1,0,2,0,-2
2001,1,0,134,0,-134
2002,1,0,80,0,-80
2003,1,0,169,0,-169
2004,1,0,81,0,-81
2005,0,0,11,0,-11
2006,1,0,1,0,-1
2007,1,0,23,0,-23
2008,0,0,109,0,-109
2009,0,0,71,0,-71
2010,1,0,16,0,-16
2011,1,0,42,0,-42
2012,1,1,358,2113,1755
2013,1,0,65,0,-65
2014,1,1,211,1407,1196
2015,1,1,2351,1395,-956
2016,1,0,241,0,-241
2017,1,1,185,1413,1228
2018,1,1,589,1460,871
2019,1,1,220,1669,1449
2020,1,0,59,0,-59
2021,0,0,19,0,-19
2022,0,0,273,0,-273
2023,0,0,97,0,-97
2024,1,0,53,0,-53
2025,1,0,68,0,-68
2026,1,1,359,1876,1517
2027,1,1,1270,1215,-55
2028,0,0,4,0,-4
2029,1,0,14,0,-14
2030,0,0,4,0,-4
2031,1,0,14,0,-14
2032,1,1,408,1579,1171
2033,0,0,20,0,-20
2034,1,1,1194,1680,486
2035,0,0,114,0,-114
2036,1,0,9,0,-9
2037,1,0,0,0,0
2038,1,1,604,1302,698
2039,1,1,56,1533,1477
2040,0,0,224,0,-224
2041,1,1,1048,1298,250
2042,0,0,112,0,-112
2043,0,0,31,0,-31
2044,0,0,5,0,-5
2045,1,0,29,0,-29
2046,1,1,372,1599,1227
2047,0,0,43,0,-43
2048,1,0,50,0,-50
2049,1,1,1291,1472,181
2050,1,1,65,3435,3370
2051,0,0,0,0,0
2052,1,0,27,0,-27
2053,1,1,892,1213,321
2054,1,0,9,0,-9
2055,0,0,3,0,-3
2056,1,0,124,0,-124
2057,1,1,745,1247,502
2058,0,0,2,0,-2
2059,1,1,1466,1380,-86
2060,0,0,33,0,-33
2061,1,0,19,0,-19
2062,1,0,10,0,-10
2063,1,1,191,1206,1015
2064,1,1,1254,1502,248
2065,0,0,164,0,-164
2066,0,0,36,0,-36
2067,1,0,57,0,-57
2068,0,0,20,0,-20
2069,1,1,707,1402,695
2070,1,0,4,0,-4
2071,0,0,4,0,-4
2072,1,0,23,0,-23
2073,1,0,145,0,-145
2074,1,1,149,1448,1299
2075,0,0,17,0,-17
2076,0,0,58,0,-58
2077,1,1,820,1207,387
2078,0,0,25,0,-25
2079,0,0,86,0,-86
2080,1,0,78,0,-78
2081,1,1,431,1849,1418
2082,1,0,133,0,-133
2083,1,0,28,0,-28
2084,1,1,634,1589,955
2085,1,0,9,0,-9
2086,0,0,32,0,-32
2087,1,1,679,1204,525
2088,1,1,565,1472,907
2089,0,0,35,0,-35
2090,0,0,22,0,-22
2091,1,1,650,2370,1720
2092,0,0,0,0,0
2093,1,1,1004,2557,1553
2094,1,1,431,1455,1024
2095,1,1,135,1367,1232
2096,1,1,343,1471,1128
2097,0,0,1,0,-1
2098,0,0,102,0,-102
2099,0,0,95,0,-95
2100,1,0,6,0,-6
2101,0,0,38,0,-38
2102,1,1,144,1329,1185
2103,1,1,830,1509,679
2104,0,0,21,0,-21
2105,1,0,78,0,-78
2106,0,0,97,0,-97
2107,0,0,11,0,-11
2108,1,0,19,0,-19
2109,1,0,35,0,-35
2110,1,0,65,0,-65
2111,1,0,37,0,-37
2112,1,0,70,0,-70
2113,0,0,227,0,-227
2114,1,0,151,0,-151
2115,1,0,35,0,-35
2116,1,1,258,2746,2488
2117,0,0,77,0,-77
2118,0,0,72,0,-72
2119,1,1,159,1736,1577
2120,0,0,82,0,-82
2121,0,0,22,0,-22
2122,1,1,292,1376,1084
2123,0,0,23,0,-23
2124,1,1,1180,1241,61
2125,1,0,27,0,-27
2126,0,0,20,0,-20
2127,0,0,65,0,-65
2128,1,0,181,0,-181
2129,0,0,28,0,-28
2130,0,0,68,0,-68
2131,0,0,48,0,-48
2132,0,0,8,0,-8
2133,1,1,199,1405,1206
2134,1,1,80,1906,1826
2135,1,1,201,2067,1866
2136,1,1,945,1671,726
2137,1,0,14,0,-14
2138,1,1,1701,2062,361
2139,0,0,81,0,-81
2140,0,0,25,0,-25
2141,0,0,97,0,-97
2142,0,0,24,0,-24
2143,1,1,293,1465,1172
2144,1,1,135,1418,1283
2145,0,0,29,0,-29
2146,1,0,231,0,-231
2147,0,0,58,0,-58
2148,1,0,46,0,-46
2149,0,0,62,0,-62
2150,0,0,14,0,-14
2151,1,1,420,1252,832
2152,1,0,91,0,-91
2153,0,0,64,0,-64
2154,1,1,429,1515,1086
2155,1,0,64,0,-64
2156,0,0,35,0,-35
2157,0,0,49,0,-49
2158,0,0,101,0,-101
2159,1,0,57,0,-57
2160,1,1,527,1249,722
2161,1,1,512,1363,851
2162,0,0,16,0,-16
2163,1,1,100,1458,1358
2164,1,0,41,0,-41
2165,0,0,96,0,-96
2166,1,0,16,0,-16
2167,1,0,83,0,-83
2168,1,0,32,0,-32
2169,0,0,244,0,-244
2170,0,0,8,0,-8
2171,0,0,90,0,-90
2172,1,0,34,0,-34
2173,1,0,91,0,-91
2174,1,1,50,2256,2206
2175,1,0,19,0,-19
2176,0,0,47,0,-47
2177,1,1,129,1312,1183
2178,0,0,2,0,-2
2179,0,0,40,0,-40
2180,1,0,35,0,-35
2181,1,0,8,0,-8
2182,1,1,381,1745,1364
2183,1,1,199,1329,1130
2184,1,0,0,0,0
2185,0,0,109,0,-109
2186,1,0,36,0,-36
2187,0,0,40,0,-40
2188,1,0,78,0,-78
2189,1,1,1179,1241,62
2190,0,0,3,0,-3
2191,0,0,107,0,-107
2192,0,0,28,0,-28
2193,1,1,588,1564,976
2194,1,0,103,0,-103
2195,1,1,167,1390,1223
2196,0,0,154,0,-154
2197,1,0,28,0,-28
2198,1,0,36,0,-36
2199,1,1,290,1558,1268
2200,0,0,4,0,-4
2201,1,0,67,0,-67
2202,0,0,0,0,0
2203,0,0,41,0,-41
2204,0,0,37,0,-37
2205,0,0,34,0,-34
2206,0,0,86,0,-86
2207,1,0,24,0,-24
2208,1,1,1362,1211,-151
2209,0,0,5,0,-5
2210,0,0,37,0,-37
2211,1,1,1039,1335,296
2212,0,0,102,0,-102
2213,0,0,26,0,-26
2214,1,1,710,1374,664
2215,0,0,16,0,-16
2216,1,1,536,1538,1002
2217,1,1,279,1477,1198
2218,1,0,29,0,-29
2219,1,1,472,1275,803
2220,0,0,5,0,-5
2221,1,0,17,0,-17
2222,0,0,103,0,-103
2223,0,0,16,0,-16
2224,1,1,629,1214,585
2225,1,0,59,0,-59
2226,0,0,73,0,-73
2227,1,0,26,0,-26
2228,0,0,46,0,-46
2229,0,0,68,0,-68
2230,0,0,0,0,0
2231,1,1,813,1209,396
2232,0,0,36,0,-36
2233,1,0,2,0,-2
2234,0,0,22,0,-22
2235,1,1,606,1358,752
2236,1,1,264,1872,1608
2237,0,0,22,0,-22
2238,0,0,49,0,-49
2239,0,0,4,0,-4
2240,1,1,190,2147,1957
2241,0,0,66,0,-66
2242,0,0,20,0,-20
2243,1,0,46,0,-46
2244,1,1,530,1556,1026
2245,1,1,204,1489,1285
2246,1,0,125,0,-125
2247,0,0,56,0,-56
2248,0,0,44,0,-44
2249,1,0,199,0,-199
2250,0,0,5,0,-5
2251,1,0,90,0,-90
2252,1,0,61,0,-61
2253,1,1,504,2026,1522
2254,0,0,5,0,-5
2255,0,0,30,0,-30
2256,0,0,135,0,-135
2257,1,0,73,0,-73
2258,1,1,449,1813,1364
2259,1,1,577,2828,2251
2260,1,0,108,0,-108
2261,1,1,118,1901,1783
2262,0,0,41,0,-41
2263,1,1,144,2381,2237
2264,0,0,51,0,-51
2265,1,0,36,0,-36
2266,1,1,85,1356,1271
2267,1,1,1283,1218,-65
2268,0,0,59,0,-59
2269,1,1,182,1246,1064
2270,1,1,142,1796,1654
2271,1,1,487,1406,919
2272,0,0,317,0,-317
2273,0,0,212,0,-212
2274,1,1,34,1301,1267
2275,0,0,2,0,-2
2276,0,0,45,0,-45
2277,1,0,25,0,-25
2278,0,0,134,0,-134
2279,1,1,416,1379,963
2280,0,0,55,0,-55
2281,1,0,176,0,-176
2282,0,0,7,0,-7
2283,1,1,533,2801,2268
2284,1,1,1066,1208,142
2285,0,0,9,0,-9
2286,1,1,328,1457,1129
2287,1,1,289,1207,918
2288,0,0,5,0,-5
2289,1,1,20,1478,1458
2290,0,0,9,0,-9
2291,0,0,13,0,-13
2292,0,0,34,0,-34
2293,1,1,894,1307,413
2294,1,0,33,0,-33
2295,1,0,79,0,-79
2296,0,0,52,0,-52
2297,0,0,16,0,-16
2298,1,0,42,0,-42
2299,1,0,101,0,-101
2300,1,1,239,1381,1142
2301,0,0,111,0,-111
2302,1,0,9,0,-9
2303,0,0,34,0,-34
2304,0,0,122,0,-122
2305,0,0,24,0,-24
2306,1,1,851,1447,596
2307,1,1,184,2642,2458
2308,1,1,157,1692,1535
2309,0,0,7,0,-7
2310,0,0,59,0,-59
2311,1,1,388,1248,860
2312,0,0,14,0,-14
2313,1,0,5,0,-5
2314,0,0,11,0,-11
2315,1,0,37,0,-37
2316,1,1,88,2122,2034
2317,1,1,135,1701,1566
2318,1,1,1437,1252,-185
2319,1,1,195,1242,1047
2320,1,0,13,0,-13
2321,1,0,91,0,-91
2322,0,0,215,0,-215
2323,1,1,1236,2280,1044
2324,1,0,159,0,-159
2325,0,0,19,0,-19
2326,0,0,264,0,-264
2327,0,0,6,0,-6
2328,1,0,130,0,-130
2329,1,1,473,1512,1039
2330,1,1,363,1656,1293
2331,1,0,26,0,-26
2332,1,0,155,0,-155
2333,1,0,40,0,-40
2334,1,0,9,0,-9
2335,0,0,75,0,-75
2336,1,0,44,0,-44
2337,0,0,53,0,-53
2338,0,0,93,0,-93
2339,1,0,166,0,-166
2340,1,1,1255,3579,2324
2341,0,0,46,0,-46
2342,1,0,46,0,-46
2343,1,1,119,1350,1231
2344,0,0,51,0,-51
2345,0,0,86,0,-86
2346,1,0,28,0,-28
2347,0,0,5,0,-5
2348,0,0,15,0,-15
2349,1,0,26,0,-26
2350,0,0,46,0,-46
2351,1,0,17,0,-17
2352,1,1,68,1712,1644
2353,1,1,559,1231,672
2354,1,1,358,1311,953
2355,1,0,113,0,-113
2356,0,0,151,0,-151
2357,0,0,19,0,-19
2358,0,0,68,0,-68
2359,0,0,19,0,-19
2360,1,0,7,0,-7
2361,1,1,1072,1350,278
2362,0,0,133,0,-133
2363,1,0,164,0,-164
2364,0,0,57,0,-57
2365,1,1,206,1413,1207
2366,1,1,173,1448,1275
2367,1,1,460,1469,1009
2368,0,0,36,0,-36
2369,0,0,45,0,-45
2370,0,0,94,0,-94
2371,1,0,24,0,-24
2372,1,0,13,0,-13
2373,0,0,2,0,-2
2374,1,0,53,0,-53
2375,1,1,862,1203,341
2376,1,0,65,0,-65
2377,1,1,69,1227,1158
2378,1,0,48,0,-48
2379,0,0,11,0,-11
2380,1,1,174,1283,1109
2381,1,1,678,1452,774
2382,1,1,876,4249,3373
2383,0,0,105,0,-105
2384,0,0,16,0,-16
2385,1,1,565,1724,1159
2386,1,1,154,1249,1095
2387,0,0,210,0,-210
2388,1,0,3,0,-3
2389,1,1,211,2183,1972
2390,1,1,210,1217,1007
2391,1,0,5,0,-5
2392,0,0,37,0,-37
2393,1,0,42,0,-42
2394,0,0,31,0,-31
2395,1,1,1077,1493,416
2396,0,0,31,0,-31
2397,1,1,679,1503,824
2398,1,1,151,1581,1430
2399,1,1,90,1214,1124
2400,1,1,1330,4441,3111
2401,0,0,62,0,-62
2402,1,1,85,1258,1173
2403,1,0,65,0,-65
2404,0,0,101,0,-101
2405,1,1,1271,3047,1776
2406,0,0,34,0,-34
2407,1,1,133,1557,1424
2408,0,0,70,0,-70
2409,1,0,9,0,-9
2410,1,0,75,0,-75
2411,0,0,13,0,-13
2412,0,0,21,0,-21
2413,0,0,5,0,-5
2414,1,0,85,0,-85
2415,1,1,196,2138,1942
2416,1,1,194,1287,1093
2417,1,1,597,1293,696
2418,1,0,30,0,-30
2419,1,1,348,2644,2296
2420,1,1,1073,1257,184
2421,1,1,353,1245,892
2422,0,0,33,0,-33
2423,1,1,597,1464,867
2424,0,0,68,0,-68
2425,1,0,151,0,-151
2426,1,0,24,0,-24
2427,1,0,12,0,-12
2428,1,1,753,1219,466
2429,1,1,1568,1298,-270
2430,1,1,159,1437,1278
2431,1,1,1712,1248,-464
2432,0,0,34,0,-34
2433,0,0,28,0,-28
2434,1,1,492,1480,988
2435,1,0,17,0,-17
2436,0,0,9,0,-9
2437,0,0,8,0,-8
2438,0,0,150,0,-150
2439,1,1,253,1630,1377
2440,1,0,4,0,-4
2441,1,0,135,0,-135
2442,0,0,73,0,-73
2443,1,0,72,0,-72
2444,1,1,438,1541,1103
2445,1,0,6,0,-6
2446,1,0,19,0,-19
2447,0,0,1,0,-1
2448,0,0,69,0,-69
2449,1,1,400,1747,1347
2450,1,1,99,1818,1719
2451,0,0,124,0,-124
2452,1,0,20,0,-20
2453,1,0,100,0,-100
2454,0,0,35,0,-35
2455,0,0,8,0,-8
2456,1,0,63,0,-63
2457,0,0,178,0,-178
2458,1,0,21,0,-21
2459,1,1,47,1336,1289
2460,1,1,1754,1731,-23
2461,1,0,42,0,-42
2462,1,0,51,0,-51
2463,1,1,2334,1724,-610
2464,1,0,17,0,-17
2465,0,0,156,0,-156
2466,1,0,3,0,-3
2467,0,0,58,0,-58
2468,1,1,629,1708,1079
2469,1,1,159,1234,1075
2470,0,0,115,0,-115
2471,0,0,35,0,-35
2472,1,0,88,0,-88
2473,1,0,78,0,-78
2474,1,1,653,3781,3128
2475,1,0,18,0,-18
2476,1,0,13,0,-13
2477,1,0,41,0,-41
2478,0,0,218,0,-218
2479,1,0,50,0,-50
2480,1,0,16,0,-16
2481,0,0,71,0,-71
2482,0,0,23,0,-23
2483,0,0,85,0,-85
2484,0,0,115,0,-115
2485,1,0,28,0,-28
2486,1,0,9,0,-9
2487,0,0,35,0,-35
2488,1,1,892,1655,763
2489,1,0,42,0,-42
2490,1,1,415,1242,827
2491,1,1,390,1539,1149
2492,0,0,45,0,-45
2493,1,1,1405,1211,-194
2494,0,0,8,0,-8
2495,1,1,287,1259,972
2496,1,1,450,1274,824
2497,1,0,3,0,-3
2498,1,0,27,0,-27
2499,0,0,2,0,-2
2500,1,0,0,0,0
2501,1,1,1306,1228,-78
2502,0,0,0,0,0
2503,0,0,42,0,-42
2504,0,0,48,0,-48
2505,0,0,69,0,-69
2506,1,1,432,2178,1746
2507,0,0,12,0,-12
2508,1,1,33,1268,1235
2509,1,1,330,1552,1222
2510,1,0,12,0,-12
2511,1,0,31,0,-31
2512,1,0,27,0,-27
2513,0,0,222,0,-222
2514,0,0,123,0,-123
2515,0,0,31,0,-31
2516,1,0,36,0,-36
2517,1,0,106,0,-106
2518,1,0,1,0,-1
2519,0,0,26,0,-26
2520,1,0,37,0,-37
2521,0,0,137,0,-137
2522,0,0,45,0,-45
2523,1,1,331,1272,941
2524,1,1,1229,1202,-27
2525,0,0,37,0,-37
2526,0,0,43,0,-43
2527,0,0,1,0,-1
2528,1,0,104,0,-104
2529,1,0,72,0,-72
2530,1,1,299,1223,924
2531,0,0,4,0,-4
2532,1,0,61,0,-61
2533,0,0,82,0,-82
2534,1,0,36,0,-36
2535,0,0,39,0,-39
2536,1,0,53,0,-53
2537,1,0,107,0,-107
2538,1,0,48,0,-48
2539,1,0,138,0,-138
2540,1,1,2335,1225,-1110
2541,0,0,98,0,-98
2542,1,1,39,1665,1626
2543,0,0,5,0,-5
2544,1,1,297,2899,2602
2545,1,0,42,0,-42
2546,0,0,10,0,-10
2547,1,1,306,2166,1860
2548,0,0,83,0,-83
2549,1,0,45,0,-45
2550,1,1,360,1295,935
2551,1,1,346,1418,1072
2552,1,1,1261,1600,339
2553,1,0,125,0,-125
2554,0,0,29,0,-29
2555,0,0,0,0,0
2556,1,1,191,1646,1455
2557,0,0,8,0,-8
2558,1,0,132,0,-132
2559,1,1,88,1553,1465
2560,1,0,120,0,-120
2561,0,0,8,0,-8
2562,1,1,36,1200,1164
2563,1,0,77,0,-77
2564,0,0,79,0,-79
2565,1,0,3,0,-3
2566,0,0,25,0,-25
2567,1,1,402,1439,1037
2568,1,1,1233,1912,679
2569,1,0,8,0,-8
2570,0,0,238,0,-238
2571,1,0,111,0,-111
2572,0,0,21,0,-21
2573,0,0,240,0,-240
2574,1,1,173,1436,1263
2575,1,1,346,1953,1607
2576,0,0,8,0,-8
2577,1,0,18,0,-18
2578,0,0,2,0,-2
2579,1,1,201,1362,1161
2580,0,0,68,0,-68
2581,1,0,26,0,-26
2582,1,1,479,1476,997
2583,0,0,38,0,-38
2584,1,1,489,1669,1180
2585,0,0,44,0,-44
2586,1,1,149,1318,1169
2587,1,0,79,0,-79
2588,0,0,57,0,-57
2589,0,0,23,0,-23
2590,0,0,19,0,-19
2591,0,0,0,0,0
2592,0,0,15,0,-15
2593,1,1,344,1474,1130
2594,1,1,259,1561,1302
2595,0,0,39,0,-39
2596,1,0,43,0,-43
2597,1,1,718,1648,930
2598,1,1,46,1303,1257
2599,1,1,681,1726,1045
2600,0,0,164,0,-164
2601,1,1,1484,1362,-122
2602,1,1,282,1267,985
2603,1,0,5,0,-5
2604,1,1,250,1340,1090
2605,1,0,57,0,-57
2606,0,0,18,0,-18
2607,0,0,28,0,-28
2608,1,0,35,0,-35
2609,0,0,43,0,-43
2610,1,0,15,0,-15
2611,1,0,33,0,-33
2612,1,0,104,0,-104
2613,1,1,487,1566,1079
2614,1,1,48,1299,1251
2615,1,1,333,1818,1485
2616,1,1,244,2407,2163
2617,1,0,175,0,-175
2618,1,1,46,1693,1647
2619,1,0,12,0,-12
2620,1,0,96,0,-96
2621,1,0,126,0,-126
2622,0,0,4,0,-4
2623,1,1,58,1270,1212
2624,1,1,566,1459,893
2625,1,0,43,0,-43
2626,1,1,646,4704,4058
2627,1,1,2466,1517,-949
2628,0,0,13,0,-13
2629,0,0,22,0,-22
2630,1,1,597,1996,1399
2631,1,1,168,1739,1571
2632,0,0,47,0,-47
2633,1,0,17,0,-17
2634,1,1,292,1294,1002
2635,0,0,1,0,-1
2636,1,1,388,1598,1210
2637,1,0,80,0,-80
2638,1,1,782,1263,481
2639,1,1,461,1536,1075
2640,0,0,64,0,-64
2641,1,1,62,1611,1549
2642,0,0,26,0,-26
2643,1,0,16,0,-16
2644,1,1,361,1606,1245
2645,0,0,139,0,-139
2646,1,0,11,0,-11
2647,1,1,1029,1290,261
2648,1,1,127,1748,1621
2649,0,0,11,0,-11
2650,1,0,49,0,-49
2651,1,0,67,0,-67
2652,0,0,14,0,-14
2653,0,0,177,0,-177
2654,0,0,64,0,-64
2655,0,0,7,0,-7
2656,1,1,134,1317,1183
2657,1,0,4,0,-4
2658,0,0,21,0,-21
2659,0,0,43,0,-43
2660,0,0,15,0,-15
2661,1,0,143,0,-143
2662,0,0,10,0,-10
2663,1,0,3,0,-3
2664,0,0,80,0,-80
2665,0,0,19,0,-19
2666,1,0,15,0,-15
2667,0,0,32,0,-32
2668,0,0,14,0,-14
2669,0,0,24,0,-24
2670,0,0,19,0,-19
2671,1,0,37,0,-37
2672,1,0,43,0,-43
2673,0,0,8,0,-8
2674,1,1,390,1280,890
2675,1,0,50,0,-50
2676,1,1,204,1227,1023
2677,1,0,7,0,-7
2678,1,0,15,0,-15
2679,0,0,85,0,-85
2680,1,1,182,1367,1185
2681,1,1,918,1302,384
2682,0,0,193,0,-193
2683,1,1,297,1303,1006
2684,0,0,55,0,-55
2685,1,0,11,0,-11
2686,1,1,2402,1566,-836
2687,0,0,3,0,-3
2688,1,0,24,0,-24
2689,0,0,51,0,-51
2690,1,1,658,1581,923
2691,0,0,26,0,-26
2692,0,0,20,0,-20
2693,1,0,78,0,-78
2694,1,0,21,0,-21
2695,1,1,591,1282,691
2696,1,0,34,0,-34
2697,1,0,45,0,-45
2698,1,0,72,0,-72
2699,0,0,21,0,-21
2700,0,0,25,0,-25
2701,0,0,14,0,-14
2702,1,1,453,1253,800
2703,0,0,79,0,-79
2704,0,0,43,0,-43
2705,0,0,141,0,-141
2706,0,0,4,0,-4
2707,0,0,20,0,-20
2708,1,0,15,0,-15
2709,1,1,210,1470,1260
2710,0,0,7,0,-7
2711,1,1,110,1820,1710
2712,0,0,70,0,-70
2713,0,0,127,0,-127
2714,1,1,58,1463,1405
2715,1,1,750,1440,690
2716,1,0,30,0,-30
2717,0,0,9,0,-9
2718,1,0,110,0,-110
2719,0,0,79,0,-79
2720,1,0,82,0,-82
2721,1,0,237,0,-237
2722,0,0,129,0,-129
2723,1,1,1859,1249,-610
2724,1,0,34,0,-34
2725,1,1,208,1338,1130
2726,1,1,255,1454,1199
2727,1,1,249,1816,1567
2728,1,0,51,0,-51
2729,0,0,26,0,-26
2730,0,0,22,0,-22
2731,1,1,118,2262,2144
2732,1,1,462,1321,859
2733,1,0,19,0,-19
2734,1,0,143,0,-143
2735,1,1,381,1285,904
2736,1,0,100,0,-100
2737,0,0,79,0,-79
2738,1,0,98,0,-98
2739,0,0,28,0,-28
2740,1,0,4,0,-4
2741,1,0,136,0,-136
2742,0,0,225,0,-225
2743,0,0,47,0,-47
2744,1,0,18,0,-18
2745,0,0,23,0,-23
2746,1,0,50,0,-50
2747,0,0,52,0,-52
2748,1,0,23,0,-23
2749,0,0,60,0,-60
2750,1,1,470,2063,1593
2751,1,0,30,0,-30
2752,1,1,23,1412,1389
2753,1,1,448,2419,1971
2754,1,1,545,1407,862
2755,1,1,117,1572,1455
2756,1,1,1183,1416,233
2757,1,1,947,1290,343
2758,1,0,14,0,-14
2759,1,1,204,1651,1447
2760,0,0,14,0,-14
2761,1,0,17,0,-17
2762,1,0,29,0,-29
2763,0,0,29,0,-29
2764,1,0,49,0,-49
2765,0,0,27,0,-27
2766,0,0,4,0,-4
2767,1,1,1675,2120,445
2768,0,0,29,0,-29
2769,1,1,212,1235,1023
2770,1,1,837,1556,719
2771,0,0,24,0,-24
2772,1,0,14,0,-14
2773,0,0,166,0,-166
2774,0,0,36,0,-36
2775,1,1,239,2416,2177
2776,0,0,159,0,-159
2777,1,1,265,1275,1010
2778,0,0,110,0,-110
2779,0,0,76,0,-76
2780,0,0,9,0,-9
2781,1,1,1974,2812,838
2782,1,1,942,1809,867
2783,0,0,3,0,-3
2784,0,0,60,0,-60
2785,1,1,2705,1320,-1385
2786,0,0,22,0,-22
2787,1,0,34,0,-34
2788,1,1,142,1401,1259
2789,0,0,79,0,-79
2790,1,1,599,1321,722
2791,0,0,46,0,-46
2792,1,1,475,1206,731
2793,1,1,154,1524,1370
2794,1,0,83,0,-83
2795,1,1,159,1246,1087
2796,1,0,132,0,-132
2797,1,1,307,1755,1448
2798,1,1,995,1349,354
2799,0,0,8,0,-8
2800,1,1,366,1326,960
2801,1,0,15,0,-15
2802,0,0,65,0,-65
2803,1,1,76,1961,1885
2804,1,1,989,1654,665
2805,1,0,35,0,-35
2806,0,0,64,0,-64
2807,1,0,211,0,-211
2808,0,0,35,0,-35
2809,1,1,59,1201,1142
2810,0,0,3,0,-3
2811,1,0,103,0,-103
2812,1,1,228,1372,1144
2813,1,0,27,0,-27
2814,0,0,167,0,-167
2815,1,0,24,0,-24
2816,0,0,44,0,-44
2817,0,0,43,0,-43
2818,0,0,15,0,-15
2819,0,0,75,0,-75
2820,1,1,1002,1368,366
2821,0,0,22,0,-22
2822,1,0,165,0,-165
2823,0,0,3,0,-3
2824,1,0,1,0,-1
2825,1,0,11,0,-11
2826,0,0,13,0,-13
2827,1,1,1100,1309,209
2828,0,0,17,0,-17
2829,0,0,29,0,-29
2830,1,1,722,1375,653
2831,0,0,80,0,-80
2832,0,0,61,0,-61
2833,1,0,6,0,-6
2834,0,0,84,0,-84
2835,1,1,155,2995,2840
2836,0,0,84,0,-84
2837,1,1,847,1530,683
2838,1,0,126,0,-126
2839,0,0,30,0,-30
2840,1,1,27,1407,1380
2841,1,1,898,2036,1138
2842,1,0,50,0,-50
2843,1,1,380,1247,867
2844,0,0,116,0,-116
2845,1,0,34,0,-34
2846,1,1,390,4492,4102
2847,0,0,23,0,-23
2848,1,0,8,0,-8
2849,1,1,420,1553,1133
2850,1,0,0,0,0
2851,1,0,63,0,-63
2852,0,0,11,0,-11
2853,1,1,405,1319,914
2854,1,1,839,1488,649
2855,1,0,44,0,-44
2856,1,1,435,1397,962
2857,1,1,692,1767,1075
2858,1,1,291,1810,1519
2859,0,0,22,0,-22
2860,0,0,45,0,-45
2861,1,0,42,0,-42
2862,1,1,88,1248,1160
2863,0,0,25,0,-25
2864,1,0,70,0,-70
2865,1,0,19,0,-19
2866,1,1,793,1595,802
2867,1,1,684,1259,575
2868,1,0,63,0,-63
2869,0,0,74,0,-74
2870,0,0,17,0,-17
2871,0,0,275,0,-275
2872,1,0,173,0,-173
2873,0,0,12,0,-12
2874,1,1,1174,1212,38
2875,1,0,5,0,-5
2876,0,0,25,0,-25
2877,0,0,43,0,-43
2878,1,1,90,1542,1452
2879,1,1,656,1205,549
2880,1,0,8,0,-8
2881,1,1,350,1220,870
2882,0,0,217,0,-217
2883,1,0,23,0,-23
2884,0,0,192,0,-192
2885,1,1,842,1896,1054
2886,1,0,82,0,-82
2887,1,0,19,0,-19
2888,1,0,87,0,-87
2889,1,0,6,0,-6
2890,0,0,36,0,-36
2891,1,1,1017,1285,268
2892,0,0,40,0,-40
2893,1,0,7,0,-7
2894,0,0,12,0,-12
2895,1,1,468,1502,1034
2896,1,1,91,1468,1377
2897,1,1,1076,1202,126
2898,0,0,84,0,-84
2899,1,0,2,0,-2
2900,1,1,299,1475,1176
2901,1,1,343,1252,909
2902,1,0,20,0,-20
2903,0,0,10,0,-10
2904,0,0,38,0,-38
2905,1,1,204,1369,1165
2906,0,0,17,0,-17
2907,0,0,66,0,-66
2908,1,1,576,1249,673
2909,1,1,142,1223,1081
2910,1,0,74,0,-74
2911,1,0,12,0,-12
2912,1,0,15,0,-15
2913,1,0,171,0,-171
2914,1,1,1069,1208,139
2915,1,0,69,0,-69
2916,1,1,568,1272,704
2917,1,0,55,0,-55
2918,0,0,62,0,-62
2919,1,0,100,0,-100
2920,1,1,70,1568,1498
2921,0,0,60,0,-60
2922,0,0,47,0,-47
2923,0,0,44,0,-44
2924,0,0,28,0,-28
2925,0,0,18,0,-18
2926,0,0,25,0,-25
2927,1,1,616,1555,939
2928,1,0,48,0,-48
2929,0,0,18,0,-18
2930,1,0,56,0,-56
2931,1,0,15,0,-15
2932,0,0,52,0,-52
2933,0,0,8,0,-8
2934,0,0,40,0,-40
2935,0,0,4,0,-4
2936,1,1,81,1570,1489
2937,0,0,97,0,-97
2938,1,0,4,0,-4
2939,0,0,122,0,-122
2940,1,1,849,1201,352
2941,0,0,10,0,-10
2942,1,0,30,0,-30
2943,0,0,7,0,-7
2944,0,0,2,0,-2
2945,1,1,1021,1505,484
2946,1,1,872,1567,695
2947,1,1,913,1600,687
2948,0,0,16,0,-16
2949,0,0,180,0,-180
2950,1,0,26,0,-26
2951,1,0,9,0,-9
2952,1,1,103,1223,1120
2953,1,0,42,0,-42
2954,0,0,4,0,-4
2955,1,0,13,0,-13
2956,0,0,109,0,-109
2957,0,0,13,0,-13
2958,0,0,43,0,-43
2959,0,0,15,0,-15
2960,1,0,34,0,-34
2961,0,0,54,0,-54
2962,1,1,414,1204,790
2963,1,0,41,0,-41
2964,0,0,101,0,-101
2965,0,0,138,0,-138
2966,0,0,31,0,-31
2967,0,0,74,0,-74
2968,1,1,346,1669,1323
2969,1,1,314,2614,2300
2970,0,0,151,0,-151
2971,1,0,12,0,-12
2972,1,1,40,1977,1937
2973,0,0,45,0,-45
2974,0,0,71,0,-71
2975,1,1,277,1329,1052
2976,1,0,16,0,-16
2977,0,0,25,0,-25
2978,1,1,14,3310,3296
2979,0,0,129,0,-129
2980,1,1,471,1687,1216
2981,1,0,3,0,-3
2982,1,0,110,0,-110
2983,1,1,187,1211,1024
2984,1,1,1573,1212,-361
2985,1,0,16,0,-16
2986,1,1,286,1565,1279
2987,0,0,17,0,-17
2988,0,0,22,0,-22
2989,1,1,281,1442,1161
2990,1,1,1141,1452,311
2991,1,1,1647,1624,-23
2992,0,0,23,0,-23
2993,1,1,395,1599,1204
2994,0,0,18,0,-18
2995,0,0,21,0,-21
2996,1,0,27,0,-27
2997,0,0,10,0,-10
2998,1,1,595,1347,752
2999,0,0,35,0,-35
3000,1,0,24,0,-24
3001,1,0,130,0,-130
3002,0,0,21,0,-21
3003,0,0,21,0,-21
3004,1,0,36,0,-36
3005,1,0,144,0,-144
3006,1,1,618,1506,888
3007,1,0,26,0,-26
3008,1,0,121,0,-121
3009,1,0,84,0,-84
3010,1,1,602,1216,614
3011,0,0,20,0,-20
3012,0,0,32,0,-32
3013,0,0,7,0,-7
3014,1,0,5,0,-5
3015,0,0,82,0,-82
3016,0,0,68,0,-68
3017,0,0,79,0,-79
3018,0,0,51,0,-51
3019,0,0,29,0,-29
3020,0,0,12,0,-12
3021,1,0,38,0,-38
3022,1,1,149,1242,1093
3023,1,0,39,0,-39
3024,0,0,17,0,-17
3025,0,0,18,0,-18
3026,1,1,638,1265,627
3027,1,0,21,0,-21
3028,1,1,1109,1589,480
3029,1,0,14,0,-14
3030,1,1,314,1226,912
3031,1,0,23,0,-23
3032,1,0,69,0,-69
3033,1,0,72,0,-72
3034,1,1,340,1310,970
3035,1,0,1,0,-1
3036,1,0,30,0,-30
3037,0,0,56,0,-56
3038,0,0,16,0,-16
3039,1,0,38,0,-38
3040,0,0,142,0,-142
3041,0,0,282,0,-282
3042,0,0,147,0,-147
3043,1,0,99,0,-99
3044,0,0,25,0,-25
3045,0,0,77,0,-77
3046,1,1,118,1446,1328
3047,1,1,707,1553,846
3048,1,0,75,0,-75
3049,1,0,12,0,-12
3050,1,1,879,2482,1603
3051,0,0,74,0,-74
3052,0,0,5,0,-5
3053,1,0,38,0,-38
3054,1,0,37,0,-37
3055,1,1,115,1324,1209
3056,1,0,5,0,-5
3057,0,0,14,0,-14
3058,1,1,292,1312,1020
3059,1,0,35,0,-35
3060,1,0,74,0,-74
3061,1,0,79,0,-79
3062,1,0,0,0,0
3063,0,0,4,0,-4
3064,0,0,187,0,-187
3065,1,1,504,2559,2055
3066,0,0,47,0,-47
3067,0,0,17,0,-17
3068,1,0,8,0,-8
3069,0,0,11,0,-11
3070,1,0,3,0,-3
3071,1,0,46,0,-46
3072,0,0,15,0,-15
3073,0,0,30,0,-30
3074,0,0,9,0,-9
3075,1,1,133,1250,1117
3076,0,0,67,0,-67
3077,0,0,11,0,-11
3078,1,0,66,0,-66
3079,0,0,58,0,-58
3080,1,0,95,0,-95
3081,0,0,104,0,-104
3082,1,1,1306,1307,1
3083,1,1,314,1627,1313
3084,0,0,74,0,-74
3085,1,1,367,1408,1041
3086,0,0,39,0,-39
3087,1,1,485,1637,1152
3088,0,0,20,0,-20
3089,0,0,8,0,-8
3090,1,1,123,2385,2262
3091,1,1,612,1242,630
3092,0,0,200,0,-200
3093,0,0,63,0,-63
3094,0,0,17,0,-17
3095,1,1,530,2056,1526
3096,0,0,38,0,-38
3097,0,0,57,0,-57
3098,1,1,64,1208,1144
3099,0,0,8,0,-8
3100,1,0,75,0,-75
3101,1,1,61,1384,1323
3102,0,0,16,0,-16
3103,1,1,421,1406,985
3104,1,0,22,0,-22
3105,0,0,41,0,-41
3106,1,1,142,2179,2037
3107,1,1,923,1492,569
3108,0,0,10,0,-10
3109,1,1,1288,1630,342
3110,0,0,113,0,-113
3111,1,0,26,0,-26
3112,0,0,15,0,-15
3113,0,0,19,0,-19
3114,1,0,55,0,-55
3115,1,1,1846,1211,-635
3116,0,0,49,0,-49
3117,1,0,105,0,-105
3118,1,0,14,0,-14
3119,1,0,45,0,-45
3120,0,0,9,0,-9
3121,1,1,153,1309,1156
3122,0,0,58,0,-58
3123,1,0,42,0,-42
3124,0,0,2,0,-2
3125,1,1,88,3086,2998
3126,0,0,120,0,-120
3127,1,0,94,0,-94
3128,0,0,70,0,-70
3129,0,0,3,0,-3
3130,1,1,306,1318,1012
3131,1,0,88,0,-88
3132,1,0,63,0,-63
3133,1,1,168,1696,1528
3134,1,1,254,1281,1027
3135,1,0,34,0,-34
3136,1,0,2,0,-2
3137,0,0,54,0,-54
3138,0,0,8,0,-8
3139,1,1,95,1627,1532
3140,0,0,55,0,-55
3141,0,0,156,0,-156
3142,0,0,30,0,-30
3143,0,0,4,0,-4
3144,1,0,27,0,-27
3145,0,0,64,0,-64
3146,0,0,9,0,-9
3147,1,0,10,0,-10
3148,1,0,41,0,-41
3149,0,0,69,0,-69
3150,1,1,180,1249,1069
3151,1,0,11,0,-11
3152,1,0,56,0,-56
3153,1,0,9,0,-9
3154,0,0,21,0,-21
3155,0,0,5,0,-5
3156,1,1,435,1400,965
3157,1,0,6,0,-6
3158,1,0,1,0,-1
3159,1,0,53,0,-53
3160,1,1,227,1393,1166
3161,1,0,68,0,-68
3162,0,0,10,0,-10
3163,0,0,1,0,-1
3164,1,0,0,0,0
3165,1,0,8,0,-8
3166,0,0,69,0,-69
3167,0,0,82,0,-82
3168,0,0,25,0,-25
3169,1,1,222,1785,1563
3170,0,0,86,0,-86
3171,1,1,442,1320,878
3172,1,0,18,0,-18
3173,1,0,104,0,-104
3174,1,1,108,3251,3143
3175,1,0,21,0,-21
3176,1,1,171,1948,1777
3177,1,1,365,1230,865
3178,0,0,109,0,-109
3179,1,1,1026,1279,253
3180,0,0,45,0,-45
3181,0,0,107,0,-107
3182,1,1,378,1352,974
3183,1,1,90,1385,1295
3184,0,0,8,0,-8
3185,1,0,3,0,-3
3186,0,0,99,0,-99
3187,1,1,364,1265,901
3188,1,1,638,1209,571
3189,0,0,50,0,-50
3190,0,0,196,0,-196
3191,1,0,26,0,-26
3192,0,0,59,0,-59
3193,0,0,12,0,-12
3194,0,0,27,0,-27
3195,1,0,10,0,-10
3196,1,1,626,2159,1533
3197,1,1,317,1539,1222
3198,0,0,62,0,-62
3199,0,0,28,0,-28
3200,1,1,402,1406,1004
3201,1,0,8,0,-8
3202,0,0,4,0,-4
3203,0,0,48,0,-48
3204,1,1,816,2537,1721
3205,1,0,52,0,-52
3206,1,0,0,0,0
3207,1,1,1502,2146,644
3208,1,0,15,0,-15
3209,1,1,741,1397,656
3210,0,0,0,0,0
3211,1,1,129,1444,1315
3212,1,0,70,0,-70
3213,1,1,199,1327,1128
3214,0,0,183,0,-183
3215,1,1,240,1268,1028
3216,0,0,35,0,-35
3217,1,0,32,0,-32
3218,1,1,195,1360,1165
3219,1,0,47,0,-47
3220,1,0,13,0,-13
3221,0,0,14,0,-14
3222,0,0,36,0,-36
3223,0,0,16,0,-16
3224,0,0,13,0,-13
3225,1,0,156,0,-156
3226,1,1,359,1507,1148
3227,0,0,69,0,-69
3228,1,0,41,0,-41
3229,1,0,19,0,-19
3230,1,1,1442,1541,99
3231,1,1,234,1593,1359
3232,1,1,1987,1205,-782
3233,1,0,85,0,-85
3234,0,0,24,0,-24
3235,1,1,602,1371,769
3236,1,0,47,0,-47
3237,1,1,426,1489,1063
3238,1,1,1148,1427,279
3239,0,0,26,0,-26
3240,1,1,426,1245,819
3241,1,0,2,0,-2
3242,1,0,3,0,-3
3243,1,1,278,1266,988
3244,1,1,219,1473,1254
3245,1,1,303,1596,1293
3246,1,1,343,1355,1012
3247,1,0,9,0,-9
3248,1,0,122,0,-122
3249,1,1,491,1205,714
3250,1,1,379,1581,1202
3251,1,0,20,0,-20
3252,1,0,80,0,-80
3253,1,0,9,0,-9
3254,0,0,55,0,-55
3255,0,0,73,0,-73
3256,1,0,43,0,-43
3257,1,0,46,0,-46
3258,1,0,39,0,-39
3259,0,0,0,0,0
3260,1,0,6,0,-6
3261,1,0,2,0,-2
3262,0,0,78,0,-78
3263,0,0,14,0,-14
3264,1,0,47,0,-47
3265,0,0,3,0,-3
3266,1,0,13,0,-13
3267,0,0,47,0,-47
3268,1,0,158,0,-158
3269,0,0,16,0,-16
3270,1,1,505,1488,983
3271,0,0,26,0,-26
3272,1,1,704,1218,514
3273,0,0,52,0,-52
3274,0,0,1,0,-1
3275,0,0,41,0,-41
3276,1,1,336,1265,929
3277,0,0,189,0,-189
3278,1,1,955,1371,416
3279,1,0,29,0,-29
3280,1,1,486,2319,1833
3281,0,0,6,0,-6
3282,0,0,75,0,-75
3283,1,1,123,1619,1496
3284,1,1,600,1217,617
3285,1,0,25,0,-25
3286,1,0,88,0,-88
3287,0,0,76,0,-76
3288,1,1,121,1227,1106
3289,1,0,202,0,-202
3290,1,1,554,1221,667
3291,1,0,42,0,-42
3292,1,0,40,0,-40
3293,1,1,979,4172,3193
3294,1,1,292,1729,1437
3295,1,0,121,0,-121
3296,0,0,67,0,-67
3297,1,1,550,1238,688
3298,1,0,0,0,0
3299,1,0,24,0,-24
3300,0,0,24,0,-24
3301,1,0,25,0,-25
3302,1,1,329,1315,986
3303,1,0,50,0,-50
3304,0,0,33,0,-33
3305,1,1,395,1633,1238
3306,0,0,10,0,-10
3307,1,0,48,0,-48
3308,1,1,193,1293,1100
3309,0,0,36,0,-36
3310,0,0,0,0,0
3311,0,0,8,0,-8
3312,0,0,162,0,-162
3313,1,0,137,0,-137
3314,1,0,5,0,-5
3315,0,0,28,0,-28
3316,1,1,32,1437,1405
3317,1,0,20,0,-20
3318,1,1,190,1645,1455
3319,1,1,770,1217,447
3320,0,0,1,0,-1
3321,0,0,11,0,-11
3322,1,1,71,1211,1140
3323,1,1,81,1282,1201
3324,1,1,288,1670,1382
3325,1,1,558,1504,946
3326,0,0,23,0,-23
3327,1,0,86,0,-86
3328,0,0,28,0,-28
3329,1,0,20,0,-20
3330,0,0,93,0,-93
3331,1,1,447,1713,1266
3332,1,0,221,0,-221
3333,0,0,44,0,-44
3334,1,1,1094,1751,657
3335,1,0,61,0,-61
3336,1,0,51,0,-51
3337,1,1,339,1602,1263
3338,0,0,12,0,-12
3339,1,1,138,1275,1137
3340,0,0,14,0,-14
3341,1,0,26,0,-26
3342,1,1,632,1644,1012
3343,0,0,83,0,-83
3344,1,0,33,0,-33
3345,1,1,251,1394,1143
3346,0,0,20,0,-20
3347,1,1,268,1290,1022
3348,0,0,20,0,-20
3349,1,0,15,0,-15
3350,1,1,1362,1659,297
3351,0,0,132,0,-132
3352,1,1,880,1731,851
3353,1,1,310,1719,1409
3354,1,0,38,0,-38
3355,1,0,97,0,-97
3356,1,1,2385,1798,-587
3357,1,0,55,0,-55
3358,1,0,79,0,-79
3359,1,1,41,1207,1166
3360,0,0,28,0,-28
3361,1,1,59,1206,1147
3362,0,0,31,0,-31
3363,1,0,29,0,-29
3364,0,0,45,0,-45
3365,1,0,160,0,-160
3366,1,1,128,1690,1562
3367,0,0,32,0,-32
3368,1,0,96,0,-96
3369,1,0,15,0,-15
3370,0,0,138,0,-138
3371,0,0,19,0,-19
3372,0,0,62,0,-62
3373,0,0,9,0,-9
3374,0,0,47,0,-47
3375,1,0,74,0,-74
3376,1,1,775,1891,1116
3377,1,0,14,0,-14
3378,0,0,33,0,-33
3379,1,0,15,0,-15
3380,1,0,9,0,-9
3381,1,0,6,0,-6
3382,1,0,30,0,-30
3383,1,0,54,0,-54
3384,0,0,48,0,-48
3385,0,0,12,0,-12
3386,1,1,234,3294,3060
3387,1,0,15,0,-15
3388,1,0,0,0,0
3389,1,0,61,0,-61
3390,1,0,47,0,-47
3391,1,0,13,0,-13
3392,1,0,50,0,-50
3393,1,0,5,0,-5
3394,1,0,77,0,-77
3395,1,1,53,1329,1276
3396,1,1,968,1577,609
3397,1,0,50,0,-50
3398,1,0,30,0,-30
3399,1,1,169,1225,1056
3400,1,1,406,1980,1574
3401,0,0,40,0,-40
3402,1,0,26,0,-26
3403,0,0,5,0,-5
3404,0,0,52,0,-52
3405,0,0,12,0,-12
3406,1,0,0,0,0
3407,0,0,5,0,-5
3408,1,1,47,1594,1547
3409,1,0,35,0,-35
3410,0,0,32,0,-32
3411,0,0,14,0,-14
3412,1,1,505,1565,1060
3413,1,1,265,1212,947
3414,0,0,6,0,-6
3415,0,0,17,0,-17
3416,1,0,16,0,-16
3417,1,1,588,1240,652
3418,0,0,29,0,-29
3419,1,1,581,1475,894
3420,1,1,1246,1707,461
3421,0,0,20,0,-20
3422,1,0,56,0,-56
3423,1,0,42,0,-42
3424,1,0,26,0,-26
3425,1,0,32,0,-32
3426,1,1,284,1248,964
3427,1,1,454,1336,882
3428,1,1,843,1411,568
3429,1,0,159,0,-159
3430,1,1,102,2637,2535
3431,1,1,667,1224,557
3432,0,0,10,0,-10
3433,1,1,905,1518,613
3434,0,0,20,0,-20
3435,1,1,54,1343,1289
3436,1,1,1054,1667,613
3437,1,1,135,1283,1148
3438,0,0,31,0,-31
3439,1,1,836,1343,507
3440,1,0,56,0,-56
3441,0,0,29,0,-29
3442,1,1,93,1460,1367
3443,1,1,579,1470,891
3444,0,0,23,0,-23
3445,1,1,648,1639,991
3446,1,0,36,0,-36
3447,1,1,222,1692,1470
3448,1,1,1169,1303,134
3449,1,0,5,0,-5
3450,1,1,229,1645,1416
3451,0,0,103,0,-103
3452,1,1,371,1219,848
3453,1,0,23,0,-23
3454,0,0,16,0,-16
3455,1,0,9,0,-9
3456,1,0,132,0,-132
3457,0,0,7,0,-7
3458,1,0,53,0,-53
3459,0,0,68,0,-68
3460,0,0,53,0,-53
3461,1,1,440,1258,818
3462,1,0,73,0,-73
3463,0,0,63,0,-63
3464,1,0,35,0,-35
3465,0,0,4,0,-4
3466,1,1,173,2147,1974
3467,1,0,39,0,-39
3468,0,0,10,0,-10
3469,1,1,143,1226,1083
3470,1,1,121,3405,3284
3471,0,0,50,0,-50
3472,1,0,7,0,-7
3473,1,1,620,1406,786
3474,0,0,29,0,-29
3475,1,1,12,1206,1194
3476,1,1,87,1568,1481
3477,1,0,1,0,-1
3478,0,0,26,0,-26
3479,1,1,83,1415,1332
3480,0,0,55,0,-55
3481,0,0,38,0,-38
3482,1,1,1561,1620,59
3483,1,0,140,0,-140
3484,1,1,551,1612,1061
3485,0,0,19,0,-19
3486,0,0,112,0,-112
3487,1,1,549,1219,670
3488,0,0,110,0,-110
3489,0,0,41,0,-41
3490,1,1,437,1247,810
3491,0,0,77,0,-77
3492,1,1,349,1914,1565
3493,1,0,149,0,-149
3494,1,0,14,0,-14
3495,0,0,35,0,-35
3496,1,1,48,1677,1629
3497,1,1,421,1686,1265
3498,1,1,1318,1361,43
3499,0,0,1,0,-1
3500,1,1,268,2428,2160
3501,1,1,364,2214,1850
3502,1,0,76,0,-76
3503,1,0,18,0,-18
3504,1,0,0,0,0
3505,0,0,34,0,-34
3506,0,0,204,0,-204
3507,0,0,41,0,-41
3508,1,0,33,0,-33
3509,1,1,2441,1296,-1145
3510,0,0,93,0,-93
3511,0,0,20,0,-20
3512,1,0,54,0,-54
3513,0,0,3,0,-3
3514,1,1,89,2033,1944
3515,1,1,392,1943,1551
3516,0,0,23,0,-23
3517,1,1,274,1457,1183
3518,1,1,75,2329,2254
3519,0,0,39,0,-39
3520,1,1,331,1526,1195
3521,0,0,7,0,-7
3522,1,0,24,0,-24
3523,0,0,46,0,-46
3524,1,0,155,0,-155
3525,1,0,58,0,-58
3526,0,0,2,0,-2
3527,0,0,1,0,-1
3528,0,0,86,0,-86
3529,0,0,11,0,-11
3530,1,1,66,1416,1350
3531,0,0,37,0,-37
3532,0,0,186,0,-186
3533,0,0,5,0,-5
3534,1,0,119,0,-119
3535,0,0,34,0,-34
3536,0,0,21,0,-21
3537,1,1,2006,1437,-569
3538,0,0,1,0,-1
3539,0,0,20,0,-20
3540,0,0,20,0,-20
3541,0,0,39,0,-39
3542,1,1,950,1580,630
3543,1,1,520,1731,1211
3544,0,0,70,0,-70
3545,1,1,385,1923,1538
3546,1,0,45,0,-45
3547,1,0,1,0,-1
3548,0,0,28,0,-28
3549,1,1,375,2800,2425
3550,1,0,64,0,-64
3551,0,0,8,0,-8
3552,1,0,26,0,-26
3553,1,0,29,0,-29
3554,0,0,63,0,-63
3555,0,0,90,0,-90
3556,1,1,436,1282,846
3557,0,0,47,0,-47
3558,1,0,55,0,-55
3559,1,0,4,0,-4
3560,0,0,79,0,-79
3561,1,1,400,1214,814
3562,0,0,18,0,-18
3563,1,0,95,0,-95
3564,0,0,107,0,-107
3565,1,1,189,1257,1068
3566,0,0,33,0,-33
3567,0,0,3,0,-3
3568,0,0,40,0,-40
3569,1,0,19,0,-19
3570,1,1,549,1602,1053
3571,0,0,0,0,0
3572,0,0,22,0,-22
3573,1,0,55,0,-55
3574,1,1,2359,1203,-1156
3575,0,0,80,0,-80
3576,1,1,915,1343,428
3577,1,1,6,1668,1662
3578,1,0,5,0,-5
3579,1,0,59,0,-59
3580,1,1,87,1238,1151
3581,1,1,189,2510,2321
3582,1,0,112,0,-112
3583,1,1,546,1509,963
3584,0,0,78,0,-78
3585,0,0,2,0,-2
3586,1,1,61,1706,1645
3587,1,0,8,0,-8
3588,0,0,114,0,-114
3589,1,0,16,0,-16
3590,0,0,6,0,-6
3591,1,1,3393,1210,-2183
3592,0,0,32,0,-32
3593,1,0,3,0,-3
3594,1,0,24,0,-24
3595,1,1,120,1314,1194
3596,1,0,21,0,-21
3597,0,0,19,0,-19
3598,0,0,31,0,-31
3599,1,1,1146,1326,180
3600,1,1,559,1275,716
3601,1,0,25,0,-25
3602,1,1,740,1537,797
3603,1,1,508,1249,741
3604,1,1,297,1834,1537
3605,0,0,48,0,-48
3606,1,1,538,1274,736
3607,1,1,1077,1383,306
3608,0,0,40,0,-40
3609,1,0,3,0,-3
3610,1,1,409,1545,1136
3611,1,0,52,0,-52
3612,0,0,178,0,-178
3613,0,0,229,0,-229
3614,0,0,38,0,-38
3615,1,1,622,1485,863
3616,1,1,503,1280,777
3617,1,1,443,1243,800
3618,1,0,54,0,-54
3619,0,0,4,0,-4
3620,1,1,710,1471,761
3621,0,0,14,0,-14
3622,0,0,23,0,-23
3623,1,1,390,1665,1275
3624,1,0,23,0,-23
3625,1,1,532,1328,796
3626,0,0,89,0,-89
3627,0,0,13,0,-13
3628,1,1,412,2296,1884
3629,1,0,40,0,-40
3630,1,1,509,1494,985
3631,0,0,13,0,-13
3632,0,0,58,0,-58
3633,1,0,59,0,-59
3634,0,0,18,0,-18
3635,1,1,1144,1256,112
3636,1,0,73,0,-73
3637,0,0,51,0,-51
3638,1,0,16,0,-16
3639,1,1,780,1347,567
3640,1,1,173,2519,2346
3641,0,0,3,0,-3
3642,0,0,33,0,-33
3643,0,0,5,0,-5
3644,1,0,5,0,-5
3645,0,0,42,0,-42
3646,0,0,60,0,-60
3647,1,0,84,0,-84
3648,1,1,890,1261,371
3649,0,0,36,0,-36
3650,0,0,172,0,-172
3651,1,1,305,2218,1913
3652,1,1,379,2212,1833
3653,1,1,1023,2285,1262
3654,1,0,39,0,-39
3655,1,1,1636,1233,-403
3656,0,0,59,0,-59
3657,0,0,227,0,-227
3658,1,1,304,1346,1042
3659,1,0,21,0,-21
3660,1,0,39,0,-39
3661,0,0,11,0,-11
3662,0,0,37,0,-37
3663,0,0,82,0,-82
3664,1,1,224,1235,1011
3665,1,0,117,0,-117
3666,0,0,197,0,-197
3667,0,0,60,0,-60
3668,0,0,23,0,-23
3669,1,1,534,1405,871
3670,1,0,19,0,-19
3671,1,1,751,1233,482
3672,0,0,72,0,-72
3673,1,1,400,1492,1092
3674,1,0,258,0,-258
3675,1,0,62,0,-62
3676,1,0,14,0,-14
3677,0,0,61,0,-61
3678,0,0,28,0,-28
3679,1,0,72,0,-72
3680,1,0,56,0,-56
3681,1,1,630,1927,1297
3682,1,0,33,0,-33
3683,1,1,3515,1518,-1997
3684,1,0,20,0,-20
3685,0,0,30,0,-30
3686,1,1,459,1721,1262
3687,1,0,43,0,-43
3688,0,0,3,0,-3
3689,1,1,241,2107,1866
3690,0,0,48,0,-48
3691,0,0,48,0,-48
3692,1,0,20,0,-20
3693,1,1,182,1933,1751
3694,1,0,11,0,-11
3695,1,0,25,0,-25
3696,0,0,114,0,-114
3697,1,0,25,0,-25
3698,0,0,49,0,-49
3699,0,0,24,0,-24
3700,1,1,284,2500,2216
3701,0,0,21,0,-21
3702,1,0,20,0,-20
3703,0,0,132,0,-132
3704,0,0,29,0,-29
3705,0,0,184,0,-184
3706,0,0,99,0,-99
3707,1,0,130,0,-130
3708,1,1,1087,1227,140
3709,0,0,12,0,-12
3710,1,1,2197,1288,-909
3711,0,0,21,0,-21
3712,0,0,114,0,-114
3713,0,0,32,0,-32
3714,0,0,32,0,-32
3715,0,0,34,0,-34
3716,1,0,27,0,-27
3717,0,0,10,0,-10
3718,1,0,21,0,-21
3719,1,0,26,0,-26
3720,0,0,55,0,-55
3721,1,0,1,0,-1
3722,0,0,17,0,-17
3723,0,0,28,0,-28
3724,1,1,106,1383,1277
3725,1,1,47,1622,1575
3726,1,1,127,1587,1460
3727,0,0,9,0,-9
3728,0,0,60,0,-60
3729,0,0,113,0,-113
3730,0,0,26,0,-26
3731,0,0,105,0,-105
3732,1,0,130,0,-130
3733,1,1,894,1225,331
3734,0,0,42,0,-42
3735,1,1,292,1463,1171
3736,0,0,111,0,-111
3737,1,0,512,0,-512
3738,0,0,57,0,-57
3739,1,1,1141,1528,387
3740,1,1,681,1536,855
3741,1,0,45,0,-45
3742,0,0,40,0,-40
3743,0,0,60,0,-60
3744,1,1,956,1352,396
3745,1,0,57,0,-57
3746,0,0,2,0,-2
3747,0,0,3,0,-3
3748,1,0,65,0,-65
3749,1,0,44,0,-44
3750,0,0,35,0,-35
3751,1,1,217,1398,1181
3752,1,1,328,1242,914
3753,0,0,0,0,0
3754,0,0,25,0,-25
3755,1,1,190,1622,1432
3756,0,0,102,0,-102
3757,0,0,110,0,-110
3758,0,0,63,0,-63
3759,1,0,70,0,-70
3760,1,0,15,0,-15
3761,1,1,34,1956,1922
3762,0,0,44,0,-44
3763,1,0,30,0,-30
3764,1,1,623,2184,1561
3765,1,1,389,1822,1433
3766,0,0,43,0,-43
3767,1,0,64,0,-64
3768,1,1,704,5603,4899
3769,1,0,45,0,-45
3770,1,0,13,0,-13
3771,1,0,46,0,-46
3772,1,0,161,0,-161
3773,1,0,54,0,-54
3774,1,1,1075,1422,347
3775,1,0,40,0,-40
3776,1,0,106,0,-106
3777,1,0,86,0,-86
3778,1,0,3,0,-3
3779,1,1,917,1412,495
3780,1,1,456,1363,907
3781,0,0,52,0,-52
3782,1,0,17,0,-17
3783,1,1,225,1704,1479
3784,1,1,1008,1507,499
3785,1,1,389,1876,1487
3786,0,0,6,0,-6
3787,1,1,425,1512,1087
3788,1,1,292,1692,1400
3789,0,0,26,0,-26
3790,1,1,446,1363,917
3791,1,0,193,0,-193
3792,1,0,11,0,-11
3793,1,0,10,0,-10
3794,1,1,75,1229,1154
3795,0,0,116,0,-116
3796,1,1,585,1219,634
3797,0,0,18,0,-18
3798,1,0,12,0,-12
3799,1,0,73,0,-73
3800,1,1,97,1668,1571
3801,1,0,115,0,-115
3802,0,0,11,0,-11
3803,1,0,32,0,-32
3804,1,1,250,1221,971
3805,0,0,1,0,-1
3806,1,1,113,1733,1620
3807,1,1,2095,1518,-577
3808,1,1,366,1242,876
3809,1,0,54,0,-54
3810,1,1,248,1361,1113
3811,1,1,228,1253,1025
3812,1,0,150,0,-150
3813,1,1,863,1836,973
3814,0,0,20,0,-20
3815,1,0,70,0,-70
3816,1,1,839,1258,419
3817,1,0,36,0,-36
3818,1,0,41,0,-41
3819,1,1,893,1770,877
3820,1,1,300,1264,964
3821,1,1,117,2125,2008
3822,1,1,2061,1996,-65
3823,1,1,109,1689,1580
3824,0,0,63,0,-63
3825,0,0,95,0,-95
3826,1,0,40,0,-40
3827,0,0,43,0,-43
3828,0,0,45,0,-45
3829,0,0,22,0,-22
3830,1,0,4,0,-4
3831,0,0,49,0,-49
3832,0,0,39,0,-39
3833,1,0,38,0,-38
3834,1,0,4,0,-4
3835,0,0,59,0,-59
3836,1,1,532,2680,2148
3837,1,1,474,1210,736
3838,1,0,52,0,-52
3839,1,0,107,0,-107
3840,1,0,7,0,-7
3841,0,0,103,0,-103
3842,0,0,3,0,-3
3843,0,0,80,0,-80
3844,1,1,128,1239,1111
3845,1,0,15,0,-15
3846,1,0,73,0,-73
3847,1,0,51,0,-51
3848,0,0,53,0,-53
3849,0,0,42,0,-42
3850,1,0,70,0,-70
3851,1,0,0,0,0
3852,0,0,26,0,-26
3853,1,0,96,0,-96
3854,1,0,39,0,-39
3855,0,0,27,0,-27
3856,1,1,113,1271,1158
3857,0,0,62,0,-62
3858,1,1,1441,1443,2
3859,1,0,40,0,-40
3860,0,0,36,0,-36
3861,1,0,134,0,-134
3862,0,0,62,0,-62
3863,0,0,33,0,-33
3864,1,1,319,1488,1169
3865,1,0,11,0,-11
3866,0,0,142,0,-142
3867,0,0,5,0,-5
3868,0,0,11,0,-11
3869,1,1,892,1376,484
3870,1,1,1257,1751,494
3871,1,1,385,1377,992
3872,1,0,36,0,-36
3873,0,0,61,0,-61
3874,0,0,22,0,-22
3875,1,1,736,1727,991
3876,0,0,27,0,-27
3877,0,0,21,0,-21
3878,1,0,240,0,-240
3879,0,0,2,0,-2
3880,1,1,302,1839,1537
3881,0,0,54,0,-54
3882,0,0,81,0,-81
3883,0,0,55,0,-55
3884,0,0,53,0,-53
3885,1,0,56,0,-56
3886,0,0,56,0,-56
3887,1,0,32,0,-32
3888,0,0,9,0,-9
3889,0,0,40,0,-40
3890,0,0,11,0,-11
3891,1,0,29,0,-29
3892,0,0,14,0,-14
3893,1,0,40,0,-40
3894,0,0,7,0,-7
3895,0,0,52,0,-52
3896,1,1,500,1220,720
3897,0,0,60,0,-60
3898,0,0,27,0,-27
3899,1,1,2052,1825,-227
3900,0,0,90,0,-90
3901,1,1,214,1207,993
3902,1,0,94,0,-94
3903,1,0,75,0,-75
3904,0,0,52,0,-52
3905,1,1,1326,1568,242
3906,1,1,142,1441,1299
3907,1,1,273,1665,1392
3908,0,0,72,0,-72
3909,0,0,112,0,-112
3910,1,0,8,0,-8
3911,1,0,14,0,-14
3912,1,1,371,1207,836
3913,1,0,21,0,-21
3914,0,0,50,0,-50
3915,1,1,1923,1212,-711
3916,1,0,20,0,-20
3917,1,0,11,0,-11
3918,1,1,186,1274,1088
3919,1,1,162,1253,1091
3920,0,0,1,0,-1
3921,1,1,190,1216,1026
3922,1,1,807,1355,548
3923,1,1,496,1325,829
3924,0,0,17,0,-17
3925,1,1,139,1238,1099
3926,0,0,77,0,-77
3927,1,1,2258,1320,-938
3928,0,0,18,0,-18
3929,0,0,18,0,-18
3930,0,0,6,0,-6
3931,1,1,1709,1225,-484
3932,0,0,4,0,-4
3933,0,0,95,0,-95
3934,1,1,1049,1360,311
3935,1,0,6,0,-6
3936,0,0,34,0,-34
3937,0,0,11,0,-11
3938,0,0,3,0,-3
3939,1,0,6,0,-6
3940,1,0,15,0,-15
3941,1,0,51,0,-51
3942,1,1,1076,2351,1275
3943,1,0,169,0,-169
3944,1,0,134,0,-134
3945,0,0,6,0,-6
3946,0,0,55,0,-55
3947,1,0,48,0,-48
3948,1,0,59,0,-59
3949,0,0,29,0,-29
3950,0,0,89,0,-89
3951,1,1,206,1824,1618
3952,0,0,8,0,-8
3953,1,0,33,0,-33
3954,1,0,54,0,-54
3955,0,0,16,0,-16
3956,1,1,337,1241,904
3957,0,0,29,0,-29
3958,1,1,541,1862,1321
3959,1,0,6,0,-6
3960,1,0,28,0,-28
3961,0,0,12,0,-12
3962,0,0,45,0,-45
3963,1,0,6,0,-6
3964,0,0,10,0,-10
3965,1,0,17,0,-17
3966,1,0,11,0,-11
3967,1,1,1380,1445,65
3968,1,1,436,1546,1110
3969,0,0,45,0,-45
3970,0,0,38,0,-38
3971,0,0,12,0,-12
3972,0,0,8,0,-8
3973,1,1,512,1202,690
3974,1,0,10,0,-10
3975,0,0,40,0,-40
3976,1,0,247,0,-247
3977,0,0,22,0,-22
3978,0,0,156,0,-156
3979,0,0,33,0,-33
3980,1,1,124,2322,2198
3981,0,0,99,0,-99
3982,0,0,92,0,-92
3983,1,1,1595,1306,-289
3984,0,0,2,0,-2
3985,0,0,65,0,-65
3986,1,1,268,1757,1489
3987,1,1,129,1721,1592
3988,0,0,38,0,-38
3989,1,0,232,0,-232
3990,0,0,38,0,-38
3991,1,1,329,1729,1400
3992,1,1,234,2913,2679
3993,1,0,44,0,-44
3994,0,0,40,0,-40
3995,1,1,476,1702,1226
3996,0,0,76,0,-76
3997,1,0,22,0,-22
3998,0,0,59,0,-59
3999,0,0,120,0,-120
4000,1,1,1856,3312,1456
4001,0,0,113,0,-113
4002,1,0,101,0,-101
4003,0,0,83,0,-83
4004,1,0,72,0,-72
4005,0,0,99,0,-99
4006,1,0,44,0,-44
4007,1,1,206,1866,1660
4008,1,0,42,0,-42
4009,1,0,8,0,-8
4010,0,0,111,0,-111
4011,1,0,109,0,-109
4012,1,1,724,1257,533
4013,1,0,13,0,-13
4014,1,1,28,1727,1699
4015,0,0,42,0,-42
4016,1,0,140,0,-140
4017,0,0,113,0,-113
4018,1,1,1241,1245,4
4019,1,1,417,1270,853
4020,1,0,1,0,-1
4021,0,0,0,0,0
4022,1,1,130,1979,1849
4023,0,0,11,0,-11
4024,0,0,124,0,-124
4025,1,0,18,0,-18
4026,0,0,26,0,-26
4027,1,1,906,1947,1041
4028,1,1,1046,1303,257
4029,0,0,1,0,-1
4030,1,0,3,0,-3
4031,1,0,24,0,-24
4032,1,0,7,0,-7
4033,1,1,287,1244,957
4034,0,0,69,0,-69
4035,0,0,1,0,-1
4036,1,0,13,0,-13
4037,0,0,24,0,-24
4038,1,0,32,0,-32
4039,1,1,186,1204,1018
4040,0,0,35,0,-35
4041,0,0,40,0,-40
4042,0,0,56,0,-56
4043,1,1,830,2218,1388
4044,1,1,1502,1622,120
4045,0,0,4,0,-4
4046,0,0,23,0,-23
4047,1,1,240,1531,1291
4048,0,0,93,0,-93
4049,0,0,36,0,-36
4050,0,0,37,0,-37
4051,1,0,10,0,-10
4052,0,0,52,0,-52
4053,1,1,81,1372,1291
4054,1,1,350,1707,1357
4055,0,0,22,0,-22
4056,0,0,76,0,-76
4057,1,1,1206,1413,207
4058,0,0,8,0,-8
4059,1,1,217,1473,1256
4060,1,0,35,0,-35
4061,0,0,72,0,-72
4062,0,0,133,0,-133
4063,0,0,55,0,-55
4064,1,0,86,0,-86
4065,1,1,2346,1256,-1090
4066,1,0,0,0,0
4067,0,0,9,0,-9
4068,1,1,133,2549,2416
4069,0,0,117,0,-117
4070,1,1,255,1302,1047
4071,1,1,1347,1277,-70
4072,0,0,51,0,-51
4073,1,1,313,1492,1179
4074,1,0,5,0,-5
4075,1,1,84,1466,1382
4076,0,0,79,0,-79
4077,0,0,15,0,-15
4078,1,1,402,2335,1933
4079,1,1,1040,1455,415
4080,0,0,89,0,-89
4081,0,0,29,0,-29
4082,1,1,70,1237,1167
4083,1,1,219,2225,2006
4084,1,0,1,0,-1
4085,1,0,3,0,-3
4086,1,0,27,0,-27
4087,1,0,40,0,-40
4088,0,0,28,0,-28
4089,0,0,90,0,-90
4090,0,0,58,0,-58
4091,0,0,62,0,-62
4092,1,1,440,1469,1029
4093,1,1,574,1451,877
4094,1,0,13,0,-13
4095,1,1,1053,1250,197
4096,1,1,23,1520,1497
4097,1,1,48,1200,1152
4098,1,1,242,1656,1414
4099,0,0,119,0,-119
4100,0,0,40,0,-40
4101,1,1,290,1207,917
4102,0,0,95,0,-95
4103,1,0,47,0,-47
4104,1,1,413,2121,1708
4105,1,0,10,0,-10
4106,0,0,12,0,-12
4107,1,1,77,1589,1512
4108,1,0,0,0,0
4109,0,0,33,0,-33
4110,1,1,803,2077,1274
4111,0,0,0,0,0
4112,0,0,75,0,-75
4113,0,0,87,0,-87
4114,0,0,66,0,-66
4115,0,0,3,0,-3
4116,1,0,14,0,-14
4117,1,1,428,1942,1514
4118,1,1,674,1255,581
4119,1,0,79,0,-79
4120,1,0,34,0,-34
4121,1,1,1749,1563,-186
4122,0,0,27,0,-27
4123,1,0,0,0,0
4124,1,1,531,1210,679
4125,1,1,514,1977,1463
4126,1,1,185,3202,3017
4127,1,1,58,1870,1812
4128,0,0,19,0,-19
4129,0,0,77,0,-77
4130,1,1,101,2240,2139
4131,1,0,33,0,-33
4132,1,0,20,0,-20
4133,0,0,21,0,-21
4134,1,1,688,1498,810
4135,1,1,193,1590,1397
4136,1,1,226,1251,1025
4137,1,0,48,0,-48
4138,1,1,432,1292,860
4139,0,0,1,0,-1
4140,1,1,776,1510,734
4141,1,1,730,1369,639
4142,0,0,32,0,-32
4143,0,0,20,0,-20
4144,1,1,385,1381,996
4145,1,0,24,0,-24
4146,1,1,238,1656,1418
4147,0,0,188,0,-188
4148,0,0,11,0,-11
4149,1,0,79,0,-79
4150,0,0,139,0,-139
4151,1,0,21,0,-21
4152,1,1,68,1245,1177
4153,0,0,14,0,-14
4154,1,0,18,0,-18
4155,1,0,4,0,-4
4156,1,1,78,1233,1155
4157,1,0,114,0,-114
4158,0,0,20,0,-20
4159,1,1,124,1296,1172
4160,0,0,30,0,-30
4161,1,0,2,0,-2
4162,0,0,66,0,-66
4163,1,0,35,0,-35
4164,0,0,12,0,-12
4165,1,0,17,0,-17
4166,0,0,157,0,-157
4167,0,0,62,0,-62
4168,1,0,1,0,-1
4169,1,1,316,1443,1127
4170,1,1,650,2694,2044
4171,0,0,4,0,-4
4172,0,0,4,0,-4
4173,1,1,62,2042,1980
4174,1,0,43,0,-43
4175,0,0,109,0,-109
4176,1,1,304,1410,1106
4177,1,1,765,2196,1431
4178,0,0,43,0,-43
4179,0,0,140,0,-140
4180,1,1,44,2058,2014
4181,1,0,175,0,-175
4182,1,1,1721,1218,-503
4183,1,0,11,0,-11
4184,0,0,218,0,-218
4185,0,0,43,0,-43
4186,1,0,27,0,-27
4187,1,0,14,0,-14
4188,0,0,30,0,-30
4189,1,1,175,1572,1397
4190,1,1,249,1230,981
4191,1,1,233,1743,1510
4192,0,0,8,0,-8
4193,1,0,5,0,-5
4194,0,0,66,0,-66
4195,0,0,16,0,-16
4196,0,0,4,0,-4
4197,1,1,1100,1205,105
4198,1,0,89,0,-89
4199,1,1,650,1210,560
4200,0,0,0,0,0
4201,0,0,17,0,-17
4202,1,1,712,1238,526
4203,1,0,44,0,-44
4204,0,0,11,0,-11
4205,1,1,144,1222,1078
4206,0,0,59,0,-59
4207,1,1,384,1380,996
4208,0,0,99,0,-99
4209,1,1,1408,1306,-102
4210,1,0,32,0,-32
4211,1,0,24,0,-24
4212,1,0,32,0,-32
4213,0,0,6,0,-6
4214,1,0,3,0,-3
4215,0,0,59,0,-59
4216,1,1,143,1890,1747
4217,1,1,2510,1319,-1191
4218,0,0,81,0,-81
4219,1,1,417,1216,799
4220,1,0,36,0,-36
4221,1,1,1949,2930,981
4222,0,0,4,0,-4
4223,1,0,2,0,-2
4224,0,0,16,0,-16
4225,1,1,644,3668,3024
4226,0,0,4,0,-4
4227,1,0,44,0,-44
4228,0,0,3,0,-3
4229,0,0,36,0,-36
4230,1,0,67,0,-67
4231,0,0,28,0,-28
4232,0,0,19,0,-19
4233,0,0,56,0,-56
4234,1,0,21,0,-21
4235,1,1,461,1624,1163
4236,0,0,15,0,-15
4237,1,1,339,1353,1014
4238,1,0,218,0,-218
4239,0,0,62,0,-62
4240,0,0,124,0,-124
4241,1,1,57,1555,1498
4242,1,0,115,0,-115
4243,1,1,240,1935,1695
4244,0,0,3,0,-3
4245,1,0,3,0,-3
4246,1,0,2,0,-2
4247,1,0,93,0,-93
4248,0,0,374,0,-374
4249,0,0,34,0,-34
4250,0,0,1,0,-1
4251,1,0,2,0,-2
4252,0,0,0,0,0
4253,1,1,193,1837,1644
4254,0,0,74,0,-74
4255,0,0,18,0,-18
4256,1,0,63,0,-63
4257,1,0,7,0,-7
4258,0,0,14,0,-14
4259,1,1,1278,1548,270
4260,0,0,67,0,-67
4261,1,1,414,2036,1622
4262,0,0,7,0,-7
4263,0,0,117,0,-117
4264,0,0,129,0,-129
4265,1,0,19,0,-19
4266,0,0,120,0,-120
4267,1,0,65,0,-65
4268,1,1,912,1470,558
4269,1,1,1691,1439,-252
4270,1,1,155,1212,1057
4271,1,0,2,0,-2
4272,1,0,7,0,-7
4273,1,1,116,1674,1558
4274,1,0,213,0,-213
4275,0,0,48,0,-48
4276,0,0,72,0,-72
4277,1,1,224,1482,1258
4278,0,0,73,0,-73
4279,1,1,53,1902,1849
4280,1,1,826,1290,464
4281,1,0,17,0,-17
4282,1,1,641,1534,893
4283,1,0,54,0,-54
4284,0,0,72,0,-72
4285,0,0,28,0,-28
4286,0,0,94,0,-94
4287,1,1,1781,1558,-223
4288,0,0,4,0,-4
4289,0,0,26,0,-26
4290,0,0,79,0,-79
4291,1,0,4,0,-4
4292,0,0,63,0,-63
4293,1,0,131,0,-131
4294,0,0,39,0,-39
4295,1,1,497,1709,1212
4296,0,0,22,0,-22
4297,0,0,1,0,-1
4298,1,1,193,1485,1292
4299,1,1,51,1334,1283
4300,1,1,257,1824,1567
4301,1,0,1,0,-1
4302,1,0,1,0,-1
4303,1,0,7,0,-7
4304,1,0,21,0,-21
4305,1,1,613,4542,3929
4306,0,0,30,0,-30
4307,1,0,1,0,-1
4308,1,1,566,3465,2899
4309,0,0,5,0,-5
4310,1,0,48,0,-48
4311,1,0,20,0,-20
4312,1,1,391,1235,844
4313,0,0,11,0,-11
4314,0,0,55,0,-55
4315,1,0,10,0,-10
4316,0,0,41,0,-41
4317,1,0,11,0,-11
4318,0,0,166,0,-166
4319,1,0,3,0,-3
4320,1,1,1167,1201,34
4321,0,0,1,0,-1
4322,1,1,958,1401,443
4323,1,1,416,1214,798
4324,0,0,33,0,-33
4325,1,0,0,0,0
4326,1,1,460,1926,1466
4327,0,0,107,0,-107
4328,0,0,92,0,-92
4329,1,0,13,0,-13
4330,1,1,179,1391,1212
4331,0,0,9,0,-9
4332,1,0,34,0,-34
4333,1,1,975,1294,319
4334,0,0,70,0,-70
4335,1,0,18,0,-18
4336,1,1,212,3806,3594
4337,0,0,18,0,-18
4338,1,0,222,0,-222
4339,1,0,10,0,-10
4340,0,0,16,0,-16
4341,0,0,16,0,-16
4342,1,0,38,0,-38
4343,1,0,9,0,-9
4344,1,0,20,0,-20
4345,1,0,14,0,-14
4346,1,1,755,1634,879
4347,0,0,71,0,-71
4348,0,0,23,0,-23
4349,0,0,120,0,-120
4350,1,1,398,1204,806
4351,0,0,25,0,-25
4352,0,0,4,0,-4
4353,0,0,57,0,-57
4354,0,0,158,0,-158
4355,1,1,690,1419,729
4356,1,0,16,0,-16
4357,1,1,96,1814,1718
4358,1,1,2335,1317,-1018
4359,0,0,3,0,-3
4360,1,1,351,1250,899
4361,0,0,15,0,-15
4362,1,0,18,0,-18
4363,0,0,94,0,-94
4364,1,0,64,0,-64
4365,0,0,7,0,-7
4366,0,0,22,0,-22
4367,1,1,368,1884,1516
4368,1,1,73,1367,1294
4369,0,0,30,0,-30
4370,1,0,76,0,-76
4371,1,1,1259,1356,97
4372,1,0,187,0,-187
4373,0,0,40,0,-40
4374,1,0,72,0,-72
4375,0,0,77,0,-77
4376,1,1,485,1368,883
4377,0,0,65,0,-65
4378,1,1,281,1259,978
4379,0,0,68,0,-68
4380,0,0,238,0,-238
4381,0,0,95,0,-95
4382,0,0,77,0,-77
4383,1,0,0,0,0
4384,0,0,28,0,-28
4385,0,0,24,0,-24
4386,0,0,9,0,-9
4387,0,0,38,0,-38
4388,1,1,219,1493,1274
4389,1,0,33,0,-33
4390,1,1,73,1271,1198
4391,0,0,83,0,-83
4392,1,1,502,1241,739
4393,0,0,64,0,-64
4394,1,1,237,1386,1149
4395,0,0,1,0,-1
4396,1,0,36,0,-36
4397,1,0,0,0,0
4398,1,0,48,0,-48
4399,1,1,829,1492,663
4400,1,1,1578,1344,-234
4401,1,0,9,0,-9
4402,1,0,16,0,-16
4403,0,0,31,0,-31
4404,1,1,32,1524,1492
4405,0,0,17,0,-17
4406,0,0,11,0,-11
4407,0,0,30,0,-30
4408,1,1,430,1452,1022
4409,1,0,61,0,-61
4410,1,0,7,0,-7
4411,1,0,23,0,-23
4412,1,0,22,0,-22
4413,0,0,0,0,0
4414,1,0,54,0,-54
4415,1,0,47,0,-47
4416,1,1,421,1292,871
4417,0,0,148,0,-148
4418,0,0,12,0,-12
4419,1,1,613,1336,723
4420,1,1,217,1240,1023
4421,0,0,47,0,-47
4422,1,0,81,0,-81
4423,0,0,41,0,-41
4424,1,1,124,1350,1226
4425,1,1,999,1437,438
4426,0,0,123,0,-123
4427,1,0,33,0,-33
4428,0,0,15,0,-15
4429,1,0,5,0,-5
4430,1,0,161,0,-161
4431,0,0,39,0,-39
4432,1,0,87,0,-87
4433,0,0,1,0,-1
4434,0,0,31,0,-31
4435,1,1,413,1402,989
4436,0,0,37,0,-37
4437,1,0,14,0,-14
4438,1,0,46,0,-46
4439,1,0,220,0,-220
4440,0,0,63,0,-63
4441,1,0,16,0,-16
4442,0,0,54,0,-54
4443,0,0,31,0,-31
4444,1,1,460,1223,763
4445,1,1,1906,1452,-454
4446,1,0,19,0,-19
4447,0,0,38,0,-38
4448,0,0,2,0,-2
4449,1,0,6,0,-6
4450,1,0,53,0,-53
4451,0,0,24,0,-24
4452,1,0,27,0,-27
4453,0,0,6,0,-6
4454,1,0,37,0,-37
4455,1,1,71,1677,1606
4456,1,0,21,0,-21
4457,0,0,134,0,-134
4458,0,0,27,0,-27
4459,1,1,1108,1203,95
4460,0,0,28,0,-28
4461,0,0,12,0,-12
4462,0,0,67,0,-67
4463,1,0,16,0,-16
4464,0,0,8,0,-8
4465,0,0,56,0,-56
4466,0,0,2,0,-2
4467,0,0,56,0,-56
4468,0,0,83,0,-83
4469,1,1,1310,1819,509
4470,1,0,122,0,-122
4471,0,0,81,0,-81
4472,1,1,1613,1561,-52
4473,0,0,91,0,-91
4474,0,0,1,0,-1
4475,1,1,589,1231,642
4476,0,0,15,0,-15
4477,1,0,5,0,-5
4478,1,1,560,2929,2369
4479,0,0,28,0,-28
4480,0,0,118,0,-118
4481,0,0,2,0,-2
4482,1,1,46,1508,1462
4483,1,1,191,1451,1260
4484,1,0,41,0,-41
4485,0,0,118,0,-118
4486,1,0,10,0,-10
4487,1,1,121,1741,1620
4488,0,0,86,0,-86
4489,0,0,9,0,-9
4490,1,0,85,0,-85
4491,1,1,246,1472,1226
4492,0,0,11,0,-11
4493,1,1,1270,1937,667
4494,1,1,327,1596,1269
4495,1,1,1496,1241,-255
4496,1,0,44,0,-44
4497,1,1,678,1392,714
4498,1,0,23,0,-23
4499,0,0,10,0,-10
4500,0,0,27,0,-27
4501,1,1,500,1815,1315
4502,1,0,4,0,-4
4503,1,0,94,0,-94
4504,1,1,746,2403,1657
4505,1,0,141,0,-141
4506,1,1,527,2413,1886
4507,1,1,1038,1526,488
4508,1,0,93,0,-93
4509,1,1,265,1734,1469
4510,0,0,72,0,-72
4511,1,1,360,1668,1308
4512,1,1,819,1637,818
4513,1,1,82,1309,1227
4514,0,0,2,0,-2
4515,1,0,3,0,-3
4516,1,1,466,1682,1216
4517,1,1,134,1558,1424
4518,1,1,1290,1363,73
4519,0,0,6,0,-6
4520,0,0,16,0,-16
4521,1,1,1238,1353,115
4522,1,1,115,1536,1421
4523,1,0,60,0,-60
4524,1,0,250,0,-250
4525,1,0,25,0,-25
4526,1,1,643,3241,2598
4527,0,0,7,0,-7
4528,0,0,43,0,-43
4529,1,1,853,1332,479
4530,0,0,27,0,-27
4531,1,0,3,0,-3
4532,0,0,14,0,-14
4533,1,0,13,0,-13
4534,1,1,472,1464,992
4535,0,0,2,0,-2
4536,1,1,293,1572,1279
4537,1,1,317,1452,1135
4538,1,1,1412,4399,2987
4539,0,0,65,0,-65
4540,0,0,7,0,-7
4541,1,1,254,1234,980
4542,1,1,462,1591,1129
4543,0,0,63,0,-63
4544,1,1,405,1385,980
4545,1,1,112,1503,1391
4546,1,1,665,1714,1049
4547,1,0,5,0,-5
4548,0,0,3,0,-3
4549,1,0,18,0,-18
4550,1,0,71,0,-71
4551,1,1,909,1202,293
4552,1,1,332,1316,984
4553,0,0,13,0,-13
4554,0,0,1,0,-1
4555,1,1,323,1636,1313
4556,0,0,5,0,-5
4557,1,1,215,1349,1134
4558,1,1,444,1235,791
4559,0,0,64,0,-64
4560,0,0,80,0,-80
4561,0,0,7,0,-7
4562,0,0,85,0,-85
4563,0,0,24,0,-24
4564,1,1,554,1849,1295
4565,0,0,17,0,-17
4566,0,0,2,0,-2
4567,1,0,3,0,-3
4568,1,1,1099,1453,354
4569,0,0,31,0,-31
4570,1,0,74,0,-74
4571,1,0,42,0,-42
4572,1,1,281,1549,1268
4573,1,0,25,0,-25
4574,1,1,351,1382,1031
4575,1,0,4,0,-4
4576,0,0,11,0,-11
4577,1,1,657,1208,551
4578,0,0,30,0,-30
4579,1,1,97,1772,1675
4580,1,0,2,0,-2
4581,0,0,91,0,-91
4582,0,0,37,0,-37
4583,0,0,40,0,-40
4584,1,0,15,0,-15
4585,1,0,10,0,-10
4586,1,1,264,2575,2311
4587,1,1,540,1493,953
4588,1,0,1,0,-1
4589,1,1,282,3662,3380
4590,0,0,54,0,-54
4591,0,0,27,0,-27
4592,0,0,2,0,-2
4593,0,0,8,0,-8
4594,0,0,29,0,-29
4595,1,0,16,0,-16
4596,1,1,134,1357,1223
4597,0,0,38,0,-38
4598,1,1,942,2055,1113
4599,0,0,207,0,-207
4600,1,1,415,1535,1120
4601,1,1,195,3701,3506
4602,1,0,96,0,-96
4603,1,0,103,0,-103
4604,1,0,31,0,-31
4605,1,1,178,1284,1106
4606,0,0,20,0,-20
4607,0,0,13,0,-13
4608,1,0,15,0,-15
4609,1,0,135,0,-135
4610,1,0,13,0,-13
4611,1,0,109,0,-109
4612,1,1,1485,2577,1092
4613,0,0,109,0,-109
4614,1,0,39,0,-39
4615,1,0,56,0,-56
4616,1,1,377,1485,1108
4617,0,0,168,0,-168
4618,1,0,250,0,-250
4619,1,1,74,1470,1396
4620,0,0,5,0,-5
4621,0,0,20,0,-20
4622,1,1,15,1569,1554
4623,1,1,335,1488,1153
4624,1,1,135,1695,1560
4625,0,0,16,0,-16
4626,1,1,22,1448,1426
4627,1,1,95,1222,1127
4628,0,0,29,0,-29
4629,1,0,24,0,-24
4630,1,0,3,0,-3
4631,1,0,38,0,-38
4632,1,0,11,0,-11
4633,0,0,93,0,-93
4634,1,1,222,1464,1242
4635,1,0,94,0,-94
4636,0,0,0,0,0
4637,1,1,154,1329,1175
4638,1,1,315,1574,1259
4639,0,0,18,0,-18
4640,1,0,121,0,-121
4641,0,0,14,0,-14
4642,1,0,85,0,-85
4643,1,0,29,0,-29
4644,0,0,40,0,-40
4645,0,0,56,0,-56
4646,1,0,1,0,-1
4647,1,0,1,0,-1
4648,1,1,580,1221,641
4649,1,0,168,0,-168
4650,0,0,15,0,-15
4651,0,0,25,0,-25
4652,1,0,72,0,-72
4653,0,0,81,0,-81
4654,0,0,98,0,-98
4655,1,1,306,1274,968
4656,0,0,0,0,0
4657,0,0,26,0,-26
4658,0,0,4,0,-4
4659,1,1,1249,1352,103
4660,0,0,3,0,-3
4661,1,0,37,0,-37
4662,1,0,31,0,-31
4663,0,0,45,0,-45
4664,1,1,104,2025,1921
4665,0,0,118,0,-118
4666,1,0,11,0,-11
4667,1,0,35,0,-35
4668,1,1,171,1355,1184
4669,1,1,108,1253,1145
4670,0,0,1,0,-1
4671,1,1,173,1723,1550
4672,0,0,20,0,-20
4673,1,1,227,1358,1131
4674,0,0,22,0,-22
4675,0,0,138,0,-138
4676,0,0,73,0,-73
4677,1,1,1427,1747,320
4678,0,0,34,0,-34
4679,0,0,61,0,-61
4680,0,0,66,0,-66
4681,1,0,32,0,-32
4682,1,0,37,0,-37
4683,0,0,98,0,-98
4684,1,1,71,1427,1356
4685,1,0,45,0,-45
4686,0,0,54,0,-54
4687,1,1,590,1292,702
4688,1,1,194,1789,1595
4689,0,0,4,0,-4
4690,1,0,24,0,-24
4691,1,0,75,0,-75
4692,0,0,58,0,-58
4693,1,0,2,0,-2
4694,1,0,16,0,-16
4695,0,0,12,0,-12
4696,0,0,174,0,-174
4697,1,1,309,1213,904
4698,0,0,12,0,-12
4699,1,0,8,0,-8
4700,0,0,33,0,-33
4701,0,0,3,0,-3
4702,1,1,1367,1889,522
4703,1,1,163,1332,1169
4704,1,0,19,0,-19
4705,1,0,23,0,-23
4706,1,0,142,0,-142
4707,1,1,726,1681,955
4708,1,0,13,0,-13
4709,1,0,70,0,-70
4710,1,0,69,0,-69
4711,0,0,11,0,-11
4712,1,0,6,0,-6
4713,1,0,48,0,-48
4714,1,1,267,1321,1054
4715,1,1,691,1304,613
4716,1,0,89,0,-89
4717,1,1,589,1659,1070
4718,1,1,241,1540,1299
4719,1,1,388,1853,1465
4720,1,1,876,1365,489
4721,1,0,54,0,-54
4722,1,0,35,0,-35
4723,1,0,6,0,-6
4724,1,0,70,0,-70
4725,1,0,25,0,-25
4726,1,1,666,1243,577
4727,1,0,10,0,-10
4728,1,0,22,0,-22
4729,0,0,4,0,-4
4730,1,1,468,1220,752
4731,1,1,371,1231,860
4732,1,0,16,0,-16
4733,0,0,36,0,-36
4734,0,0,92,0,-92
4735,1,0,19,0,-19
4736,0,0,39,0,-39
4737,0,0,32,0,-32
4738,1,0,54,0,-54
4739,1,0,27,0,-27
4740,0,0,8,0,-8
4741,0,0,3,0,-3
4742,1,0,109,0,-109
4743,1,0,16,0,-16
4744,1,1,357,1361,1004
4745,0,0,53,0,-53
4746,1,1,83,2100,2017
4747,1,1,389,1334,945
4748,1,0,23,0,-23
4749,1,1,544,1252,708
4750,1,0,34,0,-34
4751,0,0,108,0,-108
4752,1,0,3,0,-3
4753,0,0,70,0,-70
4754,1,1,213,2260,2047
4755,1,1,586,1310,724
4756,1,1,95,1450,1355
4757,0,0,109,0,-109
4758,1,1,434,2335,1901
4759,1,1,689,1496,807
4760,1,0,8,0,-8
4761,1,1,418,1514,1096
4762,1,0,60,0,-60
4763,0,0,8,0,-8
4764,0,0,11,0,-11
4765,1,1,176,1307,1131
4766,0,0,36,0,-36
4767,1,0,38,0,-38
4768,0,0,31,0,-31
4769,0,0,26,0,-26
4770,1,1,415,1334,919
4771,1,1,1065,1230,165
4772,0,0,19,0,-19
4773,0,0,38,0,-38
4774,0,0,5,0,-5
4775,1,1,971,1229,258
4776,0,0,49,0,-49
4777,1,0,81,0,-81
4778,1,0,37,0,-37
4779,1,1,1081,1290,209
4780,1,1,2131,1287,-844
4781,1,0,46,0,-46
4782,1,0,25,0,-25
4783,0,0,1,0,-1
4784,1,1,59,1266,1207
4785,0,0,30,0,-30
4786,1,1,613,1341,728
4787,1,0,4,0,-4
4788,1,1,753,1708,955
4789,1,1,140,1306,1166
4790,1,0,111,0,-111
4791,1,1,172,1850,1678
4792,1,0,65,0,-65
4793,1,0,195,0,-195
4794,0,0,18,0,-18
4795,1,0,45,0,-45
4796,0,0,81,0,-81
4797,0,0,30,0,-30
4798,1,1,95,2519,2424
4799,1,1,325,2241,1916
4800,1,0,39,0,-39
4801,1,0,44,0,-44
4802,1,0,88,0,-88
4803,0,0,3,0,-3
4804,1,0,19,0,-19
4805,0,0,19,0,-19
4806,1,0,2,0,-2
4807,1,1,1251,1495,244
4808,0,0,122,0,-122
4809,1,0,46,0,-46
4810,1,1,147,1728,1581
4811,1,1,117,1538,1421
4812,0,0,48,0,-48
4813,0,0,0,0,0
4814,0,0,21,0,-21
4815,0,0,64,0,-64
4816,1,0,8,0,-8
4817,1,1,1766,1381,-385
4818,1,0,26,0,-26
4819,1,0,53,0,-53
4820,1,1,579,1761,1182
4821,1,0,10,0,-10
4822,0,0,113,0,-113
4823,0,0,47,0,-47
4824,1,1,762,1397,635
4825,0,0,3,0,-3
4826,0,0,7,0,-7
4827,1,0,6,0,-6
4828,1,0,2,0,-2
4829,1,1,576,1379,803
4830,0,0,40,0,-40
4831,1,1,202,1415,1213
4832,1,1,306,1213,907
4833,1,1,478,1323,845
4834,1,1,154,1276,1122
4835,0,0,96,0,-96
4836,1,1,194,1416,1222
4837,1,0,13,0,-13
4838,0,0,73,0,-73
4839,1,0,31,0,-31
4840,1,0,13,0,-13
4841,1,1,1283,1209,-74
4842,1,0,43,0,-43
4843,1,0,280,0,-280
4844,1,1,89,1407,1318
4845,1,0,53,0,-53
4846,1,1,261,1321,1060
4847,1,1,629,3278,2649
4848,0,0,16,0,-16
4849,0,0,25,0,-25
4850,0,0,0,0,0
4851,0,0,2,0,-2
4852,1,1,1601,1213,-388
4853,1,0,3,0,-3
4854,0,0,37,0,-37
4855,1,1,284,1340,1056
4856,0,0,109,0,-109
4857,1,1,822,1213,391
4858,0,0,7,0,-7
4859,1,1,1923,1429,-494
4860,1,0,2,0,-2
4861,0,0,64,0,-64
4862,0,0,4,0,-4
4863,0,0,16,0,-16
4864,1,1,357,2110,1753
4865,0,0,23,0,-23
4866,1,1,445,1213,768
4867,0,0,32,0,-32
4868,1,0,89,0,-89
4869,1,0,30,0,-30
4870,1,0,59,0,-59
4871,1,1,374,2705,2331
4872,1,1,305,3414,3109
4873,1,1,392,2121,1729
4874,1,0,67,0,-67
4875,0,0,6,0,-6
4876,1,1,467,1317,850
4877,0,0,10,0,-10
4878,1,0,54,0,-54
4879,0,0,22,0,-22
4880,1,0,23,0,-23
4881,1,1,349,1333,984
4882,1,0,17,0,-17
4883,1,1,319,1288,969
4884,0,0,9,0,-9
4885,1,1,35,1332,1297
4886,0,0,6,0,-6
4887,1,0,15,0,-15
4888,1,0,29,0,-29
4889,0,0,13,0,-13
4890,1,1,1985,3087,1102
4891,0,0,82,0,-82
4892,1,0,22,0,-22
4893,1,1,454,1220,766
4894,0,0,64,0,-64
4895,1,1,1434,1774,340
4896,0,0,13,0,-13
4897,1,0,7,0,-7
4898,1,0,86,0,-86
4899,1,0,13,0,-13
4900,1,1,228,1906,1678
4901,1,0,24,0,-24
4902,0,0,83,0,-83
4903,1,1,301,1385,1084
4904,1,1,198,1818,1620
4905,1,1,24,1653,1629
4906,1,1,582,1350,768
4907,1,0,18,0,-18
4908,0,0,6,0,-6
4909,1,1,526,2564,2038
4910,0,0,81,0,-81
4911,1,0,43,0,-43
4912,1,0,67,0,-67
4913,1,1,343,1410,1067
4914,1,0,2,0,-2
4915,0,0,18,0,-18
4916,1,1,5,2488,2483
4917,1,0,21,0,-21
4918,1,0,80,0,-80
4919,1,0,4,0,-4
4920,1,1,216,2490,2274
4921,1,0,35,0,-35
4922,1,1,2232,1444,-788
4923,0,0,5,0,-5
4924,1,1,85,1319,1234
4925,1,1,335,1554,1219
4926,0,0,66,0,-66
4927,0,0,4,0,-4
4928,0,0,8,0,-8
4929,0,0,60,0,-60
4930,1,0,71,0,-71
4931,0,0,19,0,-19
4932,1,1,650,1334,684
4933,1,0,66,0,-66
4934,0,0,81,0,-81
4935,0,0,2,0,-2
4936,1,1,339,1336,997
4937,0,0,29,0,-29
4938,1,1,160,1218,1058
4939,1,1,55,1435,1380
4940,1,0,105,0,-105
4941,0,0,26,0,-26
4942,0,0,74,0,-74
4943,0,0,23,0,-23
4944,1,0,26,0,-26
4945,1,0,7,0,-7
4946,1,1,1024,2465,1441
4947,0,0,12,0,-12
4948,0,0,5,0,-5
4949,1,0,5,0,-5
4950,0,0,113,0,-113
4951,0,0,5,0,-5
4952,0,0,60,0,-60
4953,1,0,14,0,-14
4954,0,0,30,0,-30
4955,1,1,178,1250,1072
4956,1,1,46,1515,1469
4957,1,1,107,1291,1184
4958,1,1,263,1670,1407
4959,1,0,1,0,-1
4960,0,0,9,0,-9
4961,1,1,95,1747,1652
4962,0,0,59,0,-59
4963,1,1,517,1992,1475
4964,1,0,34,0,-34
4965,0,0,112,0,-112
4966,0,0,16,0,-16
4967,0,0,159,0,-159
4968,0,0,84,0,-84
4969,1,1,47,1224,1177
4970,0,0,19,0,-19
4971,1,0,27,0,-27
4972,1,0,131,0,-131
4973,1,0,9,0,-9
4974,0,0,28,0,-28
4975,0,0,37,0,-37
4976,0,0,1,0,-1
4977,1,1,1646,1299,-347
4978,1,0,120,0,-120
4979,1,1,348,1343,995
4980,1,0,75,0,-75
4981,1,0,15,0,-15
4982,0,0,13,0,-13
4983,1,1,815,2342,1527
4984,0,0,141,0,-141
4985,1,0,31,0,-31
4986,1,0,27,0,-27
4987,0,0,24,0,-24
4988,1,0,74,0,-74
4989,0,0,169,0,-169
4990,1,0,76,0,-76
4991,0,0,2,0,-2
4992,0,0,37,0,-37
4993,0,0,55,0,-55
4994,1,1,483,1339,856
4995,1,0,292,0,-292
4996,0,0,52,0,-52
4997,0,0,147,0,-147
4998,1,1,68,3004,2936
4999,0,0,118,0,-118
5000,1,1,881,1477,596
5001,1,0,3,0,-3
5002,1,1,34,2516,2482
5003,0,0,19,0,-19
5004,1,1,868,1209,341
5005,1,1,157,1218,1061
5006,0,0,1,0,-1
5007,0,0,6,0,-6
5008,1,0,154,0,-154
5009,1,1,91,1505,1414
5010,1,1,792,1326,534
5011,1,0,55,0,-55
5012,1,0,42,0,-42
5013,1,1,2507,2642,135
5014,1,0,11,0,-11
5015,1,1,812,1849,1037
5016,0,0,50,0,-50
5017,0,0,8,0,-8
5018,1,0,4,0,-4
5019,1,1,1355,1385,30
5020,1,0,25,0,-25
5021,1,0,41,0,-41
5022,1,1,557,2575,2018
5023,1,0,120,0,-120
5024,0,0,217,0,-217
5025,1,1,70,1872,1802
5026,0,0,96,0,-96
5027,1,1,405,1214,809
5028,0,0,50,0,-50
5029,1,0,15,0,-15
5030,0,0,179,0,-179
5031,0,0,108,0,-108
5032,1,1,212,1784,1572
5033,1,1,863,2311,1448
5034,1,0,195,0,-195
5035,1,1,695,1252,557
5036,0,0,100,0,-100
5037,1,1,450,1200,750
5038,0,0,187,0,-187
5039,1,1,1230,1270,40
5040,0,0,106,0,-106
5041,0,0,183,0,-183
5042,0,0,25,0,-25
5043,1,0,81,0,-81
5044,0,0,16,0,-16
5045,1,0,75,0,-75
5046,1,1,282,1220,938
5047,0,0,3,0,-3
5048,0,0,30,0,-30
5049,0,0,5,0,-5
5050,0,0,17,0,-17
5051,0,0,30,0,-30
5052,1,1,642,1274,632
5053,1,0,102,0,-102
5054,1,1,157,1399,1242
5055,1,1,272,1219,947
5056,1,0,29,0,-29
5057,1,0,8,0,-8
5058,1,0,4,0,-4
5059,1,0,12,0,-12
5060,1,0,49,0,-49
5061,0,0,38,0,-38
5062,1,1,115,1294,1179
5063,0,0,69,0,-69
5064,1,1,1347,1258,-89
5065,0,0,2,0,-2
5066,0,0,36,0,-36
5067,1,1,502,2018,1516
5068,0,0,7,0,-7
5069,1,0,29,0,-29
5070,1,0,7,0,-7
5071,1,1,882,1222,340
5072,0,0,3,0,-3
5073,1,1,657,1281,624
5074,1,1,53,3077,3024
5075,0,0,5,0,-5
5076,1,0,75,0,-75
5077,1,1,273,1626,1353
5078,0,0,38,0,-38
5079,0,0,0,0,0
5080,0,0,73,0,-73
5081,1,1,465,1203,738
5082,0,0,17,0,-17
5083,0,0,68,0,-68
5084,1,1,32,1412,1380
5085,1,0,145,0,-145
5086,1,1,143,1341,1198
5087,0,0,17,0,-17
5088,1,1,264,3573,3309
5089,1,0,136,0,-136
5090,1,0,2,0,-2
5091,1,0,74,0,-74
5092,0,0,50,0,-50
5093,1,1,540,1359,819
5094,0,0,37,0,-37
5095,1,1,1602,1683,81
5096,0,0,24,0,-24
5097,1,1,774,1350,576
5098,0,0,12,0,-12
5099,1,0,59,0,-59
5100,0,0,13,0,-13
5101,0,0,148,0,-148
5102,1,1,303,1997,1694
5103,0,0,49,0,-49
5104,1,0,10,0,-10
5105,0,0,54,0,-54
5106,0,0,21,0,-21
5107,1,1,508,1378,870
5108,1,0,38,0,-38
5109,0,0,216,0,-216
5110,1,1,365,1840,1475
5111,1,0,79,0,-79
5112,0,0,3,0,-3
5113,0,0,45,0,-45
5114,0,0,37,0,-37
5115,1,0,69,0,-69
5116,1,0,61,0,-61
5117,1,1,414,1402,988
5118,1,0,31,0,-31
5119,1,0,45,0,-45
5120,1,1,502,1294,792
5121,1,1,1077,1369,292
5122,1,0,49,0,-49
5123,0,0,82,0,-82
5124,0,0,67,0,-67
5125,0,0,40,0,-40
5126,1,1,1551,1204,-347
5127,0,0,88,0,-88
5128,0,0,17,0,-17
5129,1,0,10,0,-10
5130,0,0,138,0,-138
5131,1,0,8,0,-8
5132,1,1,860,1416,556
5133,0,0,26,0,-26
5134,0,0,83,0,-83
5135,0,0,44,0,-44
5136,0,0,2,0,-2
5137,1,1,599,1265,666
5138,0,0,64,0,-64
5139,1,1,85,1296,1211
5140,1,0,15,0,-15
5141,1,0,59,0,-59
5142,0,0,14,0,-14
5143,1,0,95,0,-95
5144,0,0,55,0,-55
5145,1,0,58,0,-58
5146,0,0,23,0,-23
5147,1,0,6,0,-6
5148,0,0,48,0,-48
5149,1,0,91,0,-91
5150,1,0,1,0,-1
5151,1,0,40,0,-40
5152,1,1,451,3145,2694
5153,0,0,6,0,-6
5154,0,0,2,0,-2
5155,1,0,72,0,-72
5156,0,0,60,0,-60
5157,1,1,909,2269,1360
5158,1,1,343,1976,1633
5159,1,1,626,1748,1122
5160,0,0,35,0,-35
5161,1,0,74,0,-74
5162,1,0,84,0,-84
5163,1,1,808,1419,611
5164,1,0,17,0,-17
5165,1,0,53,0,-53
5166,0,0,101,0,-101
5167,1,0,165,0,-165
5168,1,1,570,1798,1228
5169,0,0,24,0,-24
5170,1,1,903,1251,348
5171,1,0,94,0,-94
5172,1,1,834,1391,557
5173,0,0,40,0,-40
5174,1,0,33,0,-33
5175,0,0,59,0,-59
5176,0,0,32,0,-32
5177,1,0,27,0,-27
5178,1,1,746,1206,460
5179,1,0,3,0,-3
5180,0,0,19,0,-19
5181,0,0,47,0,-47
5182,0,0,27,0,-27
5183,1,1,78,1373,1295
5184,1,0,84,0,-84
5185,0,0,114,0,-114
5186,0,0,220,0,-220
5187,0,0,4,0,-4
5188,1,0,85,0,-85
5189,0,0,132,0,-132
5190,0,0,78,0,-78
5191,1,1,521,1647,1126
5192,1,1,245,1749,1504
5193,1,0,48,0,-48
5194,1,0,82,0,-82
5195,1,1,94,1379,1285
5196,1,0,130,0,-130
5197,1,1,390,1238,848
5198,0,0,18,0,-18
5199,0,0,26,0,-26
5200,1,0,2,0,-2
5201,0,0,34,0,-34
5202,1,0,58,0,-58
5203,0,0,19,0,-19
5204,1,1,410,1218,808
5205,0,0,80,0,-80
5206,1,1,445,1215,770
5207,1,1,97,1276,1179
5208,1,0,61,0,-61
5209,0,0,167,0,-167
5210,0,0,22,0,-22
5211,0,0,47,0,-47
5212,0,0,88,0,-88
5213,0,0,29,0,-29
5214,1,1,316,1622,1306
5215,0,0,15,0,-15
5216,0,0,0,0,0
5217,1,0,68,0,-68
5218,1,1,326,1495,1169
5219,1,1,221,1464,1243
5220,1,1,262,2298,2036
5221,1,1,312,1242,930
5222,0,0,94,0,-94
5223,0,0,10,0,-10
5224,0,0,4,0,-4
5225,1,0,53,0,-53
5226,0,0,82,0,-82
5227,0,0,90,0,-90
5228,1,0,7,0,-7
5229,0,0,13,0,-13
5230,1,1,44,1452,1408
5231,1,0,16,0,-16
5232,0,0,11,0,-11
5233,1,0,90,0,-90
5234,1,1,622,1284,662
5235,1,1,781,1653,872
5236,0,0,19,0,-19
5237,1,1,1174,1680,506
5238,1,0,20,0,-20
5239,1,1,606,1227,621
5240,1,0,4,0,-4
5241,0,0,23,0,-23
5242,1,1,915,1244,329
5243,0,0,10,0,-10
5244,1,0,82,0,-82
5245,1,1,100,1850,1750
5246,0,0,34,0,-34
5247,1,0,26,0,-26
5248,1,1,124,1683,1559
5249,1,0,8,0,-8
5250,1,0,159,0,-159
5251,1,1,74,1218,1144
5252,1,0,44,0,-44
5253,1,0,27,0,-27
5254,1,0,4,0,-4
5255,0,0,30,0,-30
5256,0,0,164,0,-164
5257,0,0,49,0,-49
5258,1,1,331,1229,898
5259,1,0,82,0,-82
5260,1,1,234,1259,1025
5261,0,0,17,0,-17
5262,1,1,1038,1226,188
5263,0,0,145,0,-145
5264,1,1,26,1912,1886
5265,0,0,21,0,-21
5266,1,1,470,1244,774
5267,0,0,2,0,-2
5268,1,1,2021,1354,-667
5269,1,0,11,0,-11
5270,1,0,1,0,-1
5271,0,0,88,0,-88
5272,0,0,14,0,-14
5273,0,0,12,0,-12
5274,1,0,48,0,-48
5275,1,0,147,0,-147
5276,0,0,30,0,-30
5277,1,0,116,0,-116
5278,0,0,44,0,-44
5279,0,0,23,0,-23
5280,0,0,18,0,-18
5281,1,1,484,1217,733
5282,0,0,4,0,-4
5283,1,0,58,0,-58
5284,0,0,38,0,-38
5285,0,0,6,0,-6
5286,0,0,47,0,-47
5287,1,0,50,0,-50
5288,0,0,30,0,-30
5289,0,0,12,0,-12
5290,1,1,353,1254,901
5291,1,0,37,0,-37
5292,0,0,3,0,-3
5293,0,0,298,0,-298
5294,0,0,70,0,-70
5295,0,0,98,0,-98
5296,0,0,35,0,-35
5297,1,1,175,1237,1062
5298,1,1,211,1416,1205
5299,1,0,182,0,-182
5300,1,0,152,0,-152
5301,1,1,139,1694,1555
5302,1,1,1365,1202,-163
5303,1,1,161,1413,1252
5304,0,0,116,0,-116
5305,1,1,705,1723,1018
5306,1,0,54,0,-54
5307,0,0,34,0,-34
5308,0,0,3,0,-3
5309,0,0,16,0,-16
5310,1,1,546,1473,927
5311,1,1,109,2443,2334
5312,1,1,541,1528,987
5313,0,0,14,0,-14
5314,1,0,55,0,-55
5315,1,1,466,1651,1185
5316,0,0,0,0,0
5317,0,0,0,0,0
5318,0,0,31,0,-31
5319,0,0,58,0,-58
5320,0,0,114,0,-114
5321,1,0,60,0,-60
5322,0,0,29,0,-29
5323,1,1,363,1739,1376
5324,0,0,25,0,-25
5325,1,1,688,1557,869
5326,0,0,14,0,-14
5327,1,1,422,1207,785
5328,1,1,36,1361,1325
5329,0,0,67,0,-67
5330,1,1,2071,1243,-828
5331,0,0,16,0,-16
5332,1,0,23,0,-23
5333,1,0,144,0,-144
5334,1,0,40,0,-40
5335,1,1,188,1578,1390
5336,0,0,9,0,-9
5337,1,0,31,0,-31
5338,0,0,20,0,-20
5339,1,0,17,0,-17
5340,1,1,284,2642,2358
5341,0,0,13,0,-13
5342,1,1,446,1207,761
5343,1,1,99,2480,2381
5344,0,0,106,0,-106
5345,0,0,97,0,-97
5346,0,0,100,0,-100
5347,0,0,51,0,-51
5348,1,0,46,0,-46
5349,0,0,25,0,-25
5350,1,0,22,0,-22
5351,0,0,5,0,-5
5352,0,0,29,0,-29
5353,1,0,170,0,-170
5354,0,0,115,0,-115
5355,0,0,17,0,-17
5356,1,0,105,0,-105
5357,1,1,851,1250,399
5358,1,0,22,0,-22
5359,0,0,3,0,-3
5360,0,0,30,0,-30
5361,0,0,21,0,-21
5362,1,1,99,1203,1104
5363,0,0,11,0,-11
5364,1,0,8,0,-8
5365,0,0,75,0,-75
5366,0,0,10,0,-10
5367,1,1,62,1557,1495
5368,1,1,628,1482,854
5369,0,0,46,0,-46
5370,1,0,1,0,-1
5371,0,0,64,0,-64
5372,0,0,55,0,-55
5373,1,0,158,0,-158
5374,0,0,16,0,-16
5375,1,1,117,1303,1186
5376,1,0,85,0,-85
5377,0,0,22,0,-22
5378,1,1,147,1735,1588
5379,1,0,9,0,-9
5380,0,0,44,0,-44
5381,1,0,3,0,-3
5382,1,1,1031,1298,267
5383,1,1,415,1200,785
5384,1,1,790,1216,426
5385,0,0,66,0,-66
5386,0,0,31,0,-31
5387,0,0,27,0,-27
5388,1,0,25,0,-25
5389,1,1,35,1207,1172
5390,0,0,34,0,-34
5391,0,0,3,0,-3
5392,1,0,2,0,-2
5393,1,0,116,0,-116
5394,1,1,92,1984,1892
5395,1,0,44,0,-44
5396,0,0,44,0,-44
5397,0,0,21,0,-21
5398,0,0,60,0,-60
5399,1,0,152,0,-152
5400,1,1,2368,1403,-965
5401,1,1,1071,1346,275
5402,1,0,38,0,-38
5403,1,0,21,0,-21
5404,1,0,5,0,-5
5405,1,0,184,0,-184
5406,0,0,3,0,-3
5407,0,0,55,0,-55
5408,1,0,27,0,-27
5409,0,0,75,0,-75
5410,1,0,79,0,-79
5411,1,1,282,1279,997
5412,0,0,62,0,-62
5413,1,0,10,0,-10
5414,0,0,25,0,-25
5415,0,0,79,0,-79
5416,1,0,2,0,-2
5417,0,0,74,0,-74
5418,1,0,19,0,-19
5419,1,0,37,0,-37
5420,1,1,1298,1248,-50
5421,0,0,37,0,-37
5422,1,1,320,1237,917
5423,0,0,33,0,-33
5424,0,0,69,0,-69
5425,0,0,98,0,-98
5426,0,0,0,0,0
5427,1,1,132,1235,1103
5428,0,0,10,0,-10
5429,1,0,81,0,-81
5430,0,0,36,0,-36
5431,1,0,78,0,-78
5432,1,1,514,1353,839
5433,1,0,108,0,-108
5434,1,0,7,0,-7
5435,0,0,30,0,-30
5436,1,0,21,0,-21
5437,0,0,36,0,-36
5438,0,0,9,0,-9
5439,1,1,1029,1217,188
5440,1,0,52,0,-52
5441,1,0,22,0,-22
5442,1,0,132,0,-132
5443,0,0,52,0,-52
5444,0,0,31,0,-31
5445,1,1,438,1570,1132
5446,1,1,599,1701,1102
5447,1,1,74,1242,1168
5448,1,1,754,1526,772
5449,1,0,145,0,-145
5450,1,1,371,2074,1703
5451,0,0,34,0,-34
5452,1,0,37,0,-37
5453,1,1,434,1843,1409
5454,0,0,60,0,-60
5455,0,0,30,0,-30
5456,0,0,51,0,-51
5457,0,0,21,0,-21
5458,0,0,98,0,-98
5459,0,0,27,0,-27
5460,1,1,1953,2082,129
5461,0,0,52,0,-52
5462,0,0,4,0,-4
5463,1,0,13,0,-13
5464,0,0,35,0,-35
5465,0,0,63,0,-63
5466,0,0,41,0,-41
5467,1,1,1061,1293,232
5468,1,0,19,0,-19
5469,1,0,51,0,-51
5470,1,1,1207,1615,408
5471,0,0,34,0,-34
5472,1,0,132,0,-132
5473,0,0,95,0,-95
5474,0,0,21,0,-21
5475,1,0,41,0,-41
5476,1,1,1203,1593,390
5477,0,0,6,0,-6
5478,1,1,341,1242,901
5479,1,0,0,0,0
5480,1,0,68,0,-68
5481,1,1,210,1207,997
5482,1,0,148,0,-148
5483,0,0,43,0,-43
5484,0,0,53,0,-53
5485,0,0,0,0,0
5486,0,0,26,0,-26
5487,0,0,35,0,-35
5488,1,0,37,0,-37
5489,1,0,16,0,-16
5490,1,0,41,0,-41
5491,0,0,129,0,-129
5492,0,0,51,0,-51
5493,1,1,115,1631,1516
5494,1,1,227,1210,983
5495,1,1,511,1223,712
5496,1,1,151,1886,1735
5497,0,0,14,0,-14
5498,1,0,1,0,-1
5499,1,1,500,1818,1318
5500,0,0,93,0,-93
5501,0,0,71,0,-71
5502,1,0,65,0,-65
5503,0,0,1,0,-1
5504,0,0,14,0,-14
5505,0,0,5,0,-5
5506,1,0,176,0,-176
5507,0,0,96,0,-96
5508,0,0,13,0,-13
5509,1,0,53,0,-53
5510,0,0,13,0,-13
5511,1,1,2881,1312,-1569
5512,1,1,446,1409,963
5513,0,0,4,0,-4
5514,0,0,0,0,0
5515,1,0,1,0,-1
5516,1,0,33,0,-33
5517,1,1,935,2190,1255
5518,1,0,9,0,-9
5519,0,0,57,0,-57
5520,0,0,42,0,-42
5521,1,1,710,1368,658
5522,1,0,46,0,-46
5523,1,0,99,0,-99
5524,1,1,154,1534,1380
5525,1,0,3,0,-3
5526,0,0,32,0,-32
5527,0,0,26,0,-26
5528,1,0,27,0,-27
5529,0,0,99,0,-99
5530,0,0,21,0,-21
5531,0,0,79,0,-79
5532,0,0,65,0,-65
5533,1,0,11,0,-11
5534,1,0,44,0,-44
5535,1,0,177,0,-177
5536,0,0,19,0,-19
5537,1,1,1418,1642,224
5538,1,1,1047,1321,274
5539,0,0,41,0,-41
5540,1,0,87,0,-87
5541,1,0,14,0,-14
5542,1,1,828,1434,606
5543,1,1,792,1458,666
5544,0,0,15,0,-15
5545,0,0,170,0,-170
5546,0,0,0,0,0
5547,0,0,24,0,-24
5548,0,0,22,0,-22
5549,1,1,252,2938,2686
5550,1,0,49,0,-49
5551,0,0,113,0,-113
5552,1,1,730,1341,611
5553,1,0,22,0,-22
5554,1,1,303,1214,911
5555,1,0,12,0,-12
5556,1,0,119,0,-119
5557,0,0,84,0,-84
5558,0,0,29,0,-29
5559,1,1,249,1241,992
5560,0,0,27,0,-27
5561,1,0,56,0,-56
5562,1,1,919,3378,2459
5563,1,0,67,0,-67
5564,1,1,289,3929,3640
5565,0,0,206,0,-206
5566,1,1,24,1411,1387
5567,1,0,51,0,-51
5568,1,0,100,0,-100
5569,1,0,17,0,-17
5570,1,1,71,1397,1326
5571,0,0,15,0,-15
5572,1,0,17,0,-17
5573,0,0,5,0,-5
5574,1,1,137,2261,2124
5575,0,0,4,0,-4
5576,0,0,6,0,-6
5577,0,0,35,0,-35
5578,1,1,470,1327,857
5579,1,0,20,0,-20
5580,1,0,11,0,-11
5581,1,1,70,1333,1263
5582,1,1,152,1413,1261
5583,0,0,41,0,-41
5584,0,0,17,0,-17
5585,0,0,48,0,-48
5586,1,0,11,0,-11
5587,0,0,34,0,-34
5588,0,0,43,0,-43
5589,0,0,5,0,-5
5590,0,0,12,0,-12
5591,0,0,0,0,0
5592,1,1,673,2773,2100
5593,1,0,49,0,-49
5594,1,0,6,0,-6
5595,0,0,5,0,-5
5596,1,1,187,2061,1874
5597,0,0,82,0,-82
5598,0,0,60,0,-60
5599,0,0,12,0,-12
5600,0,0,16,0,-16
5601,0,0,7,0,-7
5602,1,0,27,0,-27
5603,1,0,40,0,-40
5604,0,0,27,0,-27
5605,0,0,96,0,-96
5606,1,1,1866,1208,-658
5607,1,0,4,0,-4
5608,1,1,459,1255,796
5609,0,0,15,0,-15
5610,1,1,135,1477,1342
5611,1,1,711,1371,660
5612,0,0,3,0,-3
5613,1,1,961,1544,583
5614,1,1,292,1488,1196
5615,1,1,290,1208,918
5616,0,0,101,0,-101
5617,1,1,29,1556,1527
5618,0,0,66,0,-66
5619,0,0,5,0,-5
5620,0,0,10,0,-10
5621,0,0,32,0,-32
5622,1,1,73,1415,1342
5623,1,1,168,1768,1600
5624,0,0,91,0,-91
5625,1,1,626,1526,900
5626,1,0,15,0,-15
5627,1,1,198,1273,1075
5628,1,1,182,1320,1138
5629,1,0,23,0,-23
5630,1,0,39,0,-39
5631,0,0,14,0,-14
5632,1,1,670,1214,544
5633,1,0,16,0,-16
5634,0,0,59,0,-59
5635,0,0,17,0,-17
5636,0,0,19,0,-19
5637,1,1,311,2476,2165
5638,0,0,4,0,-4
5639,1,1,85,1809,1724
5640,1,0,74,0,-74
5641,1,1,570,1398,828
5642,0,0,2,0,-2
5643,0,0,29,0,-29
5644,1,1,167,2555,2388
5645,1,1,256,1507,1251
5646,0,0,24,0,-24
5647,0,0,59,0,-59
5648,0,0,31,0,-31
5649,1,0,27,0,-27
5650,1,1,1540,1516,-24
5651,1,1,1151,2295,1144
5652,0,0,14,0,-14
5653,1,0,14,0,-14
5654,1,0,9,0,-9
5655,1,0,160,0,-160
5656,1,1,49,1391,1342
5657,1,1,1209,2042,833
5658,1,0,57,0,-57
5659,1,1,125,1692,1567
5660,0,0,39,0,-39
5661,1,0,96,0,-96
5662,0,0,30,0,-30
5663,0,0,50,0,-50
5664,1,1,123,1285,1162
5665,1,0,242,0,-242
5666,0,0,113,0,-113
5667,0,0,21,0,-21
5668,1,1,656,1326,670
5669,0,0,36,0,-36
5670,0,0,51,0,-51
5671,1,1,778,1226,448
5672,0,0,7,0,-7
5673,1,1,116,1415,1299
5674,1,0,74,0,-74
5675,0,0,28,0,-28
5676,1,1,1618,1498,-120
5677,1,1,58,1425,1367
5678,0,0,19,0,-19
5679,0,0,22,0,-22
5680,1,0,42,0,-42
5681,1,0,0,0,0
5682,0,0,101,0,-101
5683,1,1,346,2237,1891
5684,0,0,1,0,-1
5685,1,1,735,1217,482
5686,1,1,585,1205,620
5687,1,1,769,1310,541
5688,0,0,149,0,-149
5689,1,0,23,0,-23
5690,1,0,85,0,-85
5691,1,1,170,1269,1099
5692,0,0,14,0,-14
5693,1,0,1,0,-1
5694,0,0,100,0,-100
5695,1,1,305,1574,1269
5696,1,1,393,1236,843
5697,1,0,74,0,-74
5698,1,1,703,1541,838
5699,1,0,79,0,-79
5700,1,1,459,2043,1584
5701,1,0,18,0,-18
5702,1,0,112,0,-112
5703,1,0,78,0,-78
5704,0,0,88,0,-88
5705,0,0,35,0,-35
5706,1,1,400,1302,902
5707,0,0,27,0,-27
5708,1,0,60,0,-60
5709,1,1,339,2481,2142
5710,1,0,94,0,-94
5711,0,0,53,0,-53
5712,0,0,52,0,-52
5713,0,0,86,0,-86
5714,0,0,60,0,-60
5715,0,0,23,0,-23
5716,1,1,912,1259,347
5717,0,0,95,0,-95
5718,1,0,49,0,-49
5719,1,1,822,1272,450
5720,1,0,209,0,-209
5721,1,1,81,1226,1145
5722,0,0,95,0,-95
5723,1,1,29,1330,1301
5724,0,0,31,0,-31
5725,1,0,52,0,-52
5726,0,0,55,0,-55
5727,1,0,12,0,-12
5728,1,1,139,1526,1387
5729,1,1,435,1516,1081
5730,1,1,1157,1690,533
5731,1,1,895,1297,402
5732,1,0,44,0,-44
5733,1,0,28,0,-28
5734,1,0,2,0,-2
5735,1,1,398,1748,1350
5736,0,0,168,0,-168
5737,1,1,364,1468,1104
5738,1,1,732,1907,1175
5739,1,0,3,0,-3
5740,1,1,2120,1736,-384
5741,1,1,232,1304,1072
5742,1,0,136,0,-136
5743,1,1,569,1278,709
5744,0,0,37,0,-37
5745,0,0,1,0,-1
5746,1,1,942,1711,769
5747,1,0,2,0,-2
5748,0,0,78,0,-78
5749,0,0,23,0,-23
5750,1,1,530,1223,693
5751,1,1,1649,1574,-75
5752,1,0,8,0,-8
5753,1,0,22,0,-22
5754,0,0,114,0,-114
5755,0,0,28,0,-28
5756,0,0,40,0,-40
5757,1,1,125,1203,1078
5758,0,0,34,0,-34
5759,0,0,85,0,-85
5760,1,0,96,0,-96
5761,1,1,165,1522,1357
5762,0,0,50,0,-50
5763,1,0,8,0,-8
5764,1,1,369,1370,1001
5765,0,0,8,0,-8
5766,0,0,39,0,-39
5767,1,0,56,0,-56
5768,1,0,26,0,-26
5769,1,1,339,1204,865
5770,0,0,97,0,-97
5771,1,1,233,2846,2613
5772,1,0,75,0,-75
5773,1,0,70,0,-70
5774,0,0,100,0,-100
5775,1,1,290,1423,1133
5776,1,1,2161,1487,-674
5777,1,0,40,0,-40
5778,1,0,98,0,-98
5779,1,0,70,0,-70
5780,0,0,63,0,-63
5781,1,1,183,3578,3395
5782,0,0,34,0,-34
5783,1,0,47,0,-47
5784,1,1,890,1274,384
5785,1,1,813,2234,1421
5786,1,0,1,0,-1
5787,0,0,15,0,-15
5788,1,0,1,0,-1
5789,0,0,40,0,-40
5790,1,0,234,0,-234
5791,1,1,54,1381,1327
5792,1,1,433,1681,1248
5793,1,0,91,0,-91
5794,0,0,3,0,-3
5795,0,0,65,0,-65
5796,0,0,2,0,-2
5797,0,0,6,0,-6
5798,0,0,10,0,-10
5799,0,0,2,0,-2
5800,1,1,539,1504,965
5801,1,1,880,1242,362
5802,0,0,92,0,-92
5803,0,0,202,0,-202
5804,0,0,5,0,-5
5805,1,1,130,1290,1160
5806,1,1,117,1541,1424
5807,0,0,224,0,-224
5808,1,1,194,1382,1188
5809,0,0,25,0,-25
5810,1,0,34,0,-34
5811,1,0,64,0,-64
5812,0,0,2,0,-2
5813,1,1,78,2608,2530
5814,0,0,49,0,-49
5815,1,1,1804,1357,-447
5816,1,1,222,1546,1324
5817,0,0,25,0,-25
5818,1,0,74,0,-74
5819,0,0,131,0,-131
5820,1,0,26,0,-26
5821,1,1,291,1324,1033
5822,1,1,157,1807,1650
5823,1,0,166,0,-166
5824,1,1,577,1329,752
5825,1,1,413,1500,1087
5826,1,1,1455,1407,-48
5827,0,0,12,0,-12
5828,0,0,22,0,-22
5829,1,1,140,1411,1271
5830,1,0,3,0,-3
5831,0,0,4,0,-4
5832,0,0,11,0,-11
5833,0,0,26,0,-26
5834,1,0,90,0,-90
5835,1,1,1384,2248,864
5836,0,0,90,0,-90
5837,0,0,272,0,-272
5838,0,0,106,0,-106
5839,1,0,7,0,-7
5840,1,1,568,1534,966
5841,0,0,119,0,-119
5842,1,0,86,0,-86
5843,1,1,2382,1592,-790
5844,0,0,44,0,-44
5845,1,0,56,0,-56
5846,1,0,65,0,-65
5847,0,0,35,0,-35
5848,1,1,47,1239,1192
5849,0,0,74,0,-74
5850,0,0,7,0,-7
5851,0,0,118,0,-118
5852,0,0,104,0,-104
5853,0,0,93,0,-93
5854,1,0,71,0,-71
5855,1,1,523,1377,854
5856,1,1,228,1413,1185
5857,0,0,44,0,-44
5858,1,0,21,0,-21
5859,0,0,40,0,-40
5860,1,0,162,0,-162
5861,0,0,80,0,-80
5862,0,0,205,0,-205
5863,1,1,207,1321,1114
5864,1,0,3,0,-3
5865,0,0,155,0,-155
5866,0,0,47,0,-47
5867,0,0,34,0,-34
5868,1,0,44,0,-44
5869,1,1,814,1303,489
5870,1,1,255,1333,1078
5871,1,1,139,4978,4839
5872,1,0,44,0,-44
5873,1,0,13,0,-13
5874,0,0,53,0,-53
5875,0,0,231,0,-231
5876,0,0,69,0,-69
5877,1,0,10,0,-10
5878,0,0,21,0,-21
5879,0,0,10,0,-10
5880,1,1,347,1275,928
5881,1,1,442,1710,1268
5882,1,1,944,1616,672
5883,0,0,0,0,0
5884,1,0,12,0,-12
5885,0,0,0,0,0
5886,1,0,8,0,-8
5887,1,1,1356,1236,-120
5888,1,1,206,1687,1481
5889,1,1,430,1905,1475
5890,1,0,31,0,-31
5891,1,1,292,1331,1039
5892,0,0,23,0,-23
5893,1,1,97,1615,1518
5894,0,0,61,0,-61
5895,0,0,167,0,-167
5896,1,0,122,0,-122
5897,1,0,5,0,-5
5898,1,0,69,0,-69
5899,1,0,109,0,-109
5900,1,1,547,1506,959
5901,1,0,102,0,-102
5902,0,0,34,0,-34
5903,0,0,16,0,-16
5904,0,0,20,0,-20
5905,1,1,827,1386,559
5906,1,0,41,0,-41
5907,1,1,193,1208,1015
5908,1,0,10,0,-10
5909,0,0,21,0,-21
5910,1,0,75,0,-75
5911,1,1,309,1220,911
5912,0,0,20,0,-20
5913,1,0,19,0,-19
5914,1,0,65,0,-65
5915,1,0,14,0,-14
5916,1,0,20,0,-20
5917,1,1,1756,1369,-387
5918,0,0,35,0,-35
5919,1,0,24,0,-24
5920,1,1,409,1347,938
5921,1,0,110,0,-110
5922,1,0,67,0,-67
5923,1,0,73,0,-73
5924,1,1,229,1369,1140
5925,1,0,67,0,-67
5926,1,1,182,1201,1019
5927,0,0,16,0,-16
5928,0,0,179,0,-179
5929,0,0,123,0,-123
5930,1,1,66,1392,1326
5931,0,0,16,0,-16
5932,0,0,30,0,-30
5933,1,1,804,2247,1443
5934,0,0,52,0,-52
5935,1,0,3,0,-3
5936,1,0,40,0,-40
5937,1,0,38,0,-38
5938,1,0,56,0,-56
5939,0,0,44,0,-44
5940,0,0,9,0,-9
5941,1,1,1572,1511,-61
5942,1,1,151,1207,1056
5943,1,0,46,0,-46
5944,1,0,4,0,-4
5945,1,1,1831,1391,-440
5946,0,0,39,0,-39
5947,1,1,83,1224,1141
5948,0,0,125,0,-125
5949,0,0,12,0,-12
5950,1,0,73,0,-73
5951,0,0,51,0,-51
5952,1,1,572,1288,716
5953,1,0,92,0,-92
5954,0,0,25,0,-25
5955,1,0,25,0,-25
5956,1,0,1,0,-1
5957,1,0,29,0,-29
5958,1,1,88,1468,1380
5959,0,0,88,0,-88
5960,1,0,125,0,-125
5961,0,0,103,0,-103
5962,1,1,603,1560,957
5963,0,0,82,0,-82
5964,0,0,37,0,-37
5965,0,0,49,0,-49
5966,1,1,541,1472,931
5967,1,1,116,1390,1274
5968,0,0,50,0,-50
5969,1,1,535,1331,796
5970,0,0,4,0,-4
5971,0,0,43,0,-43
5972,1,1,907,1299,392
5973,1,0,3,0,-3
5974,0,0,50,0,-50
5975,1,0,12,0,-12
5976,0,0,32,0,-32
5977,0,0,11,0,-11
5978,1,0,191,0,-191
5979,1,1,551,1352,801
5980,0,0,468,0,-468
5981,1,0,52,0,-52
5982,0,0,26,0,-26
5983,0,0,87,0,-87
5984,1,0,15,0,-15
5985,1,0,25,0,-25
5986,0,0,2,0,-2
5987,0,0,113,0,-113
5988,0,0,29,0,-29
5989,0,0,13,0,-13
5990,0,0,98,0,-98
5991,1,0,29,0,-29
5992,0,0,7,0,-7
5993,1,1,185,1439,1254
5994,0,0,8,0,-8
5995,1,1,182,1794,1612
5996,0,0,23,0,-23
5997,1,1,230,1688,1458
5998,0,0,40,0,-40
5999,0,0,106,0,-106
6000,1,0,0,0,0
6001,1,1,986,1249,263
6002,1,1,69,5254,5185
6003,0,0,7,0,-7
6004,1,1,84,1254,1170
6005,0,0,32,0,-32
6006,1,1,230,1335,1105
6007,1,0,100,0,-100
6008,0,0,43,0,-43
6009,1,1,1280,3207,1927
6010,1,0,41,0,-41
6011,1,0,7,0,-7
6012,1,1,1838,1486,-352
6013,1,1,137,1273,1136
6014,1,0,32,0,-32
6015,0,0,8,0,-8
6016,1,0,9,0,-9
6017,1,0,56,0,-56
6018,0,0,140,0,-140
6019,1,1,302,3080,2778
6020,0,0,4,0,-4
6021,1,0,56,0,-56
6022,0,0,52,0,-52
6023,1,0,37,0,-37
6024,1,1,142,1340,1198
6025,0,0,151,0,-151
6026,1,0,109,0,-109
6027,1,1,1222,1277,55
6028,1,1,308,1278,970
6029,1,0,10,0,-10
6030,1,1,89,1311,1222
6031,1,1,882,1265,383
6032,1,1,507,1488,981
6033,1,0,2,0,-2
6034,0,0,6,0,-6
6035,0,0,66,0,-66
6036,1,1,1005,1240,235
6037,1,1,347,1203,856
6038,1,1,1675,1422,-253
6039,1,1,77,1271,1194
6040,0,0,37,0,-37
6041,0,0,118,0,-118
6042,1,1,163,1507,1344
6043,1,0,0,0,0
6044,1,1,166,1296,1130
6045,0,0,13,0,-13
6046,0,0,54,0,-54
6047,1,1,156,1222,1066
6048,0,0,16,0,-16
6049,1,1,1260,2182,922
6050,1,0,21,0,-21
6051,1,0,11,0,-11
6052,1,0,45,0,-45
6053,0,0,142,0,-142
6054,1,0,12,0,-12
6055,0,0,14,0,-14
6056,1,0,23,0,-23
6057,1,0,42,0,-42
6058,1,1,68,1274,1206
6059,1,1,415,1438,1023
6060,0,0,3,0,-3
6061,0,0,33,0,-33
6062,1,0,37,0,-37
6063,1,0,56,0,-56
6064,1,0,67,0,-67
6065,1,0,10,0,-10
6066,1,0,56,0,-56
6067,1,0,39,0,-39
6068,1,0,12,0,-12
6069,1,1,114,1793,1679
6070,1,0,37,0,-37
6071,1,1,329,1214,885
6072,1,1,254,1654,1400
6073,1,0,136,0,-136
6074,0,0,25,0,-25
6075,0,0,66,0,-66
6076,0,0,98,0,-98
6077,1,1,489,1966,1477
6078,0,0,2,0,-2
6079,1,0,23,0,-23
6080,0,0,31,0,-31
6081,1,1,85,1809,1724
6082,0,0,117,0,-117
6083,0,0,168,0,-168
6084,0,0,39,0,-39
6085,1,1,1034,1422,388
6086,1,0,72,0,-72
6087,0,0,5,0,-5
6088,1,0,19,0,-19
6089,1,0,16,0,-16
6090,1,1,405,1217,812
6091,0,0,48,0,-48
6092,1,0,55,0,-55
6093,1,0,28,0,-28
6094,1,1,755,2033,1278
6095,0,0,18,0,-18
6096,0,0,14,0,-14
6097,1,1,202,1838,1636
6098,1,0,79,0,-79
6099,0,0,59,0,-59
6100,1,0,19,0,-19
6101,1,1,1163,1830,667
6102,1,0,69,0,-69
6103,1,0,2,0,-2
6104,1,0,36,0,-36
6105,1,1,165,1350,1185
6106,1,0,4,0,-4
6107,0,0,153,0,-153
6108,0,0,15,0,-15
6109,1,1,892,1856,964
6110,1,1,385,1685,1300
6111,1,0,0,0,0
6112,1,0,12,0,-12
6113,0,0,277,0,-277
6114,0,0,64,0,-64
6115,1,1,1374,1628,254
6116,0,0,25,0,-25
6117,0,0,135,0,-135
6118,0,0,30,0,-30
6119,1,0,68,0,-68
6120,1,0,87,0,-87
6121,0,0,18,0,-18
6122,0,0,15,0,-15
6123,1,1,235,1673,1438
6124,1,1,386,1354,968
6125,0,0,25,0,-25
6126,0,0,53,0,-53
6127,0,0,8,0,-8
6128,1,1,121,1400,1279
6129,0,0,74,0,-74
6130,1,1,260,1837,1577
6131,1,0,0,0,0
6132,1,1,317,1716,1399
6133,0,0,26,0,-26
6134,1,0,11,0,-11
6135,1,0,8,0,-8
6136,0,0,39,0,-39
6137,1,0,38,0,-38
6138,0,0,0,0,0
6139,0,0,30,0,-30
6140,0,0,85,0,-85
6141,1,1,448,1296,848
6142,1,1,1975,1289,-686
6143,0,0,84,0,-84
6144,0,0,11,0,-11
6145,1,0,29,0,-29
6146,1,1,328,1300,972
6147,1,1,319,1247,928
6148,1,1,696,1309,613
6149,1,0,21,0,-21
6150,0,0,13,0,-13
6151,0,0,81,0,-81
6152,0,0,46,0,-46
6153,1,1,498,1280,782
6154,1,1,191,1547,1356
6155,0,0,108,0,-108
6156,1,0,146,0,-146
6157,0,0,19,0,-19
6158,1,0,30,0,-30
6159,0,0,47,0,-47
6160,0,0,41,0,-41
6161,0,0,28,0,-28
6162,0,0,82,0,-82
6163,0,0,66,0,-66
6164,1,0,15,0,-15
6165,1,1,2460,1636,-824
6166,0,0,17,0,-17
6167,0,0,66,0,-66
6168,1,0,17,0,-17
6169,0,0,7,0,-7
6170,1,1,971,2058,1087
6171,0,0,28,0,-28
6172,1,1,366,2141,1775
6173,0,0,70,0,-70
6174,0,0,77,0,-77
6175,0,0,8,0,-8
6176,1,1,369,2241,1872
6177,0,0,43,0,-43
6178,0,0,7,0,-7
6179,1,1,158,1672,1514
6180,1,0,2,0,-2
6181,1,0,119,0,-119
6182,0,0,10,0,-10
6183,0,0,27,0,-27
6184,1,1,2280,1415,-865
6185,1,0,170,0,-170
6186,0,0,18,0,-18
6187,0,0,33,0,-33
6188,1,0,2,0,-2
6189,1,0,6,0,-6
6190,1,1,956,1684,728
6191,0,0,54,0,-54
6192,0,0,66,0,-66
6193,0,0,18,0,-18
6194,1,0,111,0,-111
6195,1,0,7,0,-7
6196,0,0,24,0,-24
6197,0,0,112,0,-112
6198,1,1,393,1333,940
6199,1,1,358,1325,967
6200,0,0,48,0,-48
6201,1,0,50,0,-50
6202,1,1,199,1231,1032
6203,1,0,11,0,-11
6204,1,1,390,1304,914
6205,0,0,42,0,-42
6206,1,1,583,1303,720
6207,1,1,1115,1390,275
6208,1,0,3,0,-3
6209,0,0,18,0,-18
6210,1,0,5,0,-5
6211,1,0,24,0,-24
6212,0,0,17,0,-17
6213,0,0,7,0,-7
6214,0,0,5,0,-5
6215,0,0,185,0,-185
6216,1,0,12,0,-12
6217,0,0,149,0,-149
6218,0,0,26,0,-26
6219,0,0,38,0,-38
6220,0,0,10,0,-10
6221,0,0,10,0,-10
6222,1,1,666,1307,641
6223,0,0,170,0,-170
6224,1,0,44,0,-44
6225,1,1,310,1336,1026
6226,0,0,49,0,-49
6227,0,0,26,0,-26
6228,0,0,23,0,-23
6229,1,1,477,1678,1201
6230,1,0,45,0,-45
6231,0,0,10,0,-10
6232,1,0,1,0,-1
6233,0,0,54,0,-54
6234,1,0,1,0,-1
6235,1,0,68,0,-68
6236,1,1,1540,1595,55
6237,1,1,738,1283,545
6238,0,0,26,0,-26
6239,1,0,93,0,-93
6240,0,0,0,0,0
6241,0,0,42,0,-42
6242,1,0,120,0,-120
6243,1,1,425,1621,1196
6244,0,0,89,0,-89
6245,1,0,110,0,-110
6246,0,0,15,0,-15
6247,1,0,10,0,-10
6248,1,0,0,0,0
6249,1,1,125,1550,1425
6250,1,1,101,1391,1290
6251,0,0,40,0,-40
6252,1,0,68,0,-68
6253,1,1,279,3393,3114
6254,0,0,12,0,-12
6255,1,1,1670,2302,632
6256,1,0,39,0,-39
6257,1,0,51,0,-51
6258,0,0,13,0,-13
6259,0,0,6,0,-6
6260,0,0,24,0,-24
6261,1,0,105,0,-105
6262,1,0,11,0,-11
6263,1,1,135,1325,1190
6264,1,1,274,1228,954
6265,1,0,113,0,-113
6266,1,1,1481,1202,-279
6267,0,0,199,0,-199
6268,1,0,106,0,-106
6269,0,0,57,0,-57
6270,0,0,45,0,-45
6271,1,1,342,1668,1326
6272,1,1,969,1828,859
6273,0,0,59,0,-59
6274,1,0,5,0,-5
6275,0,0,39,0,-39
6276,0,0,136,0,-136
6277,0,0,92,0,-92
6278,1,1,839,2271,1432
6279,1,1,1735,1288,-447
6280,0,0,37,0,-37
6281,1,0,69,0,-69
6282,1,1,908,1981,1073
6283,1,0,8,0,-8
6284,0,0,39,0,-39
6285,1,1,512,1341,829
6286,0,0,137,0,-137
6287,0,0,32,0,-32
6288,1,1,97,2041,1944
6289,1,0,148,0,-148
6290,1,0,21,0,-21
6291,1,1,57,1519,1462
6292,0,0,3,0,-3
6293,1,1,664,1354,690
6294,1,1,63,1467,1404
6295,1,1,420,1333,913
6296,1,0,33,0,-33
6297,1,0,20,0,-20
6298,0,0,39,0,-39
6299,0,0,218,0,-218
6300,0,0,22,0,-22
6301,1,1,581,1729,1148
6302,1,0,12,0,-12
6303,1,0,37,0,-37
6304,0,0,29,0,-29
6305,1,1,1247,1319,72
6306,0,0,148,0,-148
6307,0,0,82,0,-82
6308,1,1,776,1399,623
6309,0,0,69,0,-69
6310,1,1,204,1206,1002
6311,0,0,24,0,-24
6312,1,1,531,1478,947
6313,0,0,244,0,-244
6314,0,0,116,0,-116
6315,0,0,63,0,-63
6316,1,1,105,1436,1331
6317,1,1,37,1331,1294
6318,1,0,82,0,-82
6319,1,0,26,0,-26
6320,1,0,69,0,-69
6321,1,0,65,0,-65
6322,0,0,118,0,-118
6323,1,0,36,0,-36
6324,0,0,15,0,-15
6325,0,0,43,0,-43
6326,0,0,17,0,-17
6327,0,0,141,0,-141
6328,1,1,991,1570,579
6329,1,0,75,0,-75
6330,1,0,57,0,-57
6331,1,1,489,1247,758
6332,0,0,14,0,-14
6333,0,0,52,0,-52
6334,1,0,16,0,-16
6335,1,0,124,0,-124
6336,1,1,606,1380,774
6337,1,0,4,0,-4
6338,0,0,62,0,-62
6339,0,0,34,0,-34
6340,1,1,653,1344,691
6341,1,0,8,0,-8
6342,0,0,104,0,-104
6343,0,0,38,0,-38
6344,1,0,50,0,-50
6345,1,0,7,0,-7
6346,1,0,37,0,-37
6347,1,1,44,1382,1338
6348,0,0,38,0,-38
6349,1,1,22,1203,1181
6350,1,1,135,2015,1880
6351,1,0,24,0,-24
6352,1,0,41,0,-41
6353,1,1,384,1534,1150
6354,0,0,28,0,-28
6355,0,0,51,0,-51
6356,1,0,10,0,-10
6357,1,0,63,0,-63
6358,1,1,37,1351,1314
6359,0,0,72,0,-72
6360,0,0,88,0,-88
6361,1,1,144,1366,1222
6362,0,0,30,0,-30
6363,0,0,137,0,-137
6364,0,0,76,0,-76
6365,0,0,3,0,-3
6366,0,0,7,0,-7
6367,1,1,181,1423,1242
6368,1,0,59,0,-59
6369,1,1,298,1652,1354
6370,1,1,558,1483,925
6371,1,1,114,1530,1416
6372,0,0,164,0,-164
6373,1,1,457,1290,833
6374,0,0,2,0,-2
6375,1,0,18,0,-18
6376,1,1,69,1650,1581
6377,0,0,15,0,-15
6378,1,0,19,0,-19
6379,0,0,90,0,-90
6380,1,1,1039,1348,309
6381,0,0,12,0,-12
6382,1,1,176,1613,1437
6383,1,0,156,0,-156
6384,0,0,50,0,-50
6385,1,1,12,1271,1259
6386,0,0,18,0,-18
6387,1,0,87,0,-87
6388,1,0,12,0,-12
6389,1,1,157,2176,2019
6390,0,0,5,0,-5
6391,1,1,648,1575,927
6392,0,0,137,0,-137
6393,0,0,22,0,-22
6394,1,0,5,0,-5
6395,1,1,1,1439,1438
6396,0,0,73,0,-73
6397,1,1,642,1217,575
6398,1,1,612,1501,889
6399,1,0,101,0,-101
6400,0,0,9,0,-9
6401,1,0,27,0,-27
6402,1,0,18,0,-18
6403,0,0,43,0,-43
6404,1,1,262,1306,1044
6405,0,0,91,0,-91
6406,1,0,57,0,-57
6407,1,0,76,0,-76
6408,1,0,28,0,-28
6409,1,0,67,0,-67
6410,1,1,842,1556,714
6411,0,0,99,0,-99
6412,0,0,12,0,-12
6413,0,0,5,0,-5
6414,0,0,18,0,-18
6415,1,0,31,0,-31
6416,0,0,24,0,-24
6417,0,0,69,0,-69
6418,1,0,2,0,-2
6419,0,0,9,0,-9
6420,1,1,69,1423,1354
6421,0,0,85,0,-85
6422,1,0,11,0,-11
6423,0,0,6,0,-6
6424,1,0,16,0,-16
6425,1,1,409,1934,1525
6426,1,1,1017,1243,226
6427,0,0,142,0,-142
6428,0,0,60,0,-60
6429,1,0,68,0,-68
6430,0,0,14,0,-14
6431,1,1,1012,1239,227
6432,1,0,86,0,-86
6433,1,1,548,1653,1105
6434,0,0,12,0,-12
6435,0,0,15,0,-15
6436,1,1,686,1813,1127
6437,0,0,123,0,-123
6438,0,0,294,0,-294
6439,0,0,31,0,-31
6440,0,0,27,0,-27
6441,0,0,64,0,-64
6442,1,0,25,0,-25
6443,1,1,1391,1234,-157
6444,0,0,63,0,-63
6445,0,0,24,0,-24
6446,1,1,2956,1352,-1604
6447,0,0,15,0,-15
6448,1,1,1721,2175,454
6449,0,0,9,0,-9
6450,1,0,29,0,-29
6451,1,0,89,0,-89
6452,1,0,94,0,-94
6453,1,1,808,1888,1080
6454,0,0,2,0,-2
6455,0,0,7,0,-7
6456,0,0,6,0,-6
6457,1,0,22,0,-22
6458,1,0,42,0,-42
6459,0,0,136,0,-136
6460,1,0,130,0,-130
6461,1,1,60,1303,1243
6462,1,0,49,0,-49
6463,0,0,2,0,-2
6464,0,0,34,0,-34
6465,1,0,40,0,-40
6466,0,0,87,0,-87
6467,1,1,379,1228,849
6468,1,1,97,1415,1318
6469,1,1,361,1392,1031
6470,1,1,186,2299,2113
6471,0,0,67,0,-67
6472,1,0,191,0,-191
6473,1,1,687,1312,625
6474,1,1,1007,2449,1442
6475,1,1,358,1325,967
6476,0,0,122,0,-122
6477,1,1,329,1645,1316
6478,0,0,0,0,0
6479,0,0,35,0,-35
6480,0,0,41,0,-41
6481,0,0,59,0,-59
6482,1,0,7,0,-7
6483,0,0,3,0,-3
6484,1,1,222,1520,1298
6485,1,0,12,0,-12
6486,1,1,1184,1218,34
6487,1,1,77,1218,1141
6488,1,0,67,0,-67
6489,0,0,5,0,-5
6490,1,0,11,0,-11
6491,1,0,18,0,-18
6492,0,0,28,0,-28
6493,0,0,32,0,-32
6494,0,0,156,0,-156
6495,1,1,764,1419,655
6496,1,1,419,1946,1527
6497,1,0,26,0,-26
6498,1,1,687,1389,702
6499,1,1,645,1557,912
6500,1,0,82,0,-82
6501,0,0,52,0,-52
6502,1,1,806,1298,492
6503,1,0,3,0,-3
6504,0,0,22,0,-22
6505,1,1,1079,1450,371
6506,1,0,41,0,-41
6507,1,1,2,1602,1600
6508,1,1,385,2111,1726
6509,0,0,4,0,-4
6510,1,1,348,1560,1212
6511,0,0,50,0,-50
6512,1,1,431,1374,943
6513,1,1,39,1753,1714
6514,1,0,24,0,-24
6515,1,0,14,0,-14
6516,0,0,50,0,-50
6517,0,0,67,0,-67
6518,1,0,3,0,-3
6519,0,0,68,0,-68
6520,1,1,28,1433,1405
6521,1,0,21,0,-21
6522,1,0,1,0,-1
6523,1,1,186,1386,1200
6524,1,1,156,3275,3119
6525,0,0,10,0,-10
6526,1,0,35,0,-35
6527,1,1,389,3085,2696
6528,0,0,3,0,-3
6529,1,0,2,0,-2
6530,1,0,42,0,-42
6531,1,0,36,0,-36
6532,1,1,1597,1215,-382
6533,1,1,96,1259,1163
6534,1,1,534,1872,1338
6535,1,0,3,0,-3
6536,0,0,100,0,-100
6537,1,0,34,0,-34
6538,0,0,18,0,-18
6539,0,0,79,0,-79
6540,1,0,4,0,-4
6541,1,1,283,2388,2105
6542,1,0,61,0,-61
6543,1,1,426,1212,786
6544,1,0,72,0,-72
6545,1,0,98,0,-98
6546,0,0,60,0,-60
6547,1,0,3,0,-3
6548,0,0,5,0,-5
6549,0,0,36,0,-36
6550,0,0,58,0,-58
6551,0,0,18,0,-18
6552,1,0,37,0,-37
6553,0,0,27,0,-27
6554,1,1,1034,1218,184
6555,1,1,49,1887,1838
6556,1,1,501,1248,747
6557,1,1,364,1320,956
6558,1,1,19,1329,1310
6559,0,0,20,0,-20
6560,1,1,853,1251,398
6561,1,0,34,0,-34
6562,0,0,66,0,-66
6563,1,1,838,1454,616
6564,0,0,6,0,-6
6565,0,0,94,0,-94
6566,1,0,76,0,-76
6567,0,0,83,0,-83
6568,1,0,67,0,-67
6569,0,0,135,0,-135
6570,1,1,531,1463,932
6571,0,0,25,0,-25
6572,1,0,51,0,-51
6573,0,0,55,0,-55
6574,1,1,124,1700,1576
6575,0,0,112,0,-112
6576,0,0,78,0,-78
6577,0,0,5,0,-5
6578,1,1,569,1335,766
6579,1,1,75,1357,1282
6580,0,0,2,0,-2
6581,1,1,327,1200,873
6582,1,0,24,0,-24
6583,0,0,195,0,-195
6584,1,0,7,0,-7
6585,1,1,163,1244,1081
6586,0,0,28,0,-28
6587,0,0,4,0,-4
6588,1,1,984,1472,488
6589,0,0,70,0,-70
6590,1,1,957,1266,309
6591,1,0,48,0,-48
6592,0,0,17,0,-17
6593,0,0,48,0,-48
6594,1,1,520,1737,1217
6595,1,1,865,2121,1256
6596,0,0,21,0,-21
6597,1,0,46,0,-46
6598,0,0,24,0,-24
6599,0,0,84,0,-84
6600,1,1,264,1206,942
6601,0,0,11,0,-11
6602,1,0,49,0,-49
6603,0,0,133,0,-133
6604,1,1,503,1547,1044
6605,1,1,367,1346,979
6606,0,0,9,0,-9
6607,0,0,17,0,-17
6608,1,0,35,0,-35
6609,0,0,14,0,-14
6610,1,0,59,0,-59
6611,0,0,34,0,-34
6612,0,0,83,0,-83
6613,0,0,26,0,-26
6614,1,0,6,0,-6
6615,1,1,567,1939,1372
6616,0,0,23,0,-23
6617,1,0,2,0,-2
6618,1,1,734,1264,530
6619,1,1,244,1421,1177
6620,1,1,241,1212,971
6621,1,1,1074,1609,535
6622,0,0,98,0,-98
6623,1,1,295,1848,1553
6624,1,1,112,1206,1094
6625,1,1,99,1678,1579
6626,1,1,129,1549,1420
6627,1,1,102,2997,2895
6628,0,0,83,0,-83
6629,0,0,46,0,-46
6630,1,1,340,1243,903
6631,1,1,427,1487,1060
6632,0,0,21,0,-21
6633,1,0,56,0,-56
6634,0,0,11,0,-11
6635,0,0,3,0,-3
6636,1,1,611,1626,1015
6637,1,0,67,0,-67
6638,1,0,17,0,-17
6639,1,0,92,0,-92
6640,0,0,53,0,-53
6641,1,1,276,1255,979
6642,0,0,200,0,-200
6643,1,0,55,0,-55
6644,1,0,26,0,-26
6645,1,1,284,1204,920
6646,1,0,16,0,-16
6647,0,0,64,0,-64
6648,0,0,51,0,-51
6649,0,0,8,0,-8
6650,1,0,16,0,-16
6651,0,0,8,0,-8
6652,1,1,438,2063,1625
6653,1,0,33,0,-33
6654,1,0,19,0,-19
6655,0,0,1,0,-1
6656,1,0,133,0,-133
6657,1,1,95,1460,1365
6658,0,0,134,0,-134
6659,0,0,237,0,-237
6660,1,1,133,1632,1499
6661,1,1,248,1279,1031
6662,1,1,396,2064,1668
6663,1,1,53,1440,1387
6664,1,1,1289,1337,48
6665,1,1,208,1312,1104
6666,1,1,521,1308,787
6667,1,1,54,1373,1319
6668,0,0,7,0,-7
6669,1,1,245,2088,1843
6670,1,1,753,1346,593
6671,0,0,5,0,-5
6672,1,1,611,1700,1089
6673,1,0,23,0,-23
6674,0,0,62,0,-62
6675,0,0,4,0,-4
6676,1,0,19,0,-19
6677,1,1,64,1232,1168
6678,1,1,670,1835,1165
6679,0,0,4,0,-4
6680,1,0,75,0,-75
6681,1,0,2,0,-2
6682,1,0,14,0,-14
6683,1,1,231,1352,1121
6684,0,0,84,0,-84
6685,1,1,2145,1970,-175
6686,0,0,54,0,-54
6687,0,0,143,0,-143
6688,1,0,6,0,-6
6689,1,0,36,0,-36
6690,1,1,1574,1535,-39
6691,0,0,95,0,-95
6692,1,0,94,0,-94
6693,1,1,549,1680,1131
6694,1,0,8,0,-8
6695,0,0,18,0,-18
6696,1,1,871,1423,552
6697,1,1,463,3004,2541
6698,1,0,52,0,-52
6699,1,1,397,2347,1950
6700,0,0,15,0,-15
6701,1,0,20,0,-20
6702,1,0,48,0,-48
6703,1,1,31,1302,1271
6704,1,0,6,0,-6
6705,1,1,1043,1469,426
6706,1,0,17,0,-17
6707,1,0,10,0,-10
6708,1,1,508,1242,734
6709,0,0,17,0,-17
6710,0,0,31,0,-31
6711,1,0,51,0,-51
6712,0,0,24,0,-24
6713,1,0,49,0,-49
6714,1,1,584,1420,836
6715,1,1,104,1455,1351
6716,0,0,77,0,-77
6717,1,1,1818,1571,-247
6718,0,0,20,0,-20
6719,0,0,12,0,-12
6720,1,0,5,0,-5
6721,0,0,31,0,-31
6722,1,0,14,0,-14
6723,1,0,73,0,-73
6724,0,0,20,0,-20
6725,0,0,6,0,-6
6726,1,1,452,4224,3772
6727,1,1,1532,1221,-311
6728,1,1,582,1204,622
6729,1,1,159,1218,1059
6730,0,0,9,0,-9
6731,1,1,186,2225,2039
6732,0,0,148,0,-148
6733,1,0,40,0,-40
6734,0,0,38,0,-38
6735,1,1,264,1322,1058
6736,0,0,14,0,-14
6737,1,1,545,1238,693
6738,0,0,49,0,-49
6739,1,1,3064,1465,-1599
6740,1,1,499,1369,870
6741,1,0,0,0,0
6742,0,0,4,0,-4
6743,1,0,73,0,-73
6744,1,0,2,0,-2
6745,0,0,62,0,-62
6746,0,0,47,0,-47
6747,1,0,6,0,-6
6748,1,1,109,1444,1335
6749,1,1,1457,1252,-205
6750,1,1,3,1498,1495
6751,1,0,7,0,-7
6752,1,0,12,0,-12
6753,0,0,13,0,-13
6754,1,0,53,0,-53
6755,0,0,31,0,-31
6756,0,0,167,0,-167
6757,1,0,9,0,-9
6758,1,0,26,0,-26
6759,1,1,255,1278,1023
6760,1,1,517,1306,789
6761,1,0,25,0,-25
6762,0,0,49,0,-49
6763,0,0,229,0,-229
6764,1,1,661,1321,660
6765,1,0,107,0,-107
6766,1,0,21,0,-21
6767,0,0,101,0,-101
6768,1,1,657,1377,720
6769,0,0,59,0,-59
6770,0,0,145,0,-145
6771,1,0,103,0,-103
6772,1,0,78,0,-78
6773,0,0,18,0,-18
6774,0,0,69,0,-69
6775,0,0,110,0,-110
6776,1,0,19,0,-19
6777,1,1,244,1676,1432
6778,0,0,85,0,-85
6779,1,0,10,0,-10
6780,0,0,98,0,-98
6781,1,1,265,1702,1437
6782,0,0,76,0,-76
6783,1,0,11,0,-11
6784,1,1,155,1245,1090
6785,1,0,36,0,-36
6786,1,0,0,0,0
6787,0,0,50,0,-50
6788,1,1,197,1350,1153
6789,1,1,325,1425,1100
6790,1,0,38,0,-38
6791,1,1,245,1214,969
6792,0,0,23,0,-23
6793,1,1,127,1547,1420
6794,0,0,62,0,-62
6795,1,1,154,1242,1088
6796,1,0,38,0,-38
6797,0,0,72,0,-72
6798,1,1,453,1892,1439
6799,1,0,54,0,-54
6800,0,0,12,0,-12
6801,0,0,3,0,-3
6802,0,0,99,0,-99
6803,0,0,3,0,-3
6804,1,0,43,0,-43
6805,0,0,28,0,-28
6806,0,0,20,0,-20
6807,1,0,38,0,-38
6808,1,0,7,0,-7
6809,1,0,3,0,-3
6810,1,1,373,1427,1054
6811,1,1,519,2576,2057
6812,1,0,14,0,-14
6813,0,0,21,0,-21
6814,0,0,18,0,-18
6815,1,0,52,0,-52
6816,0,0,4,0,-4
6817,0,0,2,0,-2
6818,0,0,75,0,-75
6819,1,0,32,0,-32
6820,0,0,10,0,-10
6821,1,0,35,0,-35
6822,0,0,2,0,-2
6823,1,1,1732,1380,-352
6824,1,1,378,3353,2975
6825,0,0,59,0,-59
6826,0,0,173,0,-173
6827,1,0,15,0,-15
6828,1,1,535,1205,670
6829,1,0,36,0,-36
6830,1,1,366,1623,1257
6831,0,0,81,0,-81
6832,1,0,5,0,-5
6833,1,0,60,0,-60
6834,0,0,68,0,-68
6835,1,0,102,0,-102
6836,0,0,54,0,-54
6837,1,0,8,0,-8
6838,1,0,35,0,-35
6839,0,0,35,0,-35
6840,1,0,40,0,-40
6841,1,1,456,2308,1852
6842,1,1,26,1236,1210
6843,1,1,742,1257,515
6844,0,0,147,0,-147
6845,0,0,70,0,-70
6846,1,1,496,1292,796
6847,0,0,110,0,-110
6848,0,0,23,0,-23
6849,0,0,31,0,-31
6850,1,1,157,1458,1301
6851,1,0,60,0,-60
6852,0,0,20,0,-20
6853,0,0,200,0,-200
6854,0,0,20,0,-20
6855,1,0,18,0,-18
6856,0,0,84,0,-84
6857,0,0,105,0,-105
6858,0,0,12,0,-12
6859,1,0,107,0,-107
6860,0,0,63,0,-63
6861,1,0,43,0,-43
6862,1,0,25,0,-25
6863,0,0,31,0,-31
6864,1,0,52,0,-52
6865,1,0,50,0,-50
6866,1,1,1697,1430,-267
6867,0,0,33,0,-33
6868,1,1,182,1986,1804
6869,1,1,737,1275,538
6870,0,0,111,0,-111
6871,0,0,27,0,-27
6872,1,1,205,1804,1599
6873,1,0,32,0,-32
6874,1,0,3,0,-3
6875,1,1,182,2199,2017
6876,1,1,885,1231,346
6877,1,1,239,1861,1622
6878,0,0,20,0,-20
6879,0,0,14,0,-14
6880,0,0,30,0,-30
6881,0,0,151,0,-151
6882,1,0,48,0,-48
6883,1,1,909,1563,654
6884,1,0,77,0,-77
6885,1,0,31,0,-31
6886,0,0,13,0,-13
6887,1,0,23,0,-23
6888,1,1,192,1381,1189
6889,1,1,93,1602,1509
6890,1,1,406,1245,839
6891,0,0,9,0,-9
6892,0,0,2,0,-2
6893,0,0,18,0,-18
6894,0,0,2,0,-2
6895,0,0,96,0,-96
6896,1,1,3735,2134,-1601
6897,1,0,69,0,-69
6898,1,1,733,2518,1785
6899,0,0,6,0,-6
6900,1,0,10,0,-10
6901,1,0,47,0,-47
6902,1,1,646,1959,1313
6903,0,0,88,0,-88
6904,0,0,74,0,-74
6905,1,0,87,0,-87
6906,1,1,243,2165,1922
6907,1,0,35,0,-35
6908,1,1,170,1371,1201
6909,1,1,179,1473,1294
6910,1,0,67,0,-67
6911,0,0,5,0,-5
6912,1,0,199,0,-199
6913,1,0,21,0,-21
6914,0,0,11,0,-11
6915,1,1,625,1333,708
6916,0,0,47,0,-47
6917,1,0,136,0,-136
6918,1,0,131,0,-131
6919,0,0,24,0,-24
6920,1,1,58,1565,1507
6921,1,0,8,0,-8
6922,0,0,22,0,-22
6923,1,1,295,1343,1048
6924,0,0,36,0,-36
6925,1,0,74,0,-74
6926,1,1,1158,3403,2245
6927,1,1,84,1299,1215
6928,1,0,1,0,-1
6929,1,0,63,0,-63
6930,1,0,2,0,-2
6931,1,0,69,0,-69
6932,1,1,237,1515,1278
6933,1,0,100,0,-100
6934,0,0,27,0,-27
6935,1,1,500,1313,813
6936,0,0,19,0,-19
6937,0,0,23,0,-23
6938,1,0,2,0,-2
6939,1,0,145,0,-145
6940,0,0,127,0,-127
6941,0,0,109,0,-109
6942,0,0,18,0,-18
6943,0,0,15,0,-15
6944,0,0,18,0,-18
6945,0,0,72,0,-72
6946,0,0,28,0,-28
6947,1,0,21,0,-21
6948,0,0,54,0,-54
6949,1,0,7,0,-7
6950,0,0,31,0,-31
6951,1,0,19,0,-19
6952,0,0,28,0,-28
6953,0,0,149,0,-149
6954,1,0,121,0,-121
6955,1,1,680,1686,1006
6956,0,0,16,0,-16
6957,0,0,87,0,-87
6958,1,1,1592,3135,1543
6959,1,0,136,0,-136
6960,0,0,25,0,-25
6961,1,0,37,0,-37
6962,0,0,63,0,-63
6963,1,1,289,1329,1040
6964,1,1,716,1904,1188
6965,1,1,691,1226,535
6966,0,0,23,0,-23
6967,0,0,1,0,-1
6968,0,0,85,0,-85
6969,1,1,114,1801,1687
6970,1,1,518,1516,998
6971,1,0,23,0,-23
6972,1,0,18,0,-18
6973,0,0,67,0,-67
6974,0,0,81,0,-81
6975,0,0,31,0,-31
6976,1,0,33,0,-33
6977,1,0,42,0,-42
6978,0,0,6,0,-6
6979,0,0,19,0,-19
6980,0,0,71,0,-71
6981,0,0,27,0,-27
6982,1,0,175,0,-175
6983,1,0,13,0,-13
6984,0,0,223,0,-223
6985,0,0,62,0,-62
6986,1,1,663,1462,799
6987,0,0,16,0,-16
6988,1,1,546,1235,689
6989,0,0,3,0,-3
6990,0,0,78,0,-78
6991,0,0,0,0,0
6992,1,1,267,1239,972
6993,0,0,48,0,-48
6994,0,0,17,0,-17
6995,1,0,31,0,-31
6996,1,1,235,1445,1210
6997,1,0,41,0,-41
6998,1,0,11,0,-11
6999,1,1,183,1427,1244
7000,0,0,28,0,-28
7001,0,0,41,0,-41
7002,1,1,717,1385,668
7003,1,0,30,0,-30
7004,0,0,36,0,-36
7005,0,0,20,0,-20
7006,1,1,1217,1651,434
7007,0,0,30,0,-30
7008,0,0,0,0,0
7009,1,1,2201,1335,-866
7010,1,1,638,1212,574
7011,1,0,8,0,-8
7012,0,0,16,0,-16
7013,0,0,3,0,-3
7014,0,0,0,0,0
7015,1,1,680,1424,744
7016,1,1,96,1802,1706
7017,1,0,1,0,-1
7018,1,0,64,0,-64
7019,1,1,652,1500,848
7020,0,0,57,0,-57
7021,0,0,42,0,-42
7022,1,1,178,1261,1083
7023,1,1,866,1593,727
7024,1,1,568,1563,995
7025,0,0,68,0,-68
7026,0,0,154,0,-154
7027,0,0,2,0,-2
7028,1,0,24,0,-24
7029,0,0,127,0,-127
7030,1,1,628,1477,849
7031,1,1,1145,1512,367
7032,1,1,351,1360,1009
7033,0,0,2,0,-2
7034,0,0,31,0,-31
7035,0,0,51,0,-51
7036,1,0,11,0,-11
7037,1,1,654,1302,648
7038,0,0,83,0,-83
7039,1,1,100,1537,1437
7040,1,0,43,0,-43
7041,1,1,469,1256,787
7042,0,0,1,0,-1
7043,0,0,16,0,-16
7044,0,0,19,0,-19
7045,1,1,174,5889,5715
7046,1,0,43,0,-43
7047,1,0,5,0,-5
7048,0,0,7,0,-7
7049,1,1,575,1414,839
7050,0,0,44,0,-44
7051,0,0,0,0,0
7052,1,1,38,1509,1471
7053,1,1,815,1496,681
7054,1,1,480,1365,885
7055,1,1,705,1571,866
7056,0,0,33,0,-33
7057,1,1,565,1531,966
7058,0,0,53,0,-53
7059,1,0,35,0,-35
7060,1,0,50,0,-50
7061,1,1,275,1371,1096
7062,0,0,47,0,-47
7063,0,0,26,0,-26
7064,1,0,215,0,-215
7065,0,0,15,0,-15
7066,0,0,105,0,-105
7067,1,0,14,0,-14
7068,1,0,29,0,-29
7069,1,1,480,2105,1625
7070,1,0,7,0,-7
7071,0,0,26,0,-26
7072,1,0,7,0,-7
7073,0,0,56,0,-56
7074,0,0,26,0,-26
7075,1,0,2,0,-2
7076,0,0,62,0,-62
7077,1,1,55,2695,2640
7078,1,1,1620,1281,-339
7079,1,1,2660,3763,1103
7080,1,1,39,2336,2297
7081,1,0,18,0,-18
7082,0,0,120,0,-120
7083,1,0,59,0,-59
7084,0,0,91,0,-91
7085,0,0,39,0,-39
7086,1,0,8,0,-8
7087,1,1,481,1213,732
7088,1,1,1312,1347,35
7089,1,0,9,0,-9
7090,1,1,299,1780,1481
7091,1,0,9,0,-9
7092,1,0,29,0,-29
7093,0,0,11,0,-11
7094,0,0,62,0,-62
7095,0,0,220,0,-220
7096,1,0,24,0,-24
7097,1,1,1129,2530,1401
7098,0,0,79,0,-79
7099,0,0,44,0,-44
7100,1,1,407,1334,927
7101,0,0,20,0,-20
7102,0,0,54,0,-54
7103,1,1,190,1397,1207
7104,1,0,27,0,-27
7105,1,1,70,1393,1323
7106,0,0,68,0,-68
7107,0,0,0,0,0
7108,1,0,49,0,-49
7109,1,1,751,1216,465
7110,0,0,65,0,-65
7111,1,0,7,0,-7
7112,0,0,57,0,-57
7113,1,0,28,0,-28
7114,1,0,1,0,-1
7115,0,0,95,0,-95
7116,0,0,70,0,-70
7117,0,0,11,0,-11
7118,1,0,9,0,-9
7119,1,1,296,2179,1883
7120,1,0,174,0,-174
7121,1,0,64,0,-64
7122,1,1,397,1575,1178
7123,0,0,134,0,-134
7124,1,0,13,0,-13
7125,0,0,60,0,-60
7126,1,1,45,1665,1620
7127,1,1,1479,1235,-244
7128,1,1,374,2641,2267
7129,0,0,15,0,-15
7130,1,1,98,1588,1490
7131,1,1,944,1352,408
7132,0,0,27,0,-27
7133,0,0,18,0,-18
7134,0,0,3,0,-3
7135,0,0,47,0,-47
7136,1,0,54,0,-54
7137,1,1,272,1224,952
7138,1,0,17,0,-17
7139,1,0,55,0,-55
7140,1,1,131,1556,1425
7141,1,0,7,0,-7
7142,1,0,65,0,-65
7143,1,0,65,0,-65
7144,0,0,93,0,-93
7145,1,0,31,0,-31
7146,1,0,76,0,-76
7147,0,0,68,0,-68
7148,1,1,525,1931,1406
7149,0,0,15,0,-15
7150,1,1,309,1845,1536
7151,0,0,117,0,-117
7152,1,1,52,1452,1400
7153,0,0,35,0,-35
7154,0,0,87,0,-87
7155,0,0,116,0,-116
7156,1,1,314,1213,899
7157,1,0,39,0,-39
7158,1,0,49,0,-49
7159,0,0,35,0,-35
7160,1,1,1282,1260,-22
7161,1,1,1529,1991,462
7162,1,0,6,0,-6
7163,0,0,0,0,0
7164,0,0,65,0,-65
7165,0,0,6,0,-6
7166,0,0,127,0,-127
7167,0,0,82,0,-82
7168,1,0,11,0,-11
7169,1,1,114,1380,1266
7170,1,0,54,0,-54
7171,0,0,17,0,-17
7172,0,0,58,0,-58
7173,1,0,55,0,-55
7174,0,0,3,0,-3
7175,0,0,17,0,-17
7176,0,0,75,0,-75
7177,0,0,26,0,-26
7178,0,0,18,0,-18
7179,1,1,349,1552,1203
7180,1,1,61,1306,1245
7181,1,1,318,1431,1113
7182,0,0,6,0,-6
7183,1,0,14,0,-14
7184,1,0,58,0,-58
7185,0,0,116,0,-116
7186,0,0,74,0,-74
7187,0,0,74,0,-74
7188,0,0,17,0,-17
7189,0,0,88,0,-88
7190,0,0,17,0,-17
7191,1,0,70,0,-70
7192,0,0,115,0,-115
7193,1,1,711,1467,756
7194,1,0,41,0,-41
7195,0,0,17,0,-17
7196,1,1,749,1270,521
7197,1,0,13,0,-13
7198,0,0,73,0,-73
7199,1,1,1546,1866,320
7200,0,0,70,0,-70
7201,1,1,434,1220,786
7202,1,0,21,0,-21
7203,1,1,647,1288,641
7204,0,0,64,0,-64
7205,1,0,46,0,-46
7206,1,0,4,0,-4
7207,1,0,46,0,-46
7208,0,0,4,0,-4
7209,0,0,72,0,-72
7210,0,0,3,0,-3
7211,0,0,64,0,-64
7212,1,0,60,0,-60
7213,1,1,1927,1217,-710
7214,1,1,585,1205,620
7215,1,0,10,0,-10
7216,1,1,456,1428,972
7217,1,0,27,0,-27
7218,0,0,7,0,-7
7219,0,0,17,0,-17
7220,0,0,38,0,-38
7221,0,0,22,0,-22
7222,0,0,10,0,-10
7223,1,0,18,0,-18
7224,0,0,248,0,-248
7225,1,1,234,1267,1033
7226,1,1,937,1203,266
7227,1,0,7,0,-7
7228,1,1,670,1865,1195
7229,1,1,694,1509,815
7230,1,1,816,1572,756
7231,1,1,22,1541,1519
7232,0,0,10,0,-10
7233,0,0,3,0,-3
7234,0,0,30,0,-30
7235,1,1,59,1495,1436
7236,1,0,17,0,-17
7237,1,1,282,1305,1023
7238,1,0,57,0,-57
7239,0,0,22,0,-22
7240,1,0,107,0,-107
7241,0,0,61,0,-61
7242,1,1,33,1575,1542
7243,1,1,424,1353,929
7244,0,0,77,0,-77
7245,0,0,30,0,-30
7246,0,0,122,0,-122
7247,1,1,745,1562,817
7248,1,1,157,1526,1369
7249,0,0,25,0,-25
7250,0,0,0,0,0
7251,0,0,20,0,-20
7252,0,0,119,0,-119
7253,1,1,1789,1720,-69
7254,1,1,2633,1457,-1176
7255,0,0,22,0,-22
7256,1,0,53,0,-53
7257,0,0,33,0,-33
7258,0,0,98,0,-98
7259,1,1,882,2216,1334
7260,0,0,26,0,-26
7261,1,1,1523,3202,1679
7262,1,0,199,0,-199
7263,1,0,232,0,-232
7264,0,0,130,0,-130
7265,1,0,55,0,-55
7266,1,0,31,0,-31
7267,1,0,116,0,-116
7268,0,0,13,0,-13
7269,0,0,6,0,-6
7270,1,0,100,0,-100
7271,0,0,231,0,-231
7272,1,1,1005,1281,276
7273,0,0,40,0,-40
7274,0,0,10,0,-10
7275,1,1,326,1594,1268
7276,1,1,1009,1427,418
7277,1,0,32,0,-32
7278,1,1,21,4392,4371
7279,0,0,14,0,-14
7280,0,0,81,0,-81
7281,1,0,72,0,-72
7282,1,0,139,0,-139
7283,1,1,89,1535,1446
7284,1,1,21,1312,1291
7285,1,1,354,1461,1107
7286,0,0,38,0,-38
7287,1,1,231,1706,1475
7288,0,0,10,0,-10
7289,0,0,65,0,-65
7290,1,0,7,0,-7
7291,0,0,74,0,-74
7292,0,0,119,0,-119
7293,0,0,60,0,-60
7294,0,0,50,0,-50
7295,0,0,22,0,-22
7296,1,1,302,2023,1721
7297,0,0,11,0,-11
7298,0,0,246,0,-246
7299,1,1,888,1305,417
7300,1,1,200,1474,1274
7301,0,0,20,0,-20
7302,0,0,89,0,-89
7303,1,1,150,1750,1600
7304,1,0,129,0,-129
7305,1,0,20,0,-20
7306,1,1,619,2620,2001
7307,0,0,67,0,-67
7308,1,1,301,1615,1314
7309,1,1,62,1278,1216
7310,0,0,25,0,-25
7311,1,1,78,1545,1467
7312,0,0,23,0,-23
7313,0,0,14,0,-14
7314,0,0,63,0,-63
7315,1,1,94,1237,1143
7316,1,0,27,0,-27
7317,1,0,6,0,-6
7318,1,1,213,1502,1289
7319,1,0,1,0,-1
7320,0,0,12,0,-12
7321,0,0,15,0,-15
7322,1,0,208,0,-208
7323,1,1,474,1269,795
7324,0,0,72,0,-72
7325,1,1,1344,1204,-140
7326,1,0,25,0,-25
7327,0,0,150,0,-150
7328,1,0,214,0,-214
7329,0,0,24,0,-24
7330,0,0,135,0,-135
7331,1,0,31,0,-31
7332,1,0,57,0,-57
7333,1,1,712,1248,536
7334,0,0,25,0,-25
7335,0,0,28,0,-28
7336,1,1,234,1484,1250
7337,1,1,35,3310,3275
7338,0,0,185,0,-185
7339,1,1,265,1214,949
7340,0,0,1,0,-1
7341,1,0,13,0,-13
7342,1,1,1378,1573,195
7343,0,0,16,0,-16
7344,1,1,1770,1407,-363
7345,0,0,84,0,-84
7346,1,0,109,0,-109
7347,0,0,4,0,-4
7348,0,0,13,0,-13
7349,1,0,49,0,-49
7350,1,1,158,1242,1084
7351,0,0,27,0,-27
7352,0,0,10,0,-10
7353,1,0,36,0,-36
7354,0,0,21,0,-21
7355,0,0,25,0,-25
7356,1,0,13,0,-13
7357,0,0,49,0,-49
7358,0,0,2,0,-2
7359,1,0,92,0,-92
7360,0,0,33,0,-33
7361,1,1,226,1262,1036
7362,1,0,38,0,-38
7363,1,0,1,0,-1
7364,1,0,0,0,0
7365,1,1,603,1880,1277
7366,1,0,22,0,-22
7367,0,0,10,0,-10
7368,1,1,862,1404,542
7369,0,0,19,0,-19
7370,0,0,84,0,-84
7371,0,0,25,0,-25
7372,1,1,317,1480,1163
7373,0,0,48,0,-48
7374,0,0,13,0,-13
7375,1,1,313,1602,1289
7376,1,1,1165,1716,551
7377,1,1,131,1312,1181
7378,1,1,111,1490,1379
7379,1,0,108,0,-108
7380,0,0,133,0,-133
7381,1,0,6,0,-6
7382,1,1,1042,3179,2137
7383,1,0,12,0,-12
7384,1,1,450,1401,951
7385,0,0,62,0,-62
7386,0,0,3,0,-3
7387,1,0,89,0,-89
7388,1,1,292,1296,1004
7389,1,0,49,0,-49
7390,1,0,103,0,-103
7391,1,1,772,1341,569
7392,1,1,62,1245,1183
7393,0,0,37,0,-37
7394,1,1,979,1399,420
7395,1,1,241,1267,1026
7396,0,0,46,0,-46
7397,0,0,29,0,-29
7398,1,1,630,1427,797
7399,1,0,47,0,-47
7400,0,0,2,0,-2
7401,0,0,12,0,-12
7402,1,1,807,1781,974
7403,1,0,92,0,-92
7404,1,0,21,0,-21
7405,1,0,85,0,-85
7406,0,0,26,0,-26
7407,0,0,6,0,-6
7408,0,0,60,0,-60
7409,1,0,40,0,-40
7410,1,1,697,2556,1859
7411,1,0,37,0,-37
7412,1,0,1,0,-1
7413,1,0,33,0,-33
7414,0,0,60,0,-60
7415,1,1,132,1376,1244
7416,1,1,116,1265,1149
7417,0,0,52,0,-52
7418,1,0,5,0,-5
7419,1,1,131,1524,1393
7420,0,0,36,0,-36
7421,1,0,16,0,-16
7422,0,0,20,0,-20
7423,1,0,65,0,-65
7424,1,0,32,0,-32
7425,1,0,1,0,-1
7426,1,0,32,0,-32
7427,1,0,5,0,-5
7428,1,0,21,0,-21
7429,1,0,54,0,-54
7430,1,1,391,1466,1075
7431,0,0,30,0,-30
7432,1,1,1113,1426,313
7433,1,1,532,1200,668
7434,0,0,46,0,-46
7435,0,0,10,0,-10
7436,1,1,806,2284,1478
7437,0,0,60,0,-60
7438,1,0,28,0,-28
7439,1,0,42,0,-42
7440,1,1,1314,1799,485
7441,1,1,162,1946,1784
7442,1,0,9,0,-9
7443,0,0,1,0,-1
7444,1,1,603,1259,656
7445,0,0,35,0,-35
7446,1,1,484,1720,1236
7447,1,1,435,1429,994
7448,0,0,60,0,-60
7449,0,0,9,0,-9
7450,1,0,3,0,-3
7451,1,1,948,1233,285
7452,1,0,26,0,-26
7453,1,1,379,1235,856
7454,1,1,206,1244,1038
7455,1,0,101,0,-101
7456,0,0,11,0,-11
7457,1,1,483,2929,2446
7458,0,0,58,0,-58
7459,0,0,3,0,-3
7460,0,0,0,0,0
7461,1,1,169,1640,1471
7462,1,0,26,0,-26
7463,1,0,17,0,-17
7464,0,0,60,0,-60
7465,0,0,107,0,-107
7466,1,1,1509,1491,-18
7467,0,0,125,0,-125
7468,1,1,627,1560,933
7469,0,0,29,0,-29
7470,1,0,27,0,-27
7471,0,0,2,0,-2
7472,1,1,153,2650,2497
7473,0,0,109,0,-109
7474,1,0,5,0,-5
7475,1,1,1484,1293,-191
7476,0,0,56,0,-56
7477,0,0,27,0,-27
7478,1,0,107,0,-107
7479,1,0,80,0,-80
7480,1,1,713,2494,1781
7481,0,0,80,0,-80
7482,0,0,20,0,-20
7483,0,0,45,0,-45
7484,1,0,54,0,-54
7485,1,0,78,0,-78
7486,0,0,53,0,-53
7487,1,0,123,0,-123
7488,0,0,120,0,-120
7489,1,1,168,1343,1175
7490,1,1,158,2023,1865
7491,1,0,179,0,-179
7492,1,1,563,2021,1458
7493,0,0,336,0,-336
7494,0,0,142,0,-142
7495,0,0,100,0,-100
7496,0,0,10,0,-10
7497,0,0,19,0,-19
7498,0,0,71,0,-71
7499,1,0,59,0,-59
7500,0,0,54,0,-54
7501,0,0,21,0,-21
7502,1,1,504,1217,713
7503,0,0,48,0,-48
7504,1,0,27,0,-27
7505,1,1,652,1278,626
7506,0,0,4,0,-4
7507,1,0,3,0,-3
7508,0,0,54,0,-54
7509,1,0,45,0,-45
7510,1,0,35,0,-35
7511,1,0,34,0,-34
7512,0,0,16,0,-16
7513,1,1,410,1726,1316
7514,0,0,34,0,-34
7515,1,1,165,1213,1048
7516,0,0,12,0,-12
7517,0,0,20,0,-20
7518,1,1,465,1209,744
7519,0,0,26,0,-26
7520,1,0,14,0,-14
7521,0,0,6,0,-6
7522,1,0,6,0,-6
7523,1,0,14,0,-14
7524,1,1,2686,1328,-1358
7525,1,0,24,0,-24
7526,0,0,3,0,-3
7527,0,0,39,0,-39
7528,1,0,125,0,-125
7529,1,1,422,1472,1050
7530,1,0,57,0,-57
7531,0,0,44,0,-44
7532,1,1,123,1473,1350
7533,1,0,2,0,-2
7534,1,0,65,0,-65
7535,0,0,14,0,-14
7536,0,0,7,0,-7
7537,1,1,277,1758,1481
7538,1,0,4,0,-4
7539,0,0,103,0,-103
7540,0,0,9,0,-9
7541,1,1,886,1402,516
7542,0,0,76,0,-76
7543,1,0,63,0,-63
7544,1,0,244,0,-244
7545,0,0,1,0,-1
7546,0,0,65,0,-65
7547,1,1,493,1390,897
7548,1,1,2357,1601,-756
7549,0,0,34,0,-34
7550,1,1,435,1450,1015
7551,1,0,276,0,-276
7552,1,0,102,0,-102
7553,1,1,86,1206,1120
7554,1,1,658,1603,945
7555,0,0,28,0,-28
7556,1,1,582,1433,851
7557,1,0,18,0,-18
7558,0,0,33,0,-33
7559,0,0,1,0,-1
7560,1,1,262,2481,2219
7561,1,0,19,0,-19
7562,1,1,551,1242,691
7563,1,0,16,0,-16
7564,1,0,117,0,-117
7565,0,0,49,0,-49
7566,1,1,83,3249,3166
7567,0,0,82,0,-82
7568,0,0,7,0,-7
7569,1,0,109,0,-109
7570,0,0,52,0,-52
7571,0,0,74,0,-74
7572,1,1,1305,3790,2485
7573,0,0,26,0,-26
7574,0,0,1,0,-1
7575,0,0,73,0,-73
7576,1,1,540,1718,1178
7577,1,1,532,1660,1128
7578,1,0,57,0,-57
7579,1,0,6,0,-6
7580,1,1,1013,1225,212
7581,1,0,12,0,-12
7582,1,0,1,0,-1
7583,1,1,523,1297,774
7584,0,0,23,0,-23
7585,1,1,112,1446,1334
7586,1,1,337,1532,1195
7587,1,0,20,0,-20
7588,0,0,26,0,-26
7589,0,0,100,0,-100
7590,0,0,34,0,-34
7591,0,0,135,0,-135
7592,1,1,666,1995,1329
7593,0,0,23,0,-23
7594,1,0,6,0,-6
7595,1,0,33,0,-33
7596,1,0,7,0,-7
7597,1,1,322,1441,1119
7598,1,1,260,1409,1149
7599,1,0,14,0,-14
7600,1,1,203,1203,1000
7601,1,0,44,0,-44
7602,0,0,9,0,-9
7603,0,0,41,0,-41
7604,1,0,65,0,-65
7605,1,1,137,1304,1167
7606,0,0,25,0,-25
7607,1,0,0,0,0
7608,0,0,71,0,-71
7609,0,0,59,0,-59
7610,1,0,1,0,-1
7611,1,0,38,0,-38
7612,1,0,88,0,-88
7613,1,0,51,0,-51
7614,1,0,146,0,-146
7615,0,0,69,0,-69
7616,0,0,24,0,-24
7617,0,0,119,0,-119
7618,1,0,105,0,-105
7619,0,0,36,0,-36
7620,1,0,144,0,-144
7621,1,0,57,0,-57
7622,0,0,82,0,-82
7623,0,0,6,0,-6
7624,0,0,13,0,-13
7625,1,1,617,1354,737
7626,1,0,24,0,-24
7627,1,1,358,1364,1006
7628,1,1,163,1312,1149
7629,1,0,44,0,-44
7630,0,0,58,0,-58
7631,0,0,15,0,-15
7632,0,0,16,0,-16
7633,1,0,39,0,-39
7634,1,0,175,0,-175
7635,1,0,3,0,-3
7636,1,0,47,0,-47
7637,0,0,0,0,0
7638,0,0,41,0,-41
7639,1,1,708,1232,524
7640,1,1,581,1316,735
7641,1,0,6,0,-6
7642,1,0,53,0,-53
7643,0,0,29,0,-29
7644,1,0,74,0,-74
7645,1,0,30,0,-30
7646,0,0,26,0,-26
7647,1,1,519,2861,2342
7648,0,0,27,0,-27
7649,0,0,66,0,-66
7650,1,0,2,0,-2
7651,1,0,19,0,-19
7652,1,1,494,1235,741
7653,1,0,33,0,-33
7654,0,0,17,0,-17
7655,1,1,445,1336,891
7656,1,0,27,0,-27
7657,1,1,85,1584,1499
7658,1,1,323,1227,904
7659,0,0,194,0,-194
7660,0,0,38,0,-38
7661,1,0,48,0,-48
7662,0,0,35,0,-35
7663,0,0,15,0,-15
7664,1,1,1022,1258,236
7665,1,1,517,1459,942
7666,1,0,20,0,-20
7667,1,0,134,0,-134
7668,1,0,226,0,-226
7669,1,1,2184,1228,-956
7670,1,0,65,0,-65
7671,1,1,778,1289,511
7672,0,0,5,0,-5
7673,1,0,11,0,-11
7674,1,1,237,1425,1188
7675,1,0,44,0,-44
7676,0,0,25,0,-25
7677,1,1,190,2650,2460
7678,1,0,35,0,-35
7679,1,0,3,0,-3
7680,1,0,35,0,-35
7681,1,1,1663,2024,361
7682,0,0,60,0,-60
7683,1,0,16,0,-16
7684,1,1,472,1592,1120
7685,1,1,692,1238,546
7686,1,0,110,0,-110
7687,0,0,106,0,-106
7688,1,1,1419,1306,-113
7689,0,0,10,0,-10
7690,1,1,678,1233,555
7691,0,0,164,0,-164
7692,1,1,167,1696,1529
7693,1,0,1,0,-1
7694,1,1,638,1277,639
7695,1,0,7,0,-7
7696,1,1,311,1326,1015
7697,0,0,148,0,-148
7698,0,0,123,0,-123
7699,1,1,1836,1307,-529
7700,0,0,156,0,-156
7701,1,1,334,1223,889
7702,1,0,56,0,-56
7703,1,1,247,1216,969
7704,0,0,12,0,-12
7705,1,1,355,1445,1090
7706,0,0,8,0,-8
7707,1,0,66,0,-66
7708,0,0,56,0,-56
7709,1,1,661,1231,570
7710,1,0,7,0,-7
7711,1,1,890,1212,322
7712,0,0,32,0,-32
7713,0,0,7,0,-7
7714,1,0,153,0,-153
7715,1,1,136,1874,1738
7716,1,0,24,0,-24
7717,0,0,58,0,-58
7718,1,1,166,1400,1234
7719,1,0,50,0,-50
7720,0,0,26,0,-26
7721,1,0,85,0,-85
7722,1,1,961,2002,1041
7723,0,0,0,0,0
7724,1,0,4,0,-4
7725,0,0,12,0,-12
7726,1,1,916,1472,556
7727,0,0,24,0,-24
7728,0,0,15,0,-15
7729,0,0,16,0,-16
7730,1,0,67,0,-67
7731,1,0,121,0,-121
7732,0,0,50,0,-50
7733,1,0,27,0,-27
7734,0,0,2,0,-2
7735,1,1,11,1222,1211
7736,0,0,1,0,-1
7737,0,0,50,0,-50
7738,0,0,6,0,-6
7739,0,0,96,0,-96
7740,0,0,8,0,-8
7741,0,0,94,0,-94
7742,0,0,10,0,-10
7743,1,1,630,1324,694
7744,1,1,103,1279,1176
7745,1,1,2244,1387,-857
7746,0,0,3,0,-3
7747,1,1,56,1355,1299
7748,1,0,2,0,-2
7749,0,0,25,0,-25
7750,1,0,215,0,-215
7751,0,0,22,0,-22
7752,1,1,1956,1204,-752
7753,0,0,5,0,-5
7754,0,0,201,0,-201
7755,1,1,201,1531,1330
7756,1,1,476,1206,730
7757,1,1,674,1624,950
7758,1,0,8,0,-8
7759,0,0,93,0,-93
7760,1,1,446,2901,2455
7761,0,0,42,0,-42
7762,0,0,24,0,-24
7763,1,0,34,0,-34
7764,1,1,2240,1718,-522
7765,0,0,9,0,-9
7766,0,0,94,0,-94
7767,0,0,82,0,-82
7768,1,1,276,1229,953
7769,0,0,16,0,-16
7770,0,0,141,0,-141
7771,1,0,145,0,-145
7772,1,0,35,0,-35
7773,0,0,2,0,-2
7774,1,0,21,0,-21
7775,1,1,355,2430,2075
7776,1,0,135,0,-135
7777,0,0,3,0,-3
7778,1,1,995,3031,2036
7779,1,1,488,1417,929
7780,1,1,33,1367,1334
7781,1,0,41,0,-41
7782,1,0,135,0,-135
7783,1,1,357,1201,844
7784,1,0,114,0,-114
7785,0,0,10,0,-10
7786,0,0,28,0,-28
7787,0,0,66,0,-66
7788,0,0,26,0,-26
7789,0,0,5,0,-5
7790,1,1,587,1409,822
7791,1,1,82,1560,1478
7792,1,1,47,8191,8144
7793,1,1,856,1515,659
7794,0,0,24,0,-24
7795,1,1,182,1456,1274
7796,1,1,631,1224,593
7797,0,0,43,0,-43
7798,0,0,221,0,-221
7799,0,0,69,0,-69
7800,0,0,20,0,-20
7801,1,0,13,0,-13
7802,0,0,29,0,-29
7803,1,1,258,1446,1188
7804,1,0,59,0,-59
7805,1,1,162,1520,1358
7806,1,0,115,0,-115
7807,1,1,525,1618,1093
7808,1,0,96,0,-96
7809,1,1,702,1976,1274
7810,0,0,5,0,-5
7811,1,1,156,1343,1187
7812,1,0,45,0,-45
7813,1,1,363,1214,851
7814,0,0,55,0,-55
7815,1,1,129,1425,1296
7816,1,0,9,0,-9
7817,0,0,59,0,-59
7818,0,0,5,0,-5
7819,0,0,44,0,-44
7820,1,1,108,1380,1272
7821,1,1,426,1632,1206
7822,0,0,81,0,-81
7823,0,0,40,0,-40
7824,0,0,96,0,-96
7825,1,1,598,1638,1040
7826,1,1,196,1673,1477
7827,1,1,219,1325,1106
7828,1,1,142,1292,1150
7829,0,0,280,0,-280
7830,0,0,131,0,-131
7831,1,0,32,0,-32
7832,1,0,0,0,0
7833,1,0,81,0,-81
7834,1,0,9,0,-9
7835,1,0,38,0,-38
7836,1,0,149,0,-149
7837,1,0,26,0,-26
7838,0,0,55,0,-55
7839,1,0,174,0,-174
7840,1,0,34,0,-34
7841,1,0,62,0,-62
7842,1,1,709,1768,1059
7843,0,0,24,0,-24
7844,1,1,1141,1372,231
7845,1,0,83,0,-83
7846,1,0,65,0,-65
7847,0,0,86,0,-86
7848,1,0,11,0,-11
7849,1,1,418,1287,869
7850,1,0,11,0,-11
7851,0,0,17,0,-17
7852,0,0,96,0,-96
7853,1,0,2,0,-2
7854,1,0,22,0,-22
7855,1,0,18,0,-18
7856,0,0,35,0,-35
7857,1,0,47,0,-47
7858,0,0,16,0,-16
7859,0,0,2,0,-2
7860,1,0,22,0,-22
7861,1,0,61,0,-61
7862,0,0,48,0,-48
7863,1,1,762,1566,804
7864,1,1,159,1236,1077
7865,1,1,67,1211,1144
7866,1,1,1141,1297,156
7867,1,1,473,1523,1050
7868,0,0,3,0,-3
7869,0,0,13,0,-13
7870,0,0,38,0,-38
7871,0,0,41,0,-41
7872,0,0,52,0,-52
7873,1,0,52,0,-52
7874,0,0,0,0,0
7875,1,0,87,0,-87
7876,0,0,42,0,-42
7877,1,0,126,0,-126
7878,1,0,10,0,-10
7879,0,0,1,0,-1
7880,0,0,37,0,-37
7881,1,1,399,1267,868
7882,1,1,487,1694,1207
7883,0,0,114,0,-114
7884,0,0,5,0,-5
7885,1,0,25,0,-25
7886,1,1,219,1277,1058
7887,1,0,29,0,-29
7888,1,0,5,0,-5
7889,1,0,0,0,0
7890,1,0,60,0,-60
7891,1,1,414,1233,819
7892,0,0,2,0,-2
7893,1,1,141,2334,2193
7894,0,0,1,0,-1
7895,1,0,53,0,-53
7896,0,0,7,0,-7
7897,0,0,8,0,-8
7898,1,1,115,1917,1802
7899,0,0,5,0,-5
7900,1,0,13,0,-13
7901,0,0,56,0,-56
7902,1,1,185,1218,1033
7903,1,1,220,1246,1026
7904,1,0,29,0,-29
7905,1,1,273,1544,1271
7906,1,1,293,1290,997
7907,0,0,81,0,-81
7908,0,0,155,0,-155
7909,0,0,8,0,-8
7910,0,0,104,0,-104
7911,0,0,8,0,-8
7912,0,0,44,0,-44
7913,0,0,17,0,-17
7914,1,0,36,0,-36
7915,1,0,238,0,-238
7916,1,1,2282,1540,-742
7917,1,0,7,0,-7
7918,1,1,242,2013,1771
7919,1,1,801,1735,934
7920,1,1,241,1822,1581
7921,1,1,939,1313,374
7922,1,0,94,0,-94
7923,0,0,26,0,-26
7924,0,0,54,0,-54
7925,1,1,825,1373,548
7926,0,0,48,0,-48
7927,1,0,90,0,-90
7928,0,0,36,0,-36
7929,1,0,183,0,-183
7930,0,0,77,0,-77
7931,0,0,5,0,-5
7932,0,0,77,0,-77
7933,1,1,625,1549,924
7934,1,1,415,1516,1101
7935,1,1,2613,1308,-1305
7936,0,0,81,0,-81
7937,1,1,472,1385,913
7938,1,0,21,0,-21
7939,1,0,5,0,-5
7940,0,0,14,0,-14
7941,0,0,57,0,-57
7942,1,1,203,1450,1247
7943,1,1,231,2470,2239
7944,0,0,63,0,-63
7945,1,0,9,0,-9
7946,0,0,4,0,-4
7947,1,0,26,0,-26
7948,0,0,71,0,-71
7949,1,1,549,1314,765
7950,1,1,125,1922,1797
7951,1,1,385,1478,1093
7952,0,0,45,0,-45
7953,1,1,1570,1449,-121
7954,1,1,537,1989,1452
7955,1,1,1480,1275,-205
7956,1,1,117,1510,1393
7957,1,1,267,1271,1004
7958,0,0,23,0,-23
7959,0,0,98,0,-98
7960,1,0,47,0,-47
7961,0,0,0,0,0
7962,1,0,92,0,-92
7963,1,0,62,0,-62
7964,1,1,858,1880,1022
7965,1,0,26,0,-26
7966,0,0,23,0,-23
7967,0,0,192,0,-192
7968,1,0,1,0,-1
7969,0,0,59,0,-59
7970,1,0,63,0,-63
7971,0,0,6,0,-6
7972,1,1,750,1218,468
7973,0,0,31,0,-31
7974,0,0,166,0,-166
7975,0,0,9,0,-9
7976,1,0,10,0,-10
7977,0,0,2,0,-2
7978,0,0,45,0,-45
7979,1,0,109,0,-109
7980,1,1,273,1239,966
7981,0,0,2,0,-2
7982,1,1,1061,1592,531
7983,1,1,164,1721,1557
7984,1,1,56,1760,1704
7985,0,0,6,0,-6
7986,0,0,35,0,-35
7987,1,1,1826,1316,-510
7988,1,0,13,0,-13
7989,0,0,126,0,-126
7990,1,0,3,0,-3
7991,1,1,245,1873,1628
7992,0,0,44,0,-44
7993,1,0,0,0,0
7994,1,1,499,2431,1932
7995,1,1,354,1867,1513
7996,0,0,21,0,-21
7997,0,0,30,0,-30
7998,1,1,607,1710,1103
7999,0,0,51,0,-51
8000,0,0,3,0,-3
8001,0,0,56,0,-56
8002,1,1,807,1336,529
8003,1,1,225,1478,1253
8004,0,0,7,0,-7
8005,1,1,1581,1259,-322
8006,1,0,4,0,-4
8007,1,0,24,0,-24
8008,1,1,121,1494,1373
8009,1,0,20,0,-20
8010,0,0,35,0,-35
8011,1,0,2,0,-2
8012,1,0,7,0,-7
8013,1,0,12,0,-12
8014,1,0,20,0,-20
8015,1,1,366,1345,979
8016,1,0,64,0,-64
8017,1,0,56,0,-56
8018,1,0,17,0,-17
8019,0,0,53,0,-53
8020,1,1,746,1803,1057
8021,1,1,575,1304,729
8022,0,0,71,0,-71
8023,1,1,554,1277,723
8024,1,0,139,0,-139
8025,1,0,72,0,-72
8026,0,0,8,0,-8
8027,0,0,94,0,-94
8028,0,0,0,0,0
8029,1,0,27,0,-27
8030,1,1,181,1412,1231
8031,1,1,626,1243,617
8032,1,1,620,1304,684
8033,0,0,79,0,-79
8034,1,0,20,0,-20
8035,1,0,125,0,-125
8036,0,0,6,0,-6
8037,0,0,17,0,-17
8038,0,0,51,0,-51
8039,0,0,115,0,-115
8040,1,1,357,1307,950
8041,0,0,7,0,-7
8042,0,0,2,0,-2
8043,1,1,121,1868,1747
8044,0,0,25,0,-25
8045,1,0,81,0,-81
8046,1,0,7,0,-7
8047,1,1,261,1375,1114
8048,1,1,54,2950,2896
8049,0,0,4,0,-4
8050,1,0,30,0,-30
8051,1,1,369,1459,1090
8052,1,0,44,0,-44
8053,1,1,289,1288,999
8054,0,0,36,0,-36
8055,0,0,40,0,-40
8056,1,0,42,0,-42
8057,1,0,5,0,-5
8058,1,0,43,0,-43
8059,0,0,0,0,0
8060,1,0,86,0,-86
8061,0,0,6,0,-6
8062,1,1,716,1349,633
8063,0,0,45,0,-45
8064,1,0,26,0,-26
8065,0,0,46,0,-46
8066,1,1,167,1275,1108
8067,0,0,21,0,-21
8068,1,0,4,0,-4
8069,1,1,343,1209,866
8070,0,0,14,0,-14
8071,1,0,8,0,-8
8072,0,0,16,0,-16
8073,1,0,59,0,-59
8074,0,0,75,0,-75
8075,1,1,177,1239,1062
8076,1,0,4,0,-4
8077,1,1,265,1222,957
8078,1,1,191,1315,1124
8079,0,0,1,0,-1
8080,0,0,73,0,-73
8081,0,0,14,0,-14
8082,0,0,111,0,-111
8083,0,0,42,0,-42
8084,1,1,926,1798,872
8085,1,0,0,0,0
8086,1,1,1889,1956,67
8087,0,0,48,0,-48
8088,0,0,27,0,-27
8089,0,0,41,0,-41
8090,1,0,48,0,-48
8091,0,0,48,0,-48
8092,0,0,78,0,-78
8093,1,1,276,1411,1135
8094,1,0,21,0,-21
8095,1,1,1215,1865,650
8096,0,0,78,0,-78
8097,0,0,2,0,-2
8098,0,0,29,0,-29
8099,1,1,136,1671,1535
8100,1,0,13,0,-13
8101,1,1,692,1268,576
8102,0,0,20,0,-20
8103,1,1,1405,1465,60
8104,0,0,49,0,-49
8105,0,0,164,0,-164
8106,1,1,1300,1242,-58
8107,1,1,402,1552,1150
8108,1,1,349,1226,877
8109,0,0,6,0,-6
8110,1,1,527,2728,2201
8111,1,0,9,0,-9
8112,1,0,88,0,-88
8113,0,0,13,0,-13
8114,1,1,759,1661,902
8115,1,0,14,0,-14
8116,1,1,206,1752,1546
8117,1,0,33,0,-33
8118,0,0,13,0,-13
8119,0,0,67,0,-67
8120,1,1,791,1416,625
8121,0,0,132,0,-132
8122,0,0,7,0,-7
8123,0,0,8,0,-8
8124,1,1,11,1247,1236
8125,1,1,51,1617,1566
8126,0,0,125,0,-125
8127,0,0,52,0,-52
8128,1,0,34,0,-34
8129,1,1,658,1216,558
8130,1,0,138,0,-138
8131,0,0,16,0,-16
8132,1,0,43,0,-43
8133,1,0,65,0,-65
8134,1,0,18,0,-18
8135,0,0,44,0,-44
8136,1,0,95,0,-95
8137,1,0,78,0,-78
8138,0,0,170,0,-170
8139,0,0,0,0,0
8140,1,1,439,1795,1356
8141,0,0,90,0,-90
8142,1,0,21,0,-21
8143,0,0,25,0,-25
8144,0,0,30,0,-30
8145,0,0,6,0,-6
8146,1,0,35,0,-35
8147,1,1,389,1291,902
8148,1,1,1222,1598,376
8149,1,0,75,0,-75
8150,1,0,26,0,-26
8151,1,1,219,1339,1120
8152,0,0,74,0,-74
8153,1,1,92,1318,1226
8154,1,0,12,0,-12
8155,0,0,87,0,-87
8156,0,0,166,0,-166
8157,0,0,119,0,-119
8158,1,0,28,0,-28
8159,1,1,60,1471,1411
8160,1,1,243,1296,1053
8161,1,1,245,1286,1041
8162,1,0,7,0,-7
8163,0,0,12,0,-12
8164,1,0,3,0,-3
8165,1,1,931,1329,398
8166,1,1,427,2765,2338
8167,1,0,5,0,-5
8168,1,1,187,1378,1191
8169,1,1,675,2557,1882
8170,1,0,19,0,-19
8171,0,0,22,0,-22
8172,1,1,340,1209,869
8173,0,0,116,0,-116
8174,1,0,42,0,-42
8175,1,1,569,1480,911
8176,1,0,4,0,-4
8177,0,0,23,0,-23
8178,1,1,523,1309,786
8179,1,1,317,1308,991
8180,1,0,9,0,-9
8181,1,1,83,1210,1127
8182,1,0,42,0,-42
8183,1,0,51,0,-51
8184,1,1,337,5584,5247
8185,0,0,68,0,-68
8186,1,0,3,0,-3
8187,1,0,86,0,-86
8188,0,0,19,0,-19
8189,1,1,429,2085,1656
8190,1,0,61,0,-61
8191,1,0,162,0,-162
8192,1,0,60,0,-60
8193,1,0,64,0,-64
8194,0,0,8,0,-8
8195,1,0,25,0,-25
8196,0,0,56,0,-56
8197,1,1,1617,1232,-385
8198,1,1,202,1924,1722
8199,1,0,143,0,-143
8200,0,0,60,0,-60
8201,1,1,505,1491,986
8202,0,0,27,0,-27
8203,1,1,850,1261,411
8204,1,1,368,1534,1166
8205,0,0,88,0,-88
8206,1,1,674,1244,570
8207,0,0,125,0,-125
8208,0,0,3,0,-3
8209,0,0,123,0,-123
8210,1,1,309,1696,1387
8211,1,0,72,0,-72
8212,1,0,40,0,-40
8213,1,1,66,1956,1890
8214,0,0,48,0,-48
8215,0,0,14,0,-14
8216,1,0,52,0,-52
8217,1,1,559,1471,912
8218,1,0,12,0,-12
8219,1,1,646,1497,851
8220,1,1,47,1547,1500
8221,1,0,3,0,-3
8222,0,0,98,0,-98
8223,0,0,4,0,-4
8224,1,0,26,0,-26
8225,0,0,28,0,-28
8226,1,0,24,0,-24
8227,1,0,31,0,-31
8228,0,0,46,0,-46
8229,1,0,107,0,-107
8230,1,0,23,0,-23
8231,0,0,23,0,-23
8232,1,0,22,0,-22
8233,0,0,18,0,-18
8234,1,0,59,0,-59
8235,0,0,13,0,-13
8236,1,0,32,0,-32
8237,0,0,56,0,-56
8238,1,0,8,0,-8
8239,1,0,47,0,-47
8240,1,1,1110,1697,587
8241,1,1,577,1351,774
8242,0,0,85,0,-85
8243,1,1,69,1381,1312
8244,1,0,8,0,-8
8245,0,0,42,0,-42
8246,1,0,37,0,-37
8247,1,1,115,2055,1940
8248,1,1,301,1402,1101
8249,1,0,70,0,-70
8250,1,0,7,0,-7
8251,0,0,23,0,-23
8252,0,0,26,0,-26
8253,1,0,52,0,-52
8254,1,0,23,0,-23
8255,1,1,555,1383,828
8256,0,0,225,0,-225
8257,1,1,236,1580,1344
8258,0,0,31,0,-31
8259,0,0,14,0,-14
8260,0,0,14,0,-14
8261,1,0,42,0,-42
8262,1,0,35,0,-35
8263,0,0,7,0,-7
8264,1,0,198,0,-198
8265,1,0,46,0,-46
8266,1,0,132,0,-132
8267,0,0,5,0,-5
8268,1,0,7,0,-7
8269,0,0,40,0,-40
8270,1,1,239,1469,1230
8271,1,0,9,0,-9
8272,1,0,3,0,-3
8273,1,1,346,1309,963
8274,1,1,284,1225,941
8275,1,0,56,0,-56
8276,1,1,1126,1340,214
8277,0,0,26,0,-26
8278,1,1,854,1866,1012
8279,0,0,96,0,-96
8280,1,0,112,0,-112
8281,0,0,5,0,-5
8282,1,0,17,0,-17
8283,1,0,72,0,-72
8284,0,0,25,0,-25
8285,1,0,15,0,-15
8286,0,0,43,0,-43
8287,1,0,17,0,-17
8288,1,1,471,1363,892
8289,1,0,5,0,-5
8290,1,1,150,1342,1192
8291,1,1,245,1609,1364
8292,0,0,35,0,-35
8293,1,0,161,0,-161
8294,0,0,10,0,-10
8295,1,0,19,0,-19
8296,1,0,116,0,-116
8297,0,0,64,0,-64
8298,1,0,32,0,-32
8299,1,1,830,1204,374
8300,1,1,646,2259,1613
8301,1,0,10,0,-10
8302,1,1,2189,1331,-858
8303,1,1,577,1210,633
8304,0,0,0,0,0
8305,0,0,40,0,-40
8306,1,1,67,1879,1812
8307,1,1,2142,1651,-491
8308,0,0,35,0,-35
8309,1,0,67,0,-67
8310,0,0,132,0,-132
8311,0,0,27,0,-27
8312,0,0,51,0,-51
8313,0,0,44,0,-44
8314,1,0,50,0,-50
8315,1,1,846,1877,1031
8316,0,0,33,0,-33
8317,1,1,450,1553,1103
8318,1,1,141,1383,1242
8319,0,0,29,0,-29
8320,1,0,9,0,-9
8321,0,0,85,0,-85
8322,1,0,19,0,-19
8323,0,0,32,0,-32
8324,0,0,115,0,-115
8325,0,0,61,0,-61
8326,1,1,123,1424,1301
8327,1,1,587,1340,753
8328,0,0,79,0,-79
8329,1,1,235,1284,1049
8330,1,1,446,2291,1845
8331,1,1,728,1554,826
8332,1,0,98,0,-98
8333,1,0,22,0,-22
8334,0,0,95,0,-95
8335,0,0,29,0,-29
8336,0,0,29,0,-29
8337,1,1,532,4284,3752
8338,1,1,435,1351,916
8339,0,0,70,0,-70
8340,1,0,163,0,-163
8341,1,0,45,0,-45
8342,1,1,541,1695,1154
8343,0,0,4,0,-4
8344,0,0,25,0,-25
8345,1,1,512,1998,1486
8346,0,0,30,0,-30
8347,1,0,1,0,-1
8348,1,0,37,0,-37
8349,0,0,46,0,-46
8350,1,1,1421,1459,38
8351,1,0,15,0,-15
8352,1,1,439,1399,960
8353,0,0,7,0,-7
8354,1,1,274,2116,1842
8355,1,0,22,0,-22
8356,1,1,525,2888,2363
8357,0,0,148,0,-148
8358,0,0,4,0,-4
8359,1,0,6,0,-6
8360,1,1,109,1255,1146
8361,1,1,1419,1200,-219
8362,1,1,381,1528,1147
8363,1,1,550,1407,857
8364,0,0,94,0,-94
8365,0,0,1,0,-1
8366,1,0,23,0,-23
8367,1,1,310,1483,1173
8368,1,1,513,2258,1745
8369,0,0,3,0,-3
8370,1,1,645,1226,581
8371,1,0,14,0,-14
8372,0,0,0,0,0
8373,1,1,257,1390,1133
8374,1,0,40,0,-40
8375,1,0,26,0,-26
8376,1,1,205,1560,1355
8377,1,0,12,0,-12
8378,1,1,1333,1357,24
8379,0,0,38,0,-38
8380,1,1,146,2125,1979
8381,1,0,13,0,-13
8382,1,1,154,1400,1246
8383,1,0,84,0,-84
8384,1,1,470,1667,1197
8385,1,1,451,1252,801
8386,0,0,29,0,-29
8387,0,0,115,0,-115
8388,1,1,201,1299,1098
8389,0,0,15,0,-15
8390,1,0,7,0,-7
8391,1,0,12,0,-12
8392,0,0,43,0,-43
8393,0,0,138,0,-138
8394,1,1,448,1555,1107
8395,1,0,26,0,-26
8396,1,1,580,1408,828
8397,1,1,376,1210,834
8398,1,0,29,0,-29
8399,1,0,18,0,-18
8400,1,0,8,0,-8
8401,1,0,123,0,-123
8402,1,1,637,1364,727
8403,0,0,13,0,-13
8404,0,0,14,0,-14
8405,0,0,2,0,-2
8406,1,0,58,0,-58
8407,0,0,8,0,-8
8408,0,0,87,0,-87
8409,0,0,37,0,-37
8410,0,0,18,0,-18
8411,1,0,124,0,-124
8412,1,1,1738,1317,-421
8413,0,0,96,0,-96
8414,0,0,22,0,-22
8415,0,0,7,0,-7
8416,0,0,151,0,-151
8417,1,0,0,0,0
8418,0,0,135,0,-135
8419,1,0,39,0,-39
8420,1,0,2,0,-2
8421,1,0,64,0,-64
8422,0,0,65,0,-65
8423,1,0,20,0,-20
8424,1,0,31,0,-31
8425,1,0,14,0,-14
8426,0,0,8,0,-8
8427,0,0,10,0,-10
8428,1,1,174,1396,1222
8429,0,0,31,0,-31
8430,0,0,17,0,-17
8431,1,1,370,1763,1393
8432,1,0,35,0,-35
8433,1,1,335,1339,1004
8434,0,0,44,0,-44
8435,1,0,38,0,-38
8436,1,0,19,0,-19
8437,1,0,61,0,-61
8438,1,1,1707,1334,-373
8439,0,0,11,0,-11
8440,0,0,2,0,-2
8441,1,1,1441,1433,-8
8442,0,0,9,0,-9
8443,1,0,2,0,-2
8444,0,0,56,0,-56
8445,0,0,27,0,-27
8446,0,0,7,0,-7
8447,1,1,357,1227,870
8448,0,0,18,0,-18
8449,0,0,48,0,-48
8450,0,0,88,0,-88
8451,0,0,17,0,-17
8452,0,0,60,0,-60
8453,0,0,109,0,-109
8454,1,0,19,0,-19
8455,0,0,62,0,-62
8456,0,0,88,0,-88
8457,1,1,10,1389,1379
8458,0,0,21,0,-21
8459,0,0,36,0,-36
8460,0,0,4,0,-4
8461,0,0,28,0,-28
8462,1,0,139,0,-139
8463,1,0,5,0,-5
8464,1,0,83,0,-83
8465,1,0,60,0,-60
8466,0,0,42,0,-42
8467,0,0,8,0,-8
8468,1,1,584,1223,639
8469,0,0,40,0,-40
8470,0,0,56,0,-56
8471,1,1,526,1426,900
8472,1,1,319,1461,1142
8473,1,0,97,0,-97
8474,1,1,918,1414,496
8475,0,0,23,0,-23
8476,1,0,14,0,-14
8477,0,0,89,0,-89
8478,0,0,14,0,-14
8479,1,1,228,1461,1233
8480,0,0,29,0,-29
8481,0,0,7,0,-7
8482,0,0,209,0,-209
8483,1,0,82,0,-82
8484,1,0,10,0,-10
8485,1,0,64,0,-64
8486,1,0,5,0,-5
8487,0,0,103,0,-103
8488,1,0,36,0,-36
8489,0,0,102,0,-102
8490,1,0,22,0,-22
8491,1,1,964,1520,556
8492,1,1,902,1263,361
8493,1,0,34,0,-34
8494,0,0,22,0,-22
8495,0,0,10,0,-10
8496,0,0,78,0,-78
8497,0,0,40,0,-40
8498,1,1,662,1243,581
8499,1,0,0,0,0
8500,1,1,163,1359,1196
8501,1,0,48,0,-48
8502,1,0,45,0,-45
8503,1,1,310,4136,3826
8504,1,1,908,2108,1200
8505,0,0,139,0,-139
8506,0,0,1,0,-1
8507,1,1,172,1374,1202
8508,1,1,242,1290,1048
8509,0,0,37,0,-37
8510,1,1,738,1555,817
8511,1,1,852,1297,445
8512,0,0,197,0,-197
8513,1,0,118,0,-118
8514,0,0,16,0,-16
8515,1,0,54,0,-54
8516,1,1,571,1272,701
8517,1,0,50,0,-50
8518,0,0,142,0,-142
8519,0,0,2,0,-2
8520,0,0,4,0,-4
8521,1,0,0,0,0
8522,1,0,129,0,-129
8523,0,0,114,0,-114
8524,0,0,21,0,-21
8525,0,0,74,0,-74
8526,1,0,6,0,-6
8527,0,0,187,0,-187
8528,1,0,48,0,-48
8529,1,0,61,0,-61
8530,1,1,684,2036,1352
8531,1,1,470,1207,737
8532,0,0,18,0,-18
8533,0,0,171,0,-171
8534,1,1,475,1440,965
8535,1,0,3,0,-3
8536,1,0,3,0,-3
8537,1,1,570,1328,758
8538,0,0,50,0,-50
8539,1,0,111,0,-111
8540,1,1,127,1279,1152
8541,1,0,27,0,-27
8542,1,1,89,1215,1126
8543,1,0,20,0,-20
8544,1,0,141,0,-141
8545,0,0,0,0,0
8546,1,1,547,1926,1379
8547,0,0,200,0,-200
8548,0,0,49,0,-49
8549,1,1,102,1245,1143
8550,1,1,325,2003,1678
8551,1,0,6,0,-6
8552,1,1,99,1276,1177
8553,1,0,16,0,-16
8554,0,0,31,0,-31
8555,1,0,24,0,-24
8556,0,0,96,0,-96
8557,1,1,361,1307,946
8558,1,0,73,0,-73
8559,1,0,46,0,-46
8560,0,0,18,0,-18
8561,1,0,47,0,-47
8562,1,0,16,0,-16
8563,0,0,30,0,-30
8564,1,0,10,0,-10
8565,1,1,740,1222,482
8566,0,0,19,0,-19
8567,1,0,60,0,-60
8568,0,0,120,0,-120
8569,1,0,32,0,-32
8570,0,0,27,0,-27
8571,1,1,2551,1451,-1100
8572,1,0,24,0,-24
8573,0,0,36,0,-36
8574,0,0,17,0,-17
8575,1,0,2,0,-2
8576,1,1,1827,1278,-549
8577,1,0,72,0,-72
8578,0,0,28,0,-28
8579,0,0,45,0,-45
8580,0,0,87,0,-87
8581,1,0,158,0,-158
8582,1,1,112,1273,1161
8583,1,1,397,1364,967
8584,1,1,150,1236,1086
8585,1,0,35,0,-35
8586,1,0,188,0,-188
8587,1,1,876,1665,789
8588,1,1,233,1868,1635
8589,0,0,2,0,-2
8590,0,0,6,0,-6
8591,1,0,14,0,-14
8592,0,0,34,0,-34
8593,1,0,10,0,-10
8594,1,1,290,1217,927
8595,1,0,80,0,-80
8596,1,1,1278,1320,42
8597,0,0,40,0,-40
8598,0,0,24,0,-24
8599,1,0,8,0,-8
8600,1,1,346,1239,893
8601,1,0,2,0,-2
8602,1,0,8,0,-8
8603,1,0,47,0,-47
8604,1,1,527,1231,704
8605,1,1,151,2407,2256
8606,0,0,23,0,-23
8607,0,0,32,0,-32
8608,1,0,28,0,-28
8609,1,0,13,0,-13
8610,0,0,12,0,-12
8611,1,1,93,1209,1116
8612,1,1,303,1217,914
8613,0,0,0,0,0
8614,1,1,472,1342,870
8615,1,0,89,0,-89
8616,1,1,206,1212,1006
8617,0,0,38,0,-38
8618,1,1,129,1369,1240
8619,0,0,50,0,-50
8620,1,0,21,0,-21
8621,1,1,430,1219,789
8622,1,0,16,0,-16
8623,1,0,22,0,-22
8624,1,0,71,0,-71
8625,1,0,181,0,-181
8626,1,0,4,0,-4
8627,1,1,1225,1346,121
8628,0,0,127,0,-127
8629,0,0,122,0,-122
8630,1,1,1240,1203,-37
8631,1,0,16,0,-16
8632,1,0,95,0,-95
8633,1,1,83,1757,1674
8634,0,0,12,0,-12
8635,1,0,13,0,-13
8636,1,1,1045,1368,323
8637,1,1,457,1803,1346
8638,1,0,17,0,-17
8639,1,1,433,1459,1026
8640,1,0,130,0,-130
8641,0,0,2,0,-2
8642,0,0,46,0,-46
8643,1,0,57,0,-57
8644,1,0,20,0,-20
8645,0,0,14,0,-14
8646,1,0,1,0,-1
8647,1,1,110,1520,1410
8648,1,0,83,0,-83
8649,1,1,509,1474,965
8650,0,0,18,0,-18
8651,1,0,104,0,-104
8652,1,1,109,1257,1148
8653,1,1,746,1483,737
8654,0,0,68,0,-68
8655,1,1,241,2281,2040
8656,0,0,83,0,-83
8657,0,0,11,0,-11
8658,0,0,71,0,-71
8659,1,0,34,0,-34
8660,0,0,55,0,-55
8661,1,1,1054,1237,183
8662,0,0,58,0,-58
8663,1,1,258,1326,1068
8664,0,0,68,0,-68
8665,1,0,52,0,-52
8666,1,1,915,1706,791
8667,0,0,84,0,-84
8668,1,1,93,1240,1147
8669,1,1,449,1523,1074
8670,1,0,40,0,-40
8671,1,0,5,0,-5
8672,1,1,107,1481,1374
8673,1,1,472,1347,875
8674,1,0,0,0,0
8675,1,1,400,1746,1346
8676,1,0,22,0,-22
8677,0,0,9,0,-9
8678,1,0,33,0,-33
8679,1,0,6,0,-6
8680,0,0,125,0,-125
8681,1,1,203,2568,2365
8682,1,1,173,1454,1281
8683,1,0,14,0,-14
8684,1,0,94,0,-94
8685,1,0,65,0,-65
8686,1,0,39,0,-39
8687,1,1,256,1478,1222
8688,1,1,1452,1978,526
8689,1,0,26,0,-26
8690,1,1,195,2190,1995
8691,1,1,784,1292,508
8692,1,1,1285,1203,-82
8693,1,1,104,1734,1630
8694,0,0,67,0,-67
8695,1,1,848,3128,2280
8696,0,0,22,0,-22
8697,1,1,46,1358,1312
8698,0,0,50,0,-50
8699,1,0,57,0,-57
8700,1,0,48,0,-48
8701,1,1,494,1256,762
8702,0,0,26,0,-26
8703,1,1,91,1233,1142
8704,0,0,10,0,-10
8705,0,0,61,0,-61
8706,0,0,11,0,-11
8707,0,0,161,0,-161
8708,1,0,16,0,-16
8709,1,1,116,1479,1363
8710,1,1,700,1525,825
8711,0,0,65,0,-65
8712,1,0,26,0,-26
8713,1,0,3,0,-3
8714,0,0,58,0,-58
8715,1,0,29,0,-29
8716,1,0,7,0,-7
8717,1,0,64,0,-64
8718,1,0,186,0,-186
8719,1,0,61,0,-61
8720,0,0,65,0,-65
8721,0,0,27,0,-27
8722,1,0,67,0,-67
8723,1,1,284,2044,1760
8724,1,0,7,0,-7
8725,1,1,83,1989,1906
8726,0,0,17,0,-17
8727,1,1,261,1403,1142
8728,1,1,348,1607,1259
8729,1,0,18,0,-18
8730,0,0,63,0,-63
8731,0,0,16,0,-16
8732,0,0,11,0,-11
8733,1,0,28,0,-28
8734,1,1,358,1781,1423
8735,1,0,14,0,-14
8736,0,0,55,0,-55
8737,1,1,386,1300,914
8738,1,0,52,0,-52
8739,1,0,8,0,-8
8740,0,0,24,0,-24
8741,1,0,39,0,-39
8742,0,0,43,0,-43
8743,1,0,124,0,-124
8744,1,1,662,1402,740
8745,1,0,11,0,-11
8746,0,0,31,0,-31
8747,0,0,23,0,-23
8748,1,1,895,1489,594
8749,1,1,777,1829,1052
8750,1,1,251,1378,1127
8751,1,1,911,1281,370
8752,0,0,1,0,-1
8753,0,0,30,0,-30
8754,1,1,495,1273,778
8755,1,1,346,1326,980
8756,1,0,7,0,-7
8757,1,0,5,0,-5
8758,1,0,21,0,-21
8759,0,0,0,0,0
8760,0,0,1,0,-1
8761,0,0,105,0,-105
8762,1,0,28,0,-28
8763,1,0,31,0,-31
8764,1,0,9,0,-9
8765,1,1,667,1339,672
8766,1,1,183,1279,1096
8767,0,0,23,0,-23
8768,1,1,300,1277,977
8769,0,0,97,0,-97
8770,1,0,17,0,-17
8771,0,0,64,0,-64
8772,0,0,41,0,-41
8773,1,0,0,0,0
8774,1,1,54,1272,1218
8775,1,1,304,1228,924
8776,0,0,38,0,-38
8777,0,0,81,0,-81
8778,0,0,13,0,-13
8779,1,1,630,1576,946
8780,1,0,10,0,-10
8781,1,0,57,0,-57
8782,1,0,30,0,-30
8783,0,0,53,0,-53
8784,1,1,50,1562,1512
8785,1,1,636,3007,2371
8786,0,0,106,0,-106
8787,1,0,70,0,-70
8788,1,1,82,1720,1638
8789,1,1,420,1819,1399
8790,0,0,39,0,-39
8791,1,0,16,0,-16
8792,1,0,28,0,-28
8793,1,1,340,2567,2227
8794,1,0,61,0,-61
8795,0,0,14,0,-14
8796,1,1,170,1202,1032
8797,1,1,62,1692,1630
8798,0,0,225,0,-225
8799,0,0,80,0,-80
8800,0,0,25,0,-25
8801,0,0,15,0,-15
8802,0,0,3,0,-3
8803,1,1,252,1518,1266
8804,0,0,27,0,-27
8805,1,0,41,0,-41
8806,1,1,126,1980,1854
8807,0,0,21,0,-21
8808,1,0,52,0,-52
8809,0,0,129,0,-129
8810,1,0,33,0,-33
8811,1,1,499,1292,793
8812,0,0,8,0,-8
8813,1,0,77,0,-77
8814,0,0,118,0,-118
8815,0,0,11,0,-11
8816,1,0,46,0,-46
8817,1,0,161,0,-161
8818,0,0,0,0,0
8819,1,1,1010,1442,432
8820,0,0,49,0,-49
8821,1,0,9,0,-9
8822,0,0,26,0,-26
8823,1,1,421,1318,897
8824,1,1,506,1340,834
8825,1,1,801,1449,648
8826,0,0,59,0,-59
8827,0,0,12,0,-12
8828,1,1,89,1279,1190
8829,0,0,23,0,-23
8830,0,0,2,0,-2
8831,0,0,16,0,-16
8832,1,1,1937,1831,-106
8833,1,1,927,1254,327
8834,1,0,46,0,-46
8835,1,0,21,0,-21
8836,0,0,1,0,-1
8837,1,1,130,1322,1192
8838,1,0,168,0,-168
8839,1,0,72,0,-72
8840,0,0,14,0,-14
8841,0,0,42,0,-42
8842,0,0,17,0,-17
8843,1,0,23,0,-23
8844,1,0,24,0,-24
8845,1,1,820,1755,935
8846,1,1,277,1236,959
8847,1,1,101,3072,2971
8848,1,0,42,0,-42
8849,1,1,113,1817,1704
8850,1,0,24,0,-24
8851,0,0,98,0,-98
8852,1,0,52,0,-52
8853,1,0,45,0,-45
8854,0,0,8,0,-8
8855,0,0,20,0,-20
8856,1,0,66,0,-66
8857,1,1,421,2087,1666
8858,1,0,48,0,-48
8859,1,1,291,1974,1683
8860,1,0,32,0,-32
8861,1,0,33,0,-33
8862,1,0,196,0,-196
8863,1,0,56,0,-56
8864,0,0,9,0,-9
8865,0,0,167,0,-167
8866,0,0,0,0,0
8867,1,0,38,0,-38
8868,0,0,1,0,-1
8869,0,0,14,0,-14
8870,0,0,2,0,-2
8871,1,1,595,1664,1069
8872,0,0,89,0,-89
8873,1,0,44,0,-44
8874,0,0,54,0,-54
8875,1,0,79,0,-79
8876,1,1,1603,1691,88
8877,0,0,1,0,-1
8878,1,0,47,0,-47
8879,0,0,47,0,-47
8880,1,0,76,0,-76
8881,1,1,80,1879,1799
8882,1,1,1607,1380,-227
8883,1,0,15,0,-15
8884,0,0,8,0,-8
8885,1,0,11,0,-11
8886,1,1,1175,1245,70
8887,0,0,26,0,-26
8888,1,1,195,1499,1304
8889,0,0,7,0,-7
8890,0,0,54,0,-54
8891,1,0,14,0,-14
8892,0,0,0,0,0
8893,1,0,87,0,-87
8894,1,0,19,0,-19
8895,1,0,81,0,-81
8896,0,0,181,0,-181
8897,0,0,6,0,-6
8898,0,0,132,0,-132
8899,0,0,192,0,-192
8900,1,0,143,0,-143
8901,1,0,50,0,-50
8902,1,1,274,1294,1020
8903,1,1,389,1225,836
8904,1,1,471,1432,961
8905,1,1,1872,1581,-291
8906,1,0,20,0,-20
8907,1,0,2,0,-2
8908,1,0,13,0,-13
8909,1,0,16,0,-16
8910,0,0,37,0,-37
8911,1,1,567,1604,1037
8912,1,0,50,0,-50
8913,0,0,13,0,-13
8914,1,0,4,0,-4
8915,1,1,358,1391,1033
8916,0,0,56,0,-56
8917,1,0,12,0,-12
8918,1,1,1069,1352,283
8919,1,1,186,2185,1999
8920,0,0,72,0,-72
8921,1,0,32,0,-32
8922,1,1,98,1205,1107
8923,0,0,77,0,-77
8924,1,0,10,0,-10
8925,0,0,5,0,-5
8926,0,0,34,0,-34
8927,1,1,108,1389,1281
8928,1,0,6,0,-6
8929,1,0,44,0,-44
8930,0,0,30,0,-30
8931,1,0,34,0,-34
8932,0,0,6,0,-6
8933,1,1,880,1338,458
8934,1,1,703,1204,501
8935,0,0,79,0,-79
8936,1,0,137,0,-137
8937,1,1,360,1328,968
8938,0,0,47,0,-47
8939,1,0,30,0,-30
8940,0,0,39,0,-39
8941,0,0,48,0,-48
8942,0,0,162,0,-162
8943,0,0,20,0,-20
8944,1,0,18,0,-18
8945,1,1,334,1837,1503
8946,0,0,42,0,-42
8947,0,0,32,0,-32
8948,0,0,0,0,0
8949,1,0,90,0,-90
8950,1,0,14,0,-14
8951,1,0,78,0,-78
8952,1,1,900,1360,460
8953,1,1,857,1430,573
8954,0,0,14,0,-14
8955,1,0,52,0,-52
8956,1,1,376,1268,892
8957,0,0,31,0,-31
8958,1,0,3,0,-3
8959,1,0,20,0,-20
8960,1,1,719,1273,554
8961,1,0,43,0,-43
8962,1,1,1454,1662,208
8963,1,0,62,0,-62
8964,1,1,160,1282,1122
8965,0,0,70,0,-70
8966,1,0,119,0,-119
8967,1,0,32,0,-32
8968,1,1,225,1268,1043
8969,1,1,861,1218,357
8970,0,0,11,0,-11
8971,1,1,875,2772,1897
8972,0,0,16,0,-16
8973,1,0,21,0,-21
8974,0,0,164,0,-164
8975,1,1,120,1714,1594
8976,1,0,78,0,-78
8977,1,1,1343,1424,81
8978,1,0,126,0,-126
8979,0,0,134,0,-134
8980,0,0,5,0,-5
8981,1,0,177,0,-177
8982,1,1,352,1302,950
8983,1,0,289,0,-289
8984,1,1,1210,2198,988
8985,1,0,15,0,-15
8986,1,1,1264,1917,653
8987,0,0,27,0,-27
8988,1,1,2022,4050,2028
8989,1,0,22,0,-22
8990,0,0,31,0,-31
8991,1,0,62,0,-62
8992,1,1,153,2139,1986
8993,1,0,23,0,-23
8994,1,1,1212,1252,40
8995,1,1,1468,1473,5
8996,1,1,757,1246,489
8997,1,0,3,0,-3
8998,0,0,63,0,-63
8999,0,0,25,0,-25
9000,0,0,17,0,-17
9001,0,0,85,0,-85
9002,1,0,27,0,-27
9003,1,1,716,1503,787
9004,1,0,194,0,-194
9005,1,0,13,0,-13
9006,1,0,16,0,-16
9007,1,1,382,1341,959
9008,1,0,9,0,-9
9009,0,0,74,0,-74
9010,1,0,82,0,-82
9011,0,0,32,0,-32
9012,1,0,30,0,-30
9013,1,0,1,0,-1
9014,0,0,4,0,-4
9015,0,0,19,0,-19
9016,1,1,342,1422,1080
9017,0,0,1,0,-1
9018,1,1,16,1202,1186
9019,1,1,19,1328,1309
9020,0,0,26,0,-26
9021,0,0,9,0,-9
9022,1,1,871,1845,974
9023,1,1,39,1412,1373
9024,0,0,53,0,-53
9025,1,0,74,0,-74
9026,1,1,746,1545,799
9027,1,1,230,1287,1057
9028,0,0,38,0,-38
9029,0,0,41,0,-41
9030,1,0,5,0,-5
9031,0,0,13,0,-13
9032,1,0,29,0,-29
9033,1,1,1946,1859,-87
9034,1,0,5,0,-5
9035,1,1,684,1230,546
9036,1,0,40,0,-40
9037,0,0,8,0,-8
9038,0,0,13,0,-13
9039,0,0,4,0,-4
9040,1,0,77,0,-77
9041,1,0,18,0,-18
9042,1,1,1242,1677,435
9043,1,1,456,1483,1027
9044,0,0,47,0,-47
9045,0,0,84,0,-84
9046,0,0,117,0,-117
9047,1,1,412,1331,919
9048,1,1,481,1453,972
9049,1,0,24,0,-24
9050,0,0,221,0,-221
9051,1,0,104,0,-104
9052,1,1,537,2064,1527
9053,1,0,38,0,-38
9054,1,1,224,1249,1025
9055,1,0,34,0,-34
9056,0,0,140,0,-140
9057,0,0,10,0,-10
9058,1,1,923,2379,1456
9059,1,0,12,0,-12
9060,0,0,199,0,-199
9061,0,0,70,0,-70
9062,1,0,209,0,-209
9063,1,1,146,1941,1795
9064,1,1,1277,1238,-39
9065,1,0,26,0,-26
9066,1,1,85,1451,1366
9067,1,1,1276,1409,133
9068,1,1,277,2158,1881
9069,0,0,6,0,-6
9070,1,1,184,1391,1207
9071,0,0,33,0,-33
9072,1,1,478,1205,727
9073,0,0,8,0,-8
9074,0,0,21,0,-21
9075,1,0,8,0,-8
9076,1,0,50,0,-50
9077,1,1,1682,1849,167
9078,1,1,226,1413,1187
9079,1,1,8,2630,2622
9080,0,0,53,0,-53
9081,0,0,14,0,-14
9082,1,0,36,0,-36
9083,0,0,8,0,-8
9084,0,0,121,0,-121
9085,1,0,21,0,-21
9086,0,0,11,0,-11
9087,1,1,640,1242,602
9088,0,0,91,0,-91
9089,1,1,471,1705,1234
9090,1,1,86,1416,1330
9091,1,0,47,0,-47
9092,1,1,1090,1367,277
9093,0,0,49,0,-49
9094,1,0,126,0,-126
9095,1,0,19,0,-19
9096,1,1,245,1236,991
9097,1,1,64,1278,1214
9098,1,1,178,1235,1057
9099,1,1,1069,1213,144
9100,1,1,689,1200,511
9101,0,0,23,0,-23
9102,0,0,25,0,-25
9103,1,1,76,1324,1248
9104,1,1,222,1354,1132
9105,1,0,7,0,-7
9106,1,1,561,1304,743
9107,1,0,109,0,-109
9108,0,0,114,0,-114
9109,0,0,50,0,-50
9110,0,0,0,0,0
9111,0,0,3,0,-3
9112,1,0,37,0,-37
9113,0,0,27,0,-27
9114,0,0,0,0,0
9115,0,0,84,0,-84
9116,1,1,1031,1381,350
9117,1,1,636,1200,564
9118,1,1,309,1313,1004
9119,1,1,541,2730,2189
9120,0,0,2,0,-2
9121,1,1,921,1290,369
9122,0,0,92,0,-92
9123,1,0,38,0,-38
9124,0,0,10,0,-10
9125,1,0,28,0,-28
9126,1,0,21,0,-21
9127,0,0,166,0,-166
9128,1,0,24,0,-24
9129,1,1,304,1294,990
9130,1,1,35,1502,1467
9131,1,1,161,1484,1323
9132,0,0,68,0,-68
9133,0,0,86,0,-86
9134,1,1,421,1592,1171
9135,1,1,433,3149,2716
9136,1,1,34,2177,2143
9137,1,1,481,1483,1002
9138,0,0,33,0,-33
9139,0,0,77,0,-77
9140,1,0,93,0,-93
9141,1,1,1678,1719,41
9142,1,1,418,1939,1521
9143,0,0,86,0,-86
9144,1,1,79,1351,1272
9145,1,1,359,1357,998
9146,0,0,30,0,-30
9147,0,0,64,0,-64
9148,1,1,1038,1424,386
9149,1,1,392,1212,820
9150,0,0,2,0,-2
9151,1,0,30,0,-30
9152,1,0,39,0,-39
9153,1,0,0,0,0
9154,0,0,20,0,-20
9155,1,0,128,0,-128
9156,1,0,12,0,-12
9157,1,1,644,1257,613
9158,0,0,4,0,-4
9159,0,0,23,0,-23
9160,1,1,158,1237,1079
9161,1,1,84,1393,1309
9162,0,0,19,0,-19
9163,1,0,17,0,-17
9164,1,1,390,1779,1389
9165,1,0,66,0,-66
9166,0,0,42,0,-42
9167,0,0,53,0,-53
9168,0,0,61,0,-61
9169,1,0,12,0,-12
9170,1,0,45,0,-45
9171,0,0,6,0,-6
9172,0,0,38,0,-38
9173,1,1,74,1494,1420
9174,1,0,40,0,-40
9175,1,0,52,0,-52
9176,1,0,41,0,-41
9177,1,0,64,0,-64
9178,1,0,13,0,-13
9179,1,1,432,1332,900
9180,1,1,645,2103,1458
9181,0,0,214,0,-214
9182,1,0,5,0,-5
9183,1,1,40,2579,2539
9184,0,0,2,0,-2
9185,0,0,74,0,-74
9186,0,0,30,0,-30
9187,1,1,86,1887,1801
9188,1,1,1350,1202,-148
9189,0,0,12,0,-12
9190,0,0,4,0,-4
9191,1,1,270,1658,1388
9192,1,0,25,0,-25
9193,1,1,530,1357,827
9194,1,0,69,0,-69
9195,1,1,173,1440,1267
9196,1,1,206,1547,1341
9197,1,0,145,0,-145
9198,0,0,105,0,-105
9199,0,0,71,0,-71
9200,1,1,547,1769,1222
9201,0,0,75,0,-75
9202,1,1,461,1320,859
9203,0,0,59,0,-59
9204,1,0,6,0,-6
9205,1,0,104,0,-104
9206,1,1,1424,1442,18
9207,1,0,21,0,-21
9208,1,0,31,0,-31
9209,1,1,116,1227,1111
9210,0,0,77,0,-77
9211,1,0,44,0,-44
9212,1,0,61,0,-61
9213,1,0,26,0,-26
9214,1,0,13,0,-13
9215,1,1,362,1243,881
9216,1,0,45,0,-45
9217,1,0,29,0,-29
9218,1,1,493,1342,849
9219,0,0,19,0,-19
9220,0,0,21,0,-21
9221,1,1,106,2501,2395
9222,1,1,92,2348,2256
9223,0,0,16,0,-16
9224,0,0,48,0,-48
9225,1,1,824,1252,428
9226,0,0,44,0,-44
9227,1,0,29,0,-29
9228,1,1,689,1529,840
9229,0,0,92,0,-92
9230,1,1,636,1295,659
9231,1,1,192,1400,1208
9232,1,1,386,2558,2172
9233,1,1,640,1318,678
9234,1,0,45,0,-45
9235,1,0,57,0,-57
9236,0,0,30,0,-30
9237,1,1,1214,1783,569
9238,1,1,304,1516,1212
9239,1,0,30,0,-30
9240,0,0,4,0,-4
9241,1,1,516,1340,824
9242,1,1,308,1336,1028
9243,1,0,30,0,-30
9244,0,0,52,0,-52
9245,1,0,47,0,-47
9246,1,0,49,0,-49
9247,1,0,12,0,-12
9248,1,0,19,0,-19
9249,0,0,6,0,-6
9250,1,1,277,1604,1327
9251,1,0,40,0,-40
9252,1,1,94,1582,1488
9253,1,0,83,0,-83
9254,0,0,37,0,-37
9255,1,0,51,0,-51
9256,0,0,31,0,-31
9257,1,0,22,0,-22
9258,0,0,123,0,-123
9259,0,0,56,0,-56
9260,1,1,286,1260,974
9261,0,0,133,0,-133
9262,1,0,39,0,-39
9263,0,0,3,0,-3
9264,1,0,78,0,-78
9265,0,0,17,0,-17
9266,0,0,22,0,-22
9267,1,1,356,1702,1346
9268,1,1,199,1609,1410
9269,1,1,219,1414,1195
9270,0,0,187,0,-187
9271,0,0,62,0,-62
9272,0,0,86,0,-86
9273,1,1,1247,1673,426
9274,1,0,149,0,-149
9275,1,1,1213,1209,-4
9276,0,0,18,0,-18
9277,0,0,0,0,0
9278,1,1,851,1739,888
9279,0,0,38,0,-38
9280,0,0,15,0,-15
9281,1,1,551,2136,1585
9282,0,0,51,0,-51
9283,1,0,196,0,-196
9284,1,1,355,1276,921
9285,1,1,340,1358,1018
9286,0,0,19,0,-19
9287,1,0,32,0,-32
9288,1,0,50,0,-50
9289,1,1,594,1365,771
9290,1,1,811,1457,646
9291,1,1,171,1339,1168
9292,1,0,31,0,-31
9293,1,1,377,2509,2132
9294,0,0,101,0,-101
9295,0,0,7,0,-7
9296,1,1,110,1269,1159
9297,0,0,4,0,-4
9298,0,0,9,0,-9
9299,1,0,2,0,-2
9300,0,0,81,0,-81
9301,0,0,81,0,-81
9302,1,0,16,0,-16
9303,0,0,19,0,-19
9304,1,1,801,1215,414
9305,0,0,4,0,-4
9306,1,0,70,0,-70
9307,1,0,20,0,-20
9308,0,0,2,0,-2
9309,0,0,14,0,-14
9310,1,1,1732,3652,1920
9311,1,0,5,0,-5
9312,1,1,529,1385,856
9313,1,1,1543,1232,-311
9314,1,0,118,0,-118
9315,0,0,60,0,-60
9316,1,0,272,0,-272
9317,1,0,60,0,-60
9318,1,0,19,0,-19
9319,1,0,36,0,-36
9320,0,0,49,0,-49
9321,0,0,116,0,-116
9322,1,1,688,1787,1099
9323,1,1,796,2879,2083
9324,0,0,46,0,-46
9325,1,0,7,0,-7
9326,1,0,29,0,-29
9327,0,0,5,0,-5
9328,1,1,444,1645,1201
9329,0,0,31,0,-31
9330,1,0,51,0,-51
9331,1,0,73,0,-73
9332,1,0,9,0,-9
9333,1,0,29,0,-29
9334,0,0,123,0,-123
9335,0,0,11,0,-11
9336,0,0,143,0,-143
9337,0,0,18,0,-18
9338,1,0,5,0,-5
9339,0,0,56,0,-56
9340,0,0,6,0,-6
9341,0,0,20,0,-20
9342,1,0,16,0,-16
9343,1,0,49,0,-49
9344,1,0,20,0,-20
9345,1,1,320,2839,2519
9346,1,1,171,4743,4572
9347,0,0,60,0,-60
9348,0,0,73,0,-73
9349,0,0,88,0,-88
9350,1,1,1528,1856,328
9351,1,0,10,0,-10
9352,1,1,886,1557,671
9353,1,0,6,0,-6
9354,1,1,1067,1223,156
9355,1,0,65,0,-65
9356,1,1,186,1497,1311
9357,0,0,50,0,-50
9358,0,0,7,0,-7
9359,1,1,165,1288,1123
9360,0,0,102,0,-102
9361,0,0,79,0,-79
9362,1,0,96,0,-96
9363,1,0,181,0,-181
9364,1,0,41,0,-41
9365,0,0,36,0,-36
9366,1,1,216,1338,1122
9367,1,1,297,2000,1703
9368,1,0,13,0,-13
9369,0,0,0,0,0
9370,0,0,9,0,-9
9371,1,0,110,0,-110
9372,0,0,24,0,-24
9373,1,0,87,0,-87
9374,0,0,52,0,-52
9375,0,0,63,0,-63
9376,1,1,826,1710,884
9377,0,0,8,0,-8
9378,1,0,92,0,-92
9379,1,0,176,0,-176
9380,1,1,133,1375,1242
9381,1,0,12,0,-12
9382,1,0,19,0,-19
9383,1,0,49,0,-49
9384,0,0,29,0,-29
9385,0,0,62,0,-62
9386,1,1,385,2258,1873
9387,1,0,52,0,-52
9388,1,1,1145,1425,280
9389,1,0,31,0,-31
9390,0,0,49,0,-49
9391,0,0,38,0,-38
9392,1,0,5,0,-5
9393,0,0,19,0,-19
9394,1,0,66,0,-66
9395,0,0,47,0,-47
9396,0,0,30,0,-30
9397,1,0,3,0,-3
9398,1,0,11,0,-11
9399,1,0,19,0,-19
9400,1,0,67,0,-67
9401,1,0,28,0,-28
9402,0,0,7,0,-7
9403,1,1,75,2430,2355
9404,1,1,945,1224,279
9405,1,1,727,1303,576
9406,1,0,67,0,-67
9407,1,1,61,1389,1328
9408,1,1,304,1263,959
9409,1,0,0,0,0
9410,1,0,83,0,-83
9411,0,0,13,0,-13
9412,0,0,17,0,-17
9413,0,0,51,0,-51
9414,1,0,28,0,-28
9415,1,1,207,1252,1045
9416,0,0,26,0,-26
9417,1,0,208,0,-208
9418,1,0,9,0,-9
9419,1,0,36,0,-36
9420,1,1,79,1200,1121
9421,0,0,131,0,-131
9422,0,0,64,0,-64
9423,1,0,52,0,-52
9424,1,0,94,0,-94
9425,0,0,53,0,-53
9426,0,0,23,0,-23
9427,1,1,46,1260,1214
9428,1,1,30,1553,1523
9429,1,1,1284,1887,603
9430,0,0,97,0,-97
9431,0,0,16,0,-16
9432,1,1,1393,1203,-190
9433,0,0,41,0,-41
9434,1,0,1,0,-1
9435,0,0,60,0,-60
9436,1,1,487,1330,843
9437,0,0,2,0,-2
9438,1,1,751,1705,954
9439,0,0,46,0,-46
9440,0,0,23,0,-23
9441,1,0,3,0,-3
9442,1,0,162,0,-162
9443,1,0,39,0,-39
9444,1,1,242,1928,1686
9445,1,1,568,1581,1013
9446,1,1,1381,1921,540
9447,1,1,7,1506,1499
9448,1,0,7,0,-7
9449,1,0,6,0,-6
9450,0,0,6,0,-6
9451,0,0,48,0,-48
9452,1,1,334,1364,1030
9453,1,1,314,1655,1341
9454,0,0,42,0,-42
9455,0,0,31,0,-31
9456,0,0,8,0,-8
9457,0,0,157,0,-157
9458,1,0,41,0,-41
9459,1,1,70,1222,1152
9460,1,1,16,1477,1461
9461,0,0,15,0,-15
9462,1,0,30,0,-30
9463,0,0,16,0,-16
9464,1,0,36,0,-36
9465,1,0,42,0,-42
9466,0,0,43,0,-43
9467,0,0,9,0,-9
9468,1,0,24,0,-24
9469,1,0,27,0,-27
9470,1,1,625,1272,647
9471,0,0,12,0,-12
9472,0,0,22,0,-22
9473,0,0,13,0,-13
9474,0,0,8,0,-8
9475,1,1,270,2569,2299
9476,1,0,44,0,-44
9477,1,0,51,0,-51
9478,0,0,19,0,-19
9479,1,0,118,0,-118
9480,0,0,20,0,-20
9481,1,1,154,1211,1057
9482,1,0,83,0,-83
9483,0,0,115,0,-115
9484,1,1,38,2024,1986
9485,1,0,12,0,-12
9486,1,1,2351,1471,-880
9487,1,1,244,1472,1228
9488,1,0,97,0,-97
9489,1,0,40,0,-40
9490,0,0,5,0,-5
9491,0,0,78,0,-78
9492,1,1,313,4537,4224
9493,1,0,57,0,-57
9494,0,0,149,0,-149
9495,0,0,9,0,-9
9496,0,0,26,0,-26
9497,0,0,206,0,-206
9498,0,0,25,0,-25
9499,1,0,6,0,-6
9500,1,1,309,1412,1103
9501,1,0,205,0,-205
9502,0,0,8,0,-8
9503,1,0,78,0,-78
9504,1,1,291,1428,1137
9505,1,0,26,0,-26
9506,0,0,22,0,-22
9507,1,1,323,1262,939
9508,1,0,14,0,-14
9509,0,0,72,0,-72
9510,0,0,3,0,-3
9511,0,0,127,0,-127
9512,1,1,166,1314,1148
9513,1,1,55,1492,1437
9514,0,0,11,0,-11
9515,1,1,1423,1212,-211
9516,1,0,140,0,-140
9517,0,0,7,0,-7
9518,1,0,21,0,-21
9519,1,0,8,0,-8
9520,1,0,15,0,-15
9521,1,1,229,1632,1403
9522,1,1,547,1432,885
9523,1,0,33,0,-33
9524,0,0,39,0,-39
9525,1,0,35,0,-35
9526,1,0,62,0,-62
9527,1,1,291,1674,1383
9528,0,0,89,0,-89
9529,1,0,13,0,-13
9530,1,0,54,0,-54
9531,1,1,814,1307,493
9532,0,0,15,0,-15
9533,0,0,54,0,-54
9534,1,1,53,1825,1772
9535,0,0,139,0,-139
9536,1,1,231,4945,4714
9537,0,0,0,0,0
9538,1,0,37,0,-37
9539,1,1,653,7880,7227
9540,1,0,42,0,-42
9541,1,1,207,1410,1203
9542,1,0,69,0,-69
9543,0,0,34,0,-34
9544,0,0,17,0,-17
9545,0,0,0,0,0
9546,1,0,4,0,-4
9547,0,0,40,0,-40
9548,1,0,25,0,-25
9549,0,0,23,0,-23
9550,1,0,82,0,-82
9551,1,1,30,1256,1226
9552,1,1,185,1766,1581
9553,0,0,94,0,-94
9554,1,0,38,0,-38
9555,1,1,95,3115,3020
9556,0,0,28,0,-28
9557,0,0,23,0,-23
9558,1,1,684,1448,764
9559,1,0,55,0,-55
9560,0,0,74,0,-74
9561,1,0,97,0,-97
9562,0,0,78,0,-78
9563,0,0,136,0,-136
9564,1,1,895,1271,376
9565,1,0,69,0,-69
9566,1,0,119,0,-119
9567,1,0,64,0,-64
9568,1,0,111,0,-111
9569,1,0,37,0,-37
9570,0,0,136,0,-136
9571,1,1,9,1228,1219
9572,0,0,21,0,-21
9573,1,1,1056,1235,179
9574,1,1,153,1631,1478
9575,1,1,1187,1668,481
9576,1,0,15,0,-15
9577,0,0,11,0,-11
9578,1,1,635,1302,667
9579,0,0,71,0,-71
9580,1,0,25,0,-25
9581,0,0,84,0,-84
9582,0,0,47,0,-47
9583,1,1,50,1225,1175
9584,1,0,24,0,-24
9585,1,1,482,1356,874
9586,1,0,58,0,-58
9587,1,0,20,0,-20
9588,1,0,31,0,-31
9589,0,0,17,0,-17
9590,1,0,2,0,-2
9591,0,0,25,0,-25
9592,0,0,76,0,-76
9593,1,0,29,0,-29
9594,1,0,35,0,-35
9595,1,0,2,0,-2
9596,0,0,29,0,-29
9597,1,0,124,0,-124
9598,1,1,366,1242,876
9599,1,0,50,0,-50
9600,1,1,328,1421,1093
9601,1,0,26,0,-26
9602,0,0,19,0,-19
9603,0,0,25,0,-25
9604,1,1,252,1765,1513
9605,1,1,197,1813,1616
9606,1,1,276,1318,1042
9607,0,0,0,0,0
9608,1,0,0,0,0
9609,0,0,33,0,-33
9610,0,0,44,0,-44
9611,1,1,1011,1414,403
9612,1,0,17,0,-17
9613,0,0,69,0,-69
9614,1,1,1023,1201,178
9615,1,0,75,0,-75
9616,0,0,15,0,-15
9617,0,0,31,0,-31
9618,0,0,65,0,-65
9619,0,0,436,0,-436
9620,1,0,13,0,-13
9621,0,0,35,0,-35
9622,1,1,432,1822,1390
9623,0,0,31,0,-31
9624,1,1,157,1284,1127
9625,1,1,684,1875,1191
9626,0,0,29,0,-29
9627,1,1,514,1204,690
9628,0,0,17,0,-17
9629,0,0,43,0,-43
9630,1,1,800,1878,1078
9631,1,0,137,0,-137
9632,1,1,11,1402,1391
9633,1,1,945,1261,316
9634,0,0,4,0,-4
9635,1,0,115,0,-115
9636,1,1,179,1382,1203
9637,0,0,25,0,-25
9638,1,0,8,0,-8
9639,0,0,18,0,-18
9640,0,0,39,0,-39
9641,1,1,353,1430,1077
9642,1,1,801,1335,534
9643,0,0,51,0,-51
9644,0,0,138,0,-138
9645,0,0,70,0,-70
9646,0,0,46,0,-46
9647,0,0,36,0,-36
9648,1,1,3554,1303,-2251
9649,1,1,412,1584,1172
9650,0,0,6,0,-6
9651,1,1,155,2145,1990
9652,1,0,40,0,-40
9653,0,0,181,0,-181
9654,0,0,30,0,-30
9655,1,0,56,0,-56
9656,0,0,37,0,-37
9657,1,0,83,0,-83
9658,1,1,306,1804,1498
9659,1,1,427,1269,842
9660,0,0,19,0,-19
9661,1,1,241,1275,1034
9662,0,0,5,0,-5
9663,0,0,17,0,-17
9664,1,0,33,0,-33
9665,0,0,17,0,-17
9666,1,0,57,0,-57
9667,0,0,49,0,-49
9668,1,1,155,1408,1253
9669,1,0,63,0,-63
9670,1,1,717,1593,876
9671,0,0,4,0,-4
9672,0,0,95,0,-95
9673,0,0,194,0,-194
9674,1,0,41,0,-41
9675,1,1,93,1749,1656
9676,1,0,71,0,-71
9677,1,1,864,1559,695
9678,1,1,201,1217,1016
9679,1,0,10,0,-10
9680,1,0,120,0,-120
9681,1,1,422,1385,963
9682,0,0,21,0,-21
9683,1,0,104,0,-104
9684,1,1,312,1376,1064
9685,1,0,75,0,-75
9686,1,0,44,0,-44
9687,0,0,25,0,-25
9688,1,1,509,1368,859
9689,1,0,10,0,-10
9690,1,0,13,0,-13
9691,0,0,134,0,-134
9692,1,0,142,0,-142
9693,0,0,0,0,0
9694,1,0,204,0,-204
9695,1,0,122,0,-122
9696,1,1,1001,1581,580
9697,0,0,1,0,-1
9698,1,0,28,0,-28
9699,0,0,5,0,-5
9700,0,0,60,0,-60
9701,0,0,24,0,-24
9702,1,1,1001,3146,2145
9703,1,1,443,1297,854
9704,1,0,3,0,-3
9705,1,0,30,0,-30
9706,0,0,71,0,-71
9707,0,0,9,0,-9
9708,1,0,175,0,-175
9709,1,1,194,1201,1007
9710,1,1,2662,1202,-1460
9711,1,1,1238,1251,13
9712,1,0,16,0,-16
9713,0,0,1,0,-1
9714,0,0,74,0,-74
9715,1,1,569,1341,772
9716,1,1,226,1209,983
9717,1,1,2001,2168,167
9718,0,0,23,0,-23
9719,1,0,73,0,-73
9720,1,0,121,0,-121
9721,0,0,18,0,-18
9722,1,1,548,1325,777
9723,1,0,108,0,-108
9724,1,1,625,1319,694
9725,0,0,34,0,-34
9726,1,1,343,1458,1115
9727,0,0,2,0,-2
9728,0,0,86,0,-86
9729,0,0,0,0,0
9730,1,0,53,0,-53
9731,0,0,10,0,-10
9732,1,1,1794,1364,-430
9733,0,0,42,0,-42
9734,1,1,224,2064,1840
9735,1,1,57,1215,1158
9736,1,1,333,1222,889
9737,1,0,32,0,-32
9738,1,0,22,0,-22
9739,0,0,23,0,-23
9740,0,0,148,0,-148
9741,1,1,80,1375,1295
9742,1,1,720,1393,673
9743,1,1,180,1959,1779
9744,1,0,13,0,-13
9745,1,0,84,0,-84
9746,0,0,9,0,-9
9747,1,0,56,0,-56
9748,0,0,8,0,-8
9749,1,0,26,0,-26
9750,0,0,21,0,-21
9751,1,0,9,0,-9
9752,1,0,33,0,-33
9753,0,0,133,0,-133
9754,0,0,41,0,-41
9755,0,0,176,0,-176
9756,0,0,14,0,-14
9757,0,0,36,0,-36
9758,0,0,10,0,-10
9759,1,1,1005,1867,862
9760,1,0,103,0,-103
9761,0,0,24,0,-24
9762,1,0,28,0,-28
9763,0,0,187,0,-187
9764,0,0,152,0,-152
9765,1,0,45,0,-45
9766,1,1,683,2317,1634
9767,1,0,9,0,-9
9768,1,0,61,0,-61
9769,1,0,10,0,-10
9770,0,0,51,0,-51
9771,1,1,463,1316,853
9772,1,1,120,1283,1163
9773,0,0,35,0,-35
9774,0,0,8,0,-8
9775,1,0,51,0,-51
9776,0,0,76,0,-76
9777,1,1,33,1354,1321
9778,1,0,293,0,-293
9779,0,0,49,0,-49
9780,0,0,1,0,-1
9781,0,0,169,0,-169
9782,1,0,0,0,0
9783,1,0,22,0,-22
9784,0,0,2,0,-2
9785,0,0,50,0,-50
9786,1,1,1086,1270,184
9787,0,0,40,0,-40
9788,1,1,743,1577,834
9789,0,0,0,0,0
9790,1,1,833,1897,1064
9791,0,0,14,0,-14
9792,1,0,42,0,-42
9793,1,1,1074,2819,1745
9794,1,0,147,0,-147
9795,1,0,94,0,-94
9796,0,0,23,0,-23
9797,1,1,163,3165,3002
9798,1,0,117,0,-117
9799,1,0,87,0,-87
9800,1,1,268,1569,1301
9801,1,1,273,1207,934
9802,1,0,83,0,-83
9803,0,0,12,0,-12
9804,1,0,242,0,-242
9805,0,0,14,0,-14
9806,1,1,272,1392,1120
9807,1,0,84,0,-84
9808,1,1,300,1520,1220
9809,1,0,13,0,-13
9810,1,1,455,1329,874
9811,0,0,24,0,-24
9812,1,1,553,1238,685
9813,1,0,17,0,-17
9814,1,0,247,0,-247
9815,1,1,295,1237,942
9816,0,0,45,0,-45
9817,1,1,20,1571,1551
9818,1,0,88,0,-88
9819,0,0,122,0,-122
9820,0,0,24,0,-24
9821,0,0,4,0,-4
9822,0,0,52,0,-52
9823,0,0,65,0,-65
9824,0,0,87,0,-87
9825,1,1,133,1218,1085
9826,0,0,46,0,-46
9827,1,1,632,1280,648
9828,1,1,565,1229,664
9829,1,0,74,0,-74
9830,1,0,25,0,-25
9831,0,0,1,0,-1
9832,1,1,192,1309,1117
9833,1,1,785,1301,516
9834,1,0,101,0,-101
9835,1,0,11,0,-11
9836,1,1,457,1779,1322
9837,0,0,14,0,-14
9838,1,0,156,0,-156
9839,1,0,108,0,-108
9840,0,0,37,0,-37
9841,1,1,817,6922,6105
9842,1,0,66,0,-66
9843,1,0,25,0,-25
9844,1,1,393,1993,1600
9845,0,0,19,0,-19
9846,1,1,59,1436,1377
9847,0,0,3,0,-3
9848,1,0,2,0,-2
9849,0,0,13,0,-13
9850,1,1,189,1212,1023
9851,0,0,0,0,0
9852,0,0,184,0,-184
9853,1,0,33,0,-33
9854,0,0,7,0,-7
9855,0,0,23,0,-23
9856,0,0,60,0,-60
9857,0,0,66,0,-66
9858,1,1,987,3034,2047
9859,0,0,154,0,-154
9860,1,1,544,1556,1012
9861,0,0,21,0,-21
9862,1,1,600,2076,1476
9863,1,1,264,1274,1010
9864,1,1,812,1660,848
9865,0,0,31,0,-31
9866,1,1,693,1259,566
9867,0,0,5,0,-5
9868,1,1,1001,1627,626
9869,1,1,1033,1270,237
9870,0,0,14,0,-14
9871,1,1,279,1667,1388
9872,0,0,14,0,-14
9873,0,0,5,0,-5
9874,0,0,15,0,-15
9875,1,0,26,0,-26
9876,1,0,56,0,-56
9877,0,0,12,0,-12
9878,1,0,13,0,-13
9879,0,0,6,0,-6
9880,0,0,254,0,-254
9881,1,1,863,2092,1229
9882,0,0,31,0,-31
9883,1,0,1,0,-1
9884,0,0,9,0,-9
9885,1,0,152,0,-152
9886,0,0,52,0,-52
9887,0,0,18,0,-18
9888,1,1,152,1566,1414
9889,0,0,14,0,-14
9890,1,0,91,0,-91
9891,1,0,20,0,-20
9892,0,0,13,0,-13
9893,1,1,168,1247,1079
9894,1,0,145,0,-145
9895,1,1,206,1219,1013
9896,0,0,6,0,-6
9897,1,0,62,0,-62
9898,1,0,42,0,-42
9899,1,0,21,0,-21
9900,1,1,482,2224,1742
9901,1,1,786,1253,467
9902,0,0,31,0,-31
9903,1,1,1316,1564,248
9904,1,1,2253,1214,-1039
9905,0,0,12,0,-12
9906,1,0,1,0,-1
9907,1,1,380,1600,1220
9908,1,0,1,0,-1
9909,0,0,6,0,-6
9910,1,0,44,0,-44
9911,0,0,10,0,-10
9912,1,1,768,1404,636
9913,1,1,312,2028,1716
9914,1,1,286,1520,1234
9915,1,0,15,0,-15
9916,0,0,70,0,-70
9917,1,1,164,1252,1088
9918,1,1,2214,1250,-964
9919,1,1,179,1626,1447
9920,0,0,65,0,-65
9921,0,0,15,0,-15
9922,1,0,3,0,-3
9923,1,1,658,1366,708
9924,1,0,42,0,-42
9925,0,0,34,0,-34
9926,0,0,9,0,-9
9927,1,0,138,0,-138
9928,1,1,1028,1362,334
9929,1,0,134,0,-134
9930,0,0,6,0,-6
9931,1,0,116,0,-116
9932,1,0,107,0,-107
9933,1,0,17,0,-17
9934,0,0,9,0,-9
9935,0,0,32,0,-32
9936,1,1,372,1568,1196
9937,1,1,1873,2511,638
9938,1,1,359,1556,1197
9939,0,0,46,0,-46
9940,1,0,22,0,-22
9941,1,1,2364,1540,-824
9942,0,0,28,0,-28
9943,1,0,85,0,-85
9944,1,1,404,1751,1347
9945,1,1,173,1291,1118
9946,1,0,62,0,-62
9947,1,1,608,1574,966
9948,1,0,28,0,-28
9949,1,0,94,0,-94
9950,1,0,82,0,-82
9951,0,0,117,0,-117
9952,0,0,23,0,-23
9953,0,0,5,0,-5
9954,1,0,14,0,-14
9955,0,0,22,0,-22
9956,1,0,22,0,-22
9957,0,0,38,0,-38
9958,1,1,247,1548,1301
9959,1,1,327,1367,1040
9960,1,0,14,0,-14
9961,0,0,19,0,-19
9962,0,0,59,0,-59
9963,0,0,5,0,-5
9964,1,1,411,3073,2662
9965,0,0,15,0,-15
9966,0,0,59,0,-59
9967,0,0,75,0,-75
9968,0,0,119,0,-119
9969,1,1,1207,4843,3636
9970,1,1,404,1390,986
9971,1,1,325,1795,1470
9972,0,0,15,0,-15
9973,0,0,4,0,-4
9974,0,0,34,0,-34
9975,0,0,14,0,-14
9976,1,0,90,0,-90
9977,0,0,120,0,-120
9978,1,0,19,0,-19
9979,1,0,25,0,-25
9980,0,0,17,0,-17
9981,0,0,50,0,-50
9982,1,1,613,1859,1246
9983,1,0,42,0,-42
9984,0,0,131,0,-131
9985,1,1,14,1214,1200
9986,0,0,23,0,-23
9987,1,1,506,1415,909
9988,1,1,953,1370,417
9989,0,0,12,0,-12
9990,1,0,28,0,-28
9991,0,0,25,0,-25
9992,1,0,27,0,-27
9993,0,0,6,0,-6
9994,0,0,134,0,-134
9995,1,1,334,1690,1356
9996,0,0,81,0,-81
9997,1,1,1176,2391,1215
9998,1,1,63,1296,1233
9999,0,0,40,0,-40
10000,1,1,285,1475,1190
10001,1,1,287,1347,1060
10002,0,0,19,0,-19
10003,1,0,39,0,-39
10004,1,0,16,0,-16
10005,1,1,31,1380,1349
10006,1,1,2234,1516,-718
10007,1,0,12,0,-12
10008,1,0,102,0,-102
10009,1,1,178,1982,1804
10010,1,0,29,0,-29
10011,1,1,344,1278,934
10012,0,0,22,0,-22
10013,1,1,85,2054,1969
10014,0,0,14,0,-14
10015,1,1,483,1249,766
10016,1,1,1596,1644,48
10017,0,0,62,0,-62
10018,1,1,475,1580,1105
10019,1,1,489,1558,1069
10020,1,1,1406,1302,-104
10021,1,0,22,0,-22
10022,0,0,8,0,-8
10023,0,0,6,0,-6
10024,1,0,152,0,-152
10025,0,0,23,0,-23
10026,1,1,270,1338,1068
10027,0,0,45,0,-45
10028,0,0,45,0,-45
10029,1,1,1837,1301,-536
10030,0,0,5,0,-5
10031,0,0,105,0,-105
10032,0,0,160,0,-160
10033,0,0,88,0,-88
10034,0,0,28,0,-28
10035,0,0,53,0,-53
10036,0,0,9,0,-9
10037,0,0,6,0,-6
10038,1,0,11,0,-11
10039,1,1,209,1326,1117
10040,1,1,302,1220,918
10041,0,0,22,0,-22
10042,1,0,47,0,-47
10043,0,0,29,0,-29
10044,0,0,15,0,-15
10045,1,1,36,2585,2549
10046,1,1,122,1359,1237
10047,0,0,83,0,-83
10048,0,0,20,0,-20
10049,1,0,59,0,-59
10050,1,0,2,0,-2
10051,0,0,142,0,-142
10052,0,0,28,0,-28
10053,1,1,17,1834,1817
10054,1,1,690,1292,602
10055,1,0,95,0,-95
10056,1,0,51,0,-51
10057,1,0,28,0,-28
10058,0,0,0,0,0
10059,0,0,118,0,-118
10060,1,1,793,1241,448
10061,1,0,7,0,-7
10062,0,0,23,0,-23
10063,1,1,459,1370,911
10064,0,0,73,0,-73
10065,1,1,449,1314,865
10066,0,0,22,0,-22
10067,1,0,15,0,-15
10068,1,0,46,0,-46
10069,1,1,98,1295,1197
10070,0,0,16,0,-16
10071,1,1,998,1210,212
10072,1,0,4,0,-4
10073,1,0,53,0,-53
10074,0,0,12,0,-12
10075,1,0,52,0,-52
10076,1,0,2,0,-2
10077,0,0,7,0,-7
10078,1,1,649,1269,620
10079,0,0,39,0,-39
10080,1,1,316,3661,3345
10081,0,0,23,0,-23
10082,1,0,3,0,-3
10083,1,0,53,0,-53
10084,1,0,24,0,-24
10085,0,0,24,0,-24
10086,1,1,497,1467,970
10087,0,0,59,0,-59
10088,0,0,34,0,-34
10089,1,0,37,0,-37
10090,1,1,209,1371,1162
10091,0,0,4,0,-4
10092,0,0,27,0,-27
10093,0,0,0,0,0
10094,1,0,17,0,-17
10095,1,1,749,1366,617
10096,0,0,40,0,-40
10097,0,0,160,0,-160
10098,0,0,10,0,-10
10099,0,0,5,0,-5
10100,1,1,580,1665,1085
10101,0,0,1,0,-1
10102,1,1,656,1222,566
10103,0,0,36,0,-36
10104,0,0,16,0,-16
10105,1,1,292,1277,985
10106,1,0,21,0,-21
10107,0,0,58,0,-58
10108,1,1,433,1482,1049
10109,1,0,44,0,-44
10110,1,0,3,0,-3
10111,1,1,140,1897,1757
10112,0,0,18,0,-18
10113,0,0,87,0,-87
10114,1,1,560,1520,960
10115,0,0,94,0,-94
10116,0,0,46,0,-46
10117,1,1,322,2224,1902
10118,1,1,256,1335,1079
10119,1,0,57,0,-57
10120,0,0,56,0,-56
10121,1,1,606,1262,656
10122,0,0,21,0,-21
10123,1,1,715,1233,518
10124,0,0,12,0,-12
10125,1,0,10,0,-10
10126,0,0,28,0,-28
10127,0,0,7,0,-7
10128,1,1,660,1388,728
10129,0,0,29,0,-29
10130,0,0,54,0,-54
10131,1,0,13,0,-13
10132,0,0,30,0,-30
10133,0,0,30,0,-30
10134,0,0,96,0,-96
10135,0,0,6,0,-6
10136,1,1,1781,1700,-81
10137,1,1,44,1416,1372
10138,1,0,0,0,0
10139,1,1,295,1200,905
10140,1,0,148,0,-148
10141,0,0,12,0,-12
10142,0,0,92,0,-92
10143,1,0,2,0,-2
10144,1,0,76,0,-76
10145,1,1,880,1568,688
10146,1,1,1031,1668,637
10147,1,0,48,0,-48
10148,1,0,34,0,-34
10149,0,0,16,0,-16
10150,1,0,10,0,-10
10151,1,0,31,0,-31
10152,1,1,200,1487,1287
10153,0,0,49,0,-49
10154,1,1,191,1208,1017
10155,1,0,47,0,-47
10156,1,0,21,0,-21
10157,0,0,65,0,-65
10158,0,0,44,0,-44
10159,1,1,386,1220,834
10160,1,0,74,0,-74
10161,1,1,86,1734,1648
10162,1,1,516,1285,769
10163,0,0,77,0,-77
10164,0,0,5,0,-5
10165,1,1,485,1602,1117
10166,0,0,2,0,-2
10167,1,1,116,1472,1356
10168,0,0,2,0,-2
10169,1,1,882,1665,783
10170,1,0,60,0,-60
10171,0,0,36,0,-36
10172,1,0,0,0,0
10173,1,0,35,0,-35
10174,0,0,14,0,-14
10175,1,0,2,0,-2
10176,1,0,4,0,-4
10177,1,0,34,0,-34
10178,1,1,274,1295,1021
10179,1,0,8,0,-8
10180,1,1,468,1588,1120
10181,1,1,202,1435,1233
10182,0,0,175,0,-175
10183,1,0,60,0,-60
10184,0,0,122,0,-122
10185,0,0,39,0,-39
10186,0,0,37,0,-37
10187,1,1,465,1458,993
10188,1,0,63,0,-63
10189,0,0,2,0,-2
10190,0,0,4,0,-4
10191,1,1,333,1229,896
10192,0,0,13,0,-13
10193,1,1,205,1443,1238
10194,1,0,76,0,-76
10195,0,0,29,0,-29
10196,0,0,19,0,-19
10197,0,0,54,0,-54
10198,0,0,43,0,-43
10199,1,1,82,1343,1261
10200,1,1,172,1242,1070
10201,0,0,24,0,-24
10202,1,1,1252,1476,224
10203,1,0,23,0,-23
10204,0,0,57,0,-57
10205,0,0,26,0,-26
10206,1,1,307,1663,1356
10207,0,0,30,0,-30
10208,1,0,93,0,-93
10209,0,0,133,0,-133
10210,1,0,27,0,-27
10211,1,1,510,1282,772
10212,0,0,37,0,-37
10213,0,0,37,0,-37
10214,1,0,101,0,-101
10215,0,0,85,0,-85
10216,0,0,110,0,-110
10217,1,0,5,0,-5
10218,0,0,4,0,-4
10219,0,0,14,0,-14
10220,0,0,27,0,-27
10221,1,0,78,0,-78
10222,1,0,37,0,-37
10223,0,0,48,0,-48
10224,1,1,312,1475,1163
10225,1,0,5,0,-5
10226,0,0,21,0,-21
10227,1,1,232,1589,1357
10228,1,1,511,1528,1017
10229,1,1,222,1258,1036
10230,1,0,51,0,-51
10231,0,0,71,0,-71
10232,1,0,109,0,-109
10233,0,0,13,0,-13
10234,0,0,23,0,-23
10235,0,0,59,0,-59
10236,1,1,505,2244,1739
10237,0,0,13,0,-13
10238,0,0,37,0,-37
10239,1,0,1,0,-1
10240,0,0,63,0,-63
10241,0,0,78,0,-78
10242,1,0,120,0,-120
10243,1,1,832,2208,1376
10244,1,0,20,0,-20
10245,0,0,3,0,-3
10246,1,1,382,1341,959
10247,0,0,35,0,-35
10248,0,0,65,0,-65
10249,1,1,455,1835,1380
10250,1,0,28,0,-28
10251,1,0,6,0,-6
10252,0,0,380,0,-380
10253,1,0,0,0,0
10254,1,0,93,0,-93
10255,1,1,151,1589,1438
10256,0,0,44,0,-44
10257,0,0,8,0,-8
10258,1,1,444,1863,1419
10259,1,0,132,0,-132
10260,0,0,116,0,-116
10261,1,1,796,1574,778
10262,1,1,268,1639,1371
10263,1,0,120,0,-120
10264,1,1,62,1719,1657
10265,1,0,7,0,-7
10266,1,1,435,1641,1206
10267,0,0,71,0,-71
10268,1,1,959,1417,458
10269,1,1,845,1200,355
10270,0,0,25,0,-25
10271,0,0,39,0,-39
10272,0,0,28,0,-28
10273,0,0,70,0,-70
10274,1,1,879,1431,552
10275,1,1,36,1411,1375
10276,0,0,66,0,-66
10277,1,0,31,0,-31
10278,1,0,3,0,-3
10279,1,0,11,0,-11
10280,1,1,242,1311,1069
10281,1,1,303,1303,1000
10282,1,1,959,1213,254
10283,1,1,334,1226,892
10284,1,1,1357,1244,-113
10285,1,1,407,2010,1603
10286,0,0,8,0,-8
10287,0,0,1,0,-1
10288,0,0,68,0,-68
10289,1,1,580,1418,838
10290,0,0,18,0,-18
10291,1,1,173,1327,1154
10292,0,0,4,0,-4
10293,1,1,1763,2117,354
10294,1,1,1006,1398,392
10295,1,0,163,0,-163
10296,1,1,232,2182,1950
10297,1,0,14,0,-14
10298,1,0,45,0,-45
10299,1,1,692,1289,597
10300,1,0,18,0,-18
10301,1,1,258,1555,1297
10302,1,0,21,0,-21
10303,0,0,46,0,-46
10304,1,0,117,0,-117
10305,1,1,237,1317,1080
10306,1,1,551,1303,752
10307,1,1,1364,1766,402
10308,0,0,290,0,-290
10309,0,0,76,0,-76
10310,1,1,620,1236,616
10311,1,1,311,1374,1063
10312,0,0,36,0,-36
10313,1,0,153,0,-153
10314,1,1,353,2412,2059
10315,0,0,0,0,0
10316,0,0,50,0,-50
10317,1,0,6,0,-6
10318,0,0,61,0,-61
10319,0,0,176,0,-176
10320,1,0,31,0,-31
10321,1,0,34,0,-34
10322,1,0,60,0,-60
10323,0,0,42,0,-42
10324,1,0,37,0,-37
10325,1,1,304,2594,2290
10326,1,0,21,0,-21
10327,1,1,269,1911,1642
10328,1,0,187,0,-187
10329,1,0,4,0,-4
10330,1,1,353,1319,966
10331,1,1,1937,2663,726
10332,0,0,103,0,-103
10333,1,1,91,1211,1120
10334,0,0,3,0,-3
10335,1,1,859,1647,788
10336,1,0,21,0,-21
10337,1,0,2,0,-2
10338,1,0,76,0,-76
10339,0,0,19,0,-19
10340,0,0,48,0,-48
10341,1,0,16,0,-16
10342,1,0,28,0,-28
10343,0,0,12,0,-12
10344,0,0,0,0,0
10345,1,1,470,1265,795
10346,1,1,219,1432,1213
10347,0,0,53,0,-53
10348,0,0,10,0,-10
10349,0,0,87,0,-87
10350,0,0,84,0,-84
10351,0,0,53,0,-53
10352,1,1,629,1398,769
10353,1,1,220,2588,2368
10354,1,0,58,0,-58
10355,1,0,30,0,-30
10356,0,0,1,0,-1
10357,0,0,49,0,-49
10358,1,1,1592,1394,-198
10359,1,0,21,0,-21
10360,0,0,33,0,-33
10361,1,1,374,1331,957
10362,0,0,14,0,-14
10363,0,0,23,0,-23
10364,0,0,36,0,-36
10365,1,1,34,1420,1386
10366,1,1,955,1245,290
10367,0,0,167,0,-167
10368,1,1,271,1210,939
10369,0,0,61,0,-61
10370,1,0,13,0,-13
10371,0,0,77,0,-77
10372,1,1,217,1801,1584
10373,1,1,21,1499,1478
10374,1,0,4,0,-4
10375,0,0,18,0,-18
10376,1,1,101,1514,1413
10377,0,0,84,0,-84
10378,0,0,73,0,-73
10379,1,1,243,1260,1017
10380,1,0,4,0,-4
10381,0,0,74,0,-74
10382,1,1,428,1360,932
10383,0,0,24,0,-24
10384,0,0,24,0,-24
10385,1,0,2,0,-2
10386,0,0,74,0,-74
10387,1,1,189,2708,2519
10388,1,0,22,0,-22
10389,1,1,611,1370,759
10390,1,1,1842,1689,-153
10391,0,0,60,0,-60
10392,1,1,412,3625,3213
10393,1,0,33,0,-33
10394,0,0,18,0,-18
10395,0,0,22,0,-22
10396,1,1,1020,1239,219
10397,1,0,18,0,-18
10398,0,0,0,0,0
10399,1,1,23,1430,1407
10400,0,0,90,0,-90
10401,1,0,3,0,-3
10402,0,0,34,0,-34
10403,1,1,254,2005,1751
10404,0,0,9,0,-9
10405,1,0,34,0,-34
10406,0,0,187,0,-187
10407,1,0,47,0,-47
10408,1,1,905,1408,503
10409,1,1,295,1277,982
10410,1,1,1627,1307,-320
10411,1,0,148,0,-148
10412,0,0,37,0,-37
10413,0,0,26,0,-26
10414,1,0,26,0,-26
10415,0,0,7,0,-7
10416,0,0,5,0,-5
10417,0,0,11,0,-11
10418,0,0,47,0,-47
10419,1,1,188,1880,1692
10420,1,0,16,0,-16
10421,0,0,68,0,-68
10422,1,0,5,0,-5
10423,1,1,340,1484,1144
10424,1,0,51,0,-51
10425,0,0,12,0,-12
10426,1,0,5,0,-5
10427,1,1,341,1301,960
10428,1,1,258,1983,1725
10429,0,0,13,0,-13
10430,0,0,76,0,-76
10431,0,0,11,0,-11
10432,1,0,108,0,-108
10433,1,1,1487,1293,-194
10434,1,0,35,0,-35
10435,0,0,9,0,-9
10436,0,0,17,0,-17
10437,1,0,66,0,-66
10438,1,1,1771,1983,212
10439,0,0,55,0,-55
10440,0,0,14,0,-14
10441,1,1,392,1205,813
10442,0,0,13,0,-13
10443,0,0,0,0,0
10444,0,0,57,0,-57
10445,0,0,84,0,-84
10446,0,0,10,0,-10
10447,0,0,15,0,-15
10448,1,0,29,0,-29
10449,1,0,7,0,-7
10450,1,1,725,1376,651
10451,1,1,151,2835,2684
10452,1,1,493,1259,766
10453,0,0,101,0,-101
10454,0,0,27,0,-27
10455,1,0,29,0,-29
10456,0,0,59,0,-59
10457,1,0,71,0,-71
10458,1,0,51,0,-51
10459,0,0,56,0,-56
10460,1,1,189,1272,1083
10461,0,0,120,0,-120
10462,1,0,5,0,-5
10463,0,0,80,0,-80
10464,1,0,28,0,-28
10465,1,0,31,0,-31
10466,1,1,1228,1244,16
10467,1,1,905,1241,336
10468,1,1,1207,1532,325
10469,0,0,88,0,-88
10470,1,0,9,0,-9
10471,0,0,52,0,-52
10472,1,0,21,0,-21
10473,1,0,48,0,-48
10474,1,0,16,0,-16
10475,1,1,172,1547,1375
10476,0,0,46,0,-46
10477,0,0,12,0,-12
10478,1,0,26,0,-26
10479,0,0,6,0,-6
10480,0,0,195,0,-195
10481,1,0,11,0,-11
10482,1,0,114,0,-114
10483,0,0,2,0,-2
10484,0,0,260,0,-260
10485,1,1,333,1427,1094
10486,0,0,34,0,-34
10487,1,0,21,0,-21
10488,0,0,149,0,-149
10489,0,0,23,0,-23
10490,1,1,797,1815,1018
10491,0,0,99,0,-99
10492,0,0,4,0,-4
10493,0,0,13,0,-13
10494,0,0,7,0,-7
10495,1,0,41,0,-41
10496,0,0,55,0,-55
10497,1,0,91,0,-91
10498,1,1,252,1693,1441
10499,0,0,56,0,-56
10500,0,0,43,0,-43
10501,0,0,40,0,-40
10502,0,0,69,0,-69
10503,0,0,112,0,-112
10504,1,0,31,0,-31
10505,1,1,94,1835,1741
10506,1,1,137,1616,1479
10507,1,0,16,0,-16
10508,0,0,122,0,-122
10509,1,1,409,1265,856
10510,0,0,42,0,-42
10511,1,1,1132,1955,823
10512,0,0,26,0,-26
10513,1,1,441,2302,1861
10514,1,1,135,1916,1781
10515,1,1,59,1491,1432
10516,1,1,17,1791,1774
10517,1,0,255,0,-255
10518,1,0,70,0,-70
10519,0,0,39,0,-39
10520,0,0,44,0,-44
10521,1,1,56,1348,1292
10522,1,0,0,0,0
10523,1,1,146,1484,1338
10524,1,1,314,1607,1293
10525,0,0,72,0,-72
10526,1,0,203,0,-203
10527,1,1,421,1751,1330
10528,1,0,47,0,-47
10529,1,0,35,0,-35
10530,1,1,22,1371,1349
10531,0,0,64,0,-64
10532,1,1,284,1559,1275
10533,0,0,109,0,-109
10534,0,0,8,0,-8
10535,1,1,118,1603,1485
10536,1,0,17,0,-17
10537,1,1,133,2505,2372
10538,0,0,14,0,-14
10539,1,0,13,0,-13
10540,1,0,69,0,-69
10541,1,1,528,1560,1032
10542,1,0,40,0,-40
10543,1,0,1,0,-1
10544,0,0,56,0,-56
10545,1,1,132,1560,1428
10546,1,1,54,3701,3647
10547,0,0,35,0,-35
10548,0,0,37,0,-37
10549,1,1,403,1651,1248
10550,1,1,108,1436,1328
10551,0,0,14,0,-14
10552,1,1,36,4421,4385
10553,0,0,16,0,-16
10554,1,0,62,0,-62
10555,1,0,98,0,-98
10556,1,1,104,1382,1278
10557,1,0,13,0,-13
10558,0,0,54,0,-54
10559,1,1,215,2767,2552
10560,1,1,688,1282,594
10561,1,1,192,1729,1537
10562,1,1,285,1288,1003
10563,1,0,3,0,-3
10564,1,0,19,0,-19
10565,1,1,160,1664,1504
10566,0,0,17,0,-17
10567,0,0,10,0,-10
10568,1,0,22,0,-22
10569,1,1,538,1403,865
10570,1,0,92,0,-92
10571,0,0,40,0,-40
10572,1,1,549,1389,840
10573,1,1,268,1797,1529
10574,0,0,59,0,-59
10575,0,0,16,0,-16
10576,1,1,185,1572,1387
10577,0,0,45,0,-45
10578,0,0,41,0,-41
10579,1,1,150,2272,2122
10580,0,0,11,0,-11
10581,1,0,76,0,-76
10582,1,1,240,1283,1043
10583,0,0,78,0,-78
10584,1,1,298,1832,1534
10585,1,0,15,0,-15
10586,1,0,20,0,-20
10587,0,0,170,0,-170
10588,0,0,9,0,-9
10589,1,0,77,0,-77
10590,0,0,12,0,-12
10591,0,0,139,0,-139
10592,0,0,5,0,-5
10593,1,1,961,2099,1138
10594,0,0,38,0,-38
10595,1,0,16,0,-16
10596,1,0,37,0,-37
10597,0,0,30,0,-30
10598,0,0,17,0,-17
10599,0,0,9,0,-9
10600,1,1,240,1356,1116
10601,0,0,20,0,-20
10602,1,1,640,1315,675
10603,0,0,1,0,-1
10604,1,0,12,0,-12
10605,1,1,465,1498,1033
10606,1,0,25,0,-25
10607,1,1,1035,1545,510
10608,0,0,4,0,-4
10609,1,1,534,1578,1044
10610,1,1,111,1346,1235
10611,1,1,769,1328,559
10612,0,0,87,0,-87
10613,0,0,146,0,-146
10614,1,1,963,1989,1026
10615,1,1,429,1338,909
10616,1,0,89,0,-89
10617,0,0,0,0,0
10618,1,1,1326,1366,40
10619,1,1,182,1254,1072
10620,1,0,3,0,-3
10621,1,1,234,1555,1321
10622,1,0,28,0,-28
10623,0,0,131,0,-131
10624,0,0,19,0,-19
10625,0,0,47,0,-47
10626,1,1,649,1338,689
10627,1,0,14,0,-14
10628,1,1,374,1653,1279
10629,1,0,27,0,-27
10630,1,1,153,1688,1535
10631,0,0,17,0,-17
10632,1,0,15,0,-15
10633,1,1,3537,1351,-2186
10634,1,0,93,0,-93
10635,1,1,128,1247,1119
10636,1,1,402,1331,929
10637,1,1,1245,1216,-29
10638,0,0,36,0,-36
10639,0,0,63,0,-63
10640,1,1,614,1330,716
10641,0,0,120,0,-120
10642,1,0,133,0,-133
10643,1,1,1066,1383,317
10644,1,1,1136,2215,1079
10645,1,0,10,0,-10
10646,1,0,45,0,-45
10647,0,0,100,0,-100
10648,1,1,378,1717,1339
10649,1,1,263,1433,1170
10650,0,0,15,0,-15
10651,1,0,147,0,-147
10652,0,0,3,0,-3
10653,0,0,2,0,-2
10654,0,0,96,0,-96
10655,1,0,61,0,-61
10656,1,0,17,0,-17
10657,1,0,0,0,0
10658,1,0,63,0,-63
10659,0,0,18,0,-18
10660,1,1,1006,1969,963
10661,1,1,512,1393,881
10662,1,1,787,1359,572
10663,1,0,44,0,-44
10664,0,0,23,0,-23
10665,0,0,3,0,-3
10666,0,0,39,0,-39
10667,1,1,237,1565,1328
10668,0,0,133,0,-133
10669,0,0,41,0,-41
10670,1,1,475,2018,1543
10671,1,0,92,0,-92
10672,1,0,21,0,-21
10673,0,0,210,0,-210
10674,0,0,17,0,-17
10675,1,1,33,1333,1300
10676,0,0,175,0,-175
10677,1,1,597,1993,1396
10678,0,0,44,0,-44
10679,0,0,36,0,-36
10680,1,1,577,1467,890
10681,0,0,109,0,-109
10682,0,0,60,0,-60
10683,0,0,13,0,-13
10684,0,0,2,0,-2
10685,0,0,26,0,-26
10686,0,0,46,0,-46
10687,0,0,14,0,-14
10688,0,0,19,0,-19
10689,1,1,488,1370,882
10690,1,0,13,0,-13
10691,0,0,17,0,-17
10692,1,1,1465,1209,-256
10693,1,1,240,1306,1066
10694,1,1,260,1304,1044
10695,1,0,56,0,-56
10696,1,0,4,0,-4
10697,1,0,50,0,-50
10698,1,0,8,0,-8
10699,0,0,152,0,-152
10700,1,1,459,1248,789
10701,1,0,68,0,-68
10702,0,0,153,0,-153
10703,0,0,65,0,-65
10704,0,0,204,0,-204
10705,1,1,145,1846,1701
10706,1,1,269,1288,1019
10707,1,0,87,0,-87
10708,1,0,50,0,-50
10709,1,0,68,0,-68
10710,0,0,48,0,-48
10711,1,0,32,0,-32
10712,1,1,309,1577,1268
10713,0,0,32,0,-32
10714,1,0,8,0,-8
10715,1,1,210,2495,2285
10716,1,0,221,0,-221
10717,1,1,58,1657,1599
10718,1,0,25,0,-25
10719,1,1,398,1742,1344
10720,0,0,27,0,-27
10721,1,1,762,1577,815
10722,1,0,23,0,-23
10723,1,0,126,0,-126
10724,1,1,239,1312,1073
10725,0,0,19,0,-19
10726,0,0,11,0,-11
10727,0,0,24,0,-24
10728,0,0,103,0,-103
10729,1,1,351,1319,968
10730,1,1,151,1361,1210
10731,1,1,1181,1245,64
10732,1,0,17,0,-17
10733,1,1,683,1438,755
10734,1,0,5,0,-5
10735,1,0,63,0,-63
10736,0,0,55,0,-55
10737,1,0,16,0,-16
10738,0,0,41,0,-41
10739,0,0,14,0,-14
10740,1,1,150,1621,1471
10741,0,0,4,0,-4
10742,1,0,90,0,-90
10743,1,0,32,0,-32
10744,1,1,343,1375,1032
10745,1,0,5,0,-5
10746,0,0,11,0,-11
10747,0,0,161,0,-161
10748,0,0,141,0,-141
10749,1,0,84,0,-84
10750,1,0,22,0,-22
10751,1,1,150,1315,1165
10752,1,0,0,0,0
10753,1,0,176,0,-176
10754,0,0,1,0,-1
10755,1,1,1322,1616,294
10756,1,0,133,0,-133
10757,1,1,411,1205,794
10758,0,0,16,0,-16
10759,1,0,119,0,-119
10760,1,1,553,1521,968
10761,0,0,73,0,-73
10762,0,0,73,0,-73
10763,0,0,95,0,-95
10764,0,0,22,0,-22
10765,1,0,65,0,-65
10766,1,0,63,0,-63
10767,1,1,1056,1271,215
10768,1,1,404,1963,1559
10769,0,0,122,0,-122
10770,0,0,79,0,-79
10771,1,1,998,1206,208
10772,0,0,1,0,-1
10773,1,1,116,1703,1587
10774,0,0,112,0,-112
10775,1,0,146,0,-146
10776,1,0,64,0,-64
10777,1,1,280,1211,931
10778,1,0,152,0,-152
10779,1,0,32,0,-32
10780,1,0,20,0,-20
10781,1,1,345,1398,1053
10782,1,1,439,1952,1513
10783,1,0,28,0,-28
10784,0,0,115,0,-115
10785,1,1,787,1583,796
10786,1,0,12,0,-12
10787,1,1,128,1589,1461
10788,0,0,42,0,-42
10789,0,0,75,0,-75
10790,0,0,1,0,-1
10791,0,0,26,0,-26
10792,0,0,8,0,-8
10793,1,0,49,0,-49
10794,1,1,392,1947,1555
10795,1,1,981,1588,607
10796,1,1,1183,1745,562
10797,0,0,252,0,-252
10798,1,1,802,1202,400
10799,1,1,677,1384,707
10800,0,0,95,0,-95
10801,1,1,121,2704,2583
10802,0,0,269,0,-269
10803,1,1,161,1613,1452
10804,1,1,267,1782,1515
10805,1,1,427,1490,1063
10806,1,0,76,0,-76
10807,1,0,7,0,-7
10808,0,0,60,0,-60
10809,1,0,39,0,-39
10810,0,0,8,0,-8
10811,0,0,4,0,-4
10812,0,0,159,0,-159
10813,0,0,67,0,-67
10814,1,1,128,1318,1190
10815,1,0,152,0,-152
10816,0,0,121,0,-121
10817,1,0,36,0,-36
10818,1,0,37,0,-37
10819,1,1,195,1535,1340
10820,1,0,121,0,-121
10821,1,0,52,0,-52
10822,0,0,96,0,-96
10823,1,0,14,0,-14
10824,0,0,4,0,-4
10825,1,0,88,0,-88
10826,1,1,429,1211,782
10827,1,0,1,0,-1
10828,1,0,149,0,-149
10829,1,0,35,0,-35
10830,1,1,1493,1276,-217
10831,1,0,44,0,-44
10832,1,1,263,1360,1097
10833,0,0,27,0,-27
10834,0,0,56,0,-56
10835,1,0,89,0,-89
10836,1,0,33,0,-33
10837,1,0,68,0,-68
10838,1,0,4,0,-4
10839,0,0,37,0,-37
10840,0,0,8,0,-8
10841,0,0,11,0,-11
10842,0,0,30,0,-30
10843,1,1,1448,2296,848
10844,1,1,1576,1319,-257
10845,0,0,93,0,-93
10846,1,1,701,1483,782
10847,0,0,72,0,-72
10848,1,0,5,0,-5
10849,0,0,42,0,-42
10850,1,1,189,1258,1069
10851,1,0,14,0,-14
10852,1,1,727,1261,534
10853,0,0,16,0,-16
10854,0,0,85,0,-85
10855,1,1,1287,1248,-39
10856,0,0,28,0,-28
10857,1,1,679,3609,2930
10858,0,0,57,0,-57
10859,1,0,81,0,-81
10860,1,1,271,1244,973
10861,1,1,123,1448,1325
10862,0,0,120,0,-120
10863,0,0,50,0,-50
10864,0,0,47,0,-47
10865,0,0,45,0,-45
10866,0,0,53,0,-53
10867,1,0,30,0,-30
10868,1,0,15,0,-15
10869,1,0,17,0,-17
10870,0,0,17,0,-17
10871,0,0,71,0,-71
10872,1,0,97,0,-97
10873,1,1,362,1811,1449
10874,1,1,23,1359,1336
10875,1,0,38,0,-38
10876,0,0,80,0,-80
10877,0,0,15,0,-15
10878,1,1,439,1397,958
10879,0,0,231,0,-231
10880,0,0,47,0,-47
10881,1,0,118,0,-118
10882,1,1,768,1206,438
10883,1,1,133,1915,1782
10884,1,0,57,0,-57
10885,1,0,43,0,-43
10886,1,1,901,1261,360
10887,0,0,72,0,-72
10888,0,0,1,0,-1
10889,1,1,1866,4126,2260
10890,1,1,189,1785,1596
10891,0,0,50,0,-50
10892,1,1,721,1441,720
10893,0,0,14,0,-14
10894,1,1,956,1500,544
10895,0,0,10,0,-10
10896,1,1,820,2386,1566
10897,1,1,168,1254,1086
10898,1,0,52,0,-52
10899,1,1,600,1267,667
10900,0,0,7,0,-7
10901,1,1,114,1589,1475
10902,0,0,4,0,-4
10903,1,0,49,0,-49
10904,1,0,75,0,-75
10905,0,0,254,0,-254
10906,0,0,7,0,-7
10907,1,0,17,0,-17
10908,0,0,14,0,-14
10909,1,0,68,0,-68
10910,1,1,510,1431,921
10911,0,0,12,0,-12
10912,0,0,48,0,-48
10913,0,0,2,0,-2
10914,0,0,15,0,-15
10915,1,0,59,0,-59
10916,1,1,130,1396,1266
10917,0,0,122,0,-122
10918,1,0,0,0,0
10919,1,1,934,2087,1153
10920,0,0,6,0,-6
10921,1,1,259,1213,954
10922,0,0,39,0,-39
10923,1,1,699,1681,982
10924,1,1,121,1639,1518
10925,0,0,186,0,-186
10926,0,0,4,0,-4
10927,1,0,27,0,-27
10928,0,0,223,0,-223
10929,0,0,23,0,-23
10930,1,0,33,0,-33
10931,1,1,1754,1297,-457
10932,0,0,8,0,-8
10933,0,0,23,0,-23
10934,1,0,2,0,-2
10935,1,1,302,1412,1110
10936,1,1,737,1720,983
10937,0,0,18,0,-18
10938,0,0,8,0,-8
10939,0,0,8,0,-8
10940,1,0,0,0,0
10941,1,1,794,2036,1242
10942,1,0,7,0,-7
10943,1,1,417,1203,786
10944,0,0,51,0,-51
10945,0,0,12,0,-12
10946,0,0,1,0,-1
10947,0,0,31,0,-31
10948,0,0,68,0,-68
10949,1,0,51,0,-51
10950,1,1,106,1599,1493
10951,1,1,650,1238,588
10952,1,0,24,0,-24
10953,0,0,186,0,-186
10954,1,1,603,1686,1083
10955,1,1,1039,1408,369
10956,1,0,6,0,-6
10957,1,0,83,0,-83
10958,1,0,30,0,-30
10959,1,1,1183,1529,346
10960,1,0,42,0,-42
10961,1,0,11,0,-11
10962,1,1,225,1237,1012
10963,1,1,565,2894,2329
10964,0,0,29,0,-29
10965,1,0,17,0,-17
10966,0,0,58,0,-58
10967,0,0,0,0,0
10968,1,0,26,0,-26
10969,1,0,92,0,-92
10970,1,0,18,0,-18
10971,1,0,182,0,-182
10972,0,0,14,0,-14
10973,1,1,1840,1293,-547
10974,1,1,158,2687,2529
10975,0,0,70,0,-70
10976,0,0,122,0,-122
10977,0,0,60,0,-60
10978,1,0,3,0,-3
10979,1,1,244,1368,1124
10980,0,0,2,0,-2
10981,1,1,587,1604,1017
10982,0,0,113,0,-113
10983,0,0,57,0,-57
10984,1,0,23,0,-23
10985,1,1,547,2292,1745
10986,1,0,130,0,-130
10987,0,0,32,0,-32
10988,1,0,0,0,0
10989,0,0,55,0,-55
10990,1,0,179,0,-179
10991,0,0,107,0,-107
10992,1,0,83,0,-83
10993,1,1,866,1474,608
10994,1,0,119,0,-119
10995,1,1,309,1226,917
10996,1,0,15,0,-15
10997,0,0,124,0,-124
10998,1,0,41,0,-41
10999,1,1,610,3218,2608
11000,1,1,179,1533,1354
11001,0,0,46,0,-46
11002,1,0,19,0,-19
11003,1,1,551,1237,686
11004,1,0,9,0,-9
11005,0,0,2,0,-2
11006,1,0,30,0,-30
11007,1,1,1004,1593,589
11008,1,0,4,0,-4
11009,0,0,53,0,-53
11010,0,0,56,0,-56
11011,0,0,60,0,-60
11012,1,0,12,0,-12
11013,1,0,11,0,-11
11014,1,0,68,0,-68
11015,1,0,8,0,-8
11016,1,0,95,0,-95
11017,0,0,48,0,-48
11018,1,1,260,2298,2038
11019,0,0,28,0,-28
11020,1,0,4,0,-4
11021,1,1,173,2603,2430
11022,1,0,35,0,-35
11023,0,0,40,0,-40
11024,1,1,707,1259,552
11025,1,0,0,0,0
11026,1,0,2,0,-2
11027,1,0,93,0,-93
11028,0,0,13,0,-13
11029,0,0,6,0,-6
11030,0,0,1,0,-1
11031,0,0,85,0,-85
11032,1,1,807,1761,954
11033,1,0,7,0,-7
11034,0,0,23,0,-23
11035,1,0,34,0,-34
11036,1,1,169,1325,1156
11037,1,0,228,0,-228
11038,1,1,117,1280,1163
11039,0,0,58,0,-58
11040,0,0,2,0,-2
11041,1,0,76,0,-76
11042,1,0,216,0,-216
11043,1,1,209,1351,1142
11044,1,0,74,0,-74
11045,1,1,2018,1407,-611
11046,1,0,173,0,-173
11047,1,0,121,0,-121
11048,0,0,25,0,-25
11049,0,0,40,0,-40
11050,0,0,56,0,-56
11051,1,0,23,0,-23
11052,0,0,10,0,-10
11053,1,1,513,1466,953
11054,1,1,364,1731,1367
11055,1,0,1,0,-1
11056,0,0,38,0,-38
11057,1,0,94,0,-94
11058,1,1,315,2209,1894
11059,0,0,35,0,-35
11060,0,0,20,0,-20
11061,1,1,217,1598,1381
11062,1,0,1,0,-1
11063,1,0,39,0,-39
11064,1,1,94,2534,2440
11065,0,0,78,0,-78
11066,0,0,8,0,-8
11067,1,0,44,0,-44
11068,0,0,57,0,-57
11069,1,0,49,0,-49
11070,1,1,535,1255,720
11071,0,0,248,0,-248
11072,0,0,137,0,-137
11073,1,1,806,1289,483
11074,1,1,117,1632,1515
11075,1,1,351,1932,1581
11076,0,0,26,0,-26
11077,0,0,16,0,-16
11078,0,0,55,0,-55
11079,1,0,27,0,-27
11080,1,1,657,1235,578
11081,0,0,66,0,-66
11082,1,0,8,0,-8
11083,0,0,17,0,-17
11084,0,0,195,0,-195
11085,0,0,52,0,-52
11086,0,0,13,0,-13
11087,0,0,96,0,-96
11088,1,0,51,0,-51
11089,0,0,25,0,-25
11090,1,1,320,1352,1032
11091,1,0,28,0,-28
11092,1,1,406,1352,946
11093,1,0,11,0,-11
11094,0,0,52,0,-52
11095,0,0,8,0,-8
11096,1,1,209,2437,2228
11097,1,0,58,0,-58
11098,1,1,544,1544,1000
11099,0,0,6,0,-6
11100,0,0,16,0,-16
11101,1,1,202,1872,1670
11102,0,0,253,0,-253
11103,0,0,116,0,-116
11104,1,0,87,0,-87
11105,0,0,20,0,-20
11106,1,1,526,1293,767
11107,0,0,18,0,-18
11108,1,0,100,0,-100
11109,0,0,114,0,-114
11110,1,1,143,2222,2079
11111,0,0,2,0,-2
11112,1,0,17,0,-17
11113,1,0,151,0,-151
11114,0,0,39,0,-39
11115,0,0,48,0,-48
11116,0,0,11,0,-11
11117,0,0,20,0,-20
11118,1,0,0,0,0
11119,1,1,1325,1480,155
11120,1,0,48,0,-48
11121,0,0,49,0,-49
11122,0,0,17,0,-17
11123,1,1,534,1960,1426
11124,1,1,586,1443,857
11125,1,0,10,0,-10
11126,1,0,185,0,-185
11127,0,0,19,0,-19
11128,1,0,6,0,-6
11129,0,0,1,0,-1
11130,1,1,333,1252,919
11131,1,0,6,0,-6
11132,0,0,38,0,-38
11133,0,0,53,0,-53
11134,0,0,74,0,-74
11135,1,1,270,1328,1058
11136,1,1,282,1659,1377
11137,1,1,261,1739,1478
11138,1,1,40,1219,1179
11139,1,0,239,0,-239
11140,1,0,244,0,-244
11141,0,0,1,0,-1
11142,0,0,48,0,-48
11143,1,0,77,0,-77
11144,1,0,148,0,-148
11145,0,0,11,0,-11
11146,1,1,69,2179,2110
11147,1,0,42,0,-42
11148,1,0,16,0,-16
11149,1,1,204,1205,1001
11150,1,0,38,0,-38
11151,0,0,49,0,-49
11152,0,0,41,0,-41
11153,1,0,47,0,-47
11154,0,0,21,0,-21
11155,1,1,273,1648,1375
11156,0,0,18,0,-18
11157,1,0,39,0,-39
11158,0,0,27,0,-27
11159,1,0,93,0,-93
11160,1,1,2068,1983,-85
11161,1,0,42,0,-42
11162,1,0,15,0,-15
11163,1,1,466,1205,739
11164,1,0,56,0,-56
11165,0,0,15,0,-15
11166,1,1,134,1432,1298
11167,0,0,74,0,-74
11168,1,0,57,0,-57
11169,1,1,138,2248,2110
11170,1,0,64,0,-64
11171,1,0,68,0,-68
11172,1,1,150,1707,1557
11173,1,0,45,0,-45
11174,1,1,317,1318,1001
11175,0,0,97,0,-97
11176,1,1,879,2705,1826
11177,1,0,107,0,-107
11178,0,0,4,0,-4
11179,1,0,6,0,-6
11180,0,0,23,0,-23
11181,1,1,497,1344,847
11182,0,0,63,0,-63
11183,1,0,49,0,-49
11184,1,0,94,0,-94
11185,1,0,172,0,-172
11186,1,1,46,1544,1498
11187,0,0,13,0,-13
11188,0,0,2,0,-2
11189,1,0,45,0,-45
11190,1,0,11,0,-11
11191,0,0,42,0,-42
11192,1,1,58,1290,1232
11193,0,0,74,0,-74
11194,1,0,43,0,-43
11195,1,0,14,0,-14
11196,0,0,96,0,-96
11197,1,0,110,0,-110
11198,0,0,101,0,-101
11199,0,0,27,0,-27
11200,1,1,411,1314,903
11201,0,0,65,0,-65
11202,1,0,32,0,-32
11203,1,1,312,1280,968
11204,1,0,48,0,-48
11205,1,1,262,1470,1208
11206,0,0,91,0,-91
11207,1,0,29,0,-29
11208,0,0,22,0,-22
11209,1,1,177,1291,1114
11210,1,0,2,0,-2
11211,0,0,27,0,-27
11212,0,0,36,0,-36
11213,1,1,606,1474,868
11214,1,0,40,0,-40
11215,0,0,26,0,-26
11216,1,0,58,0,-58
11217,0,0,68,0,-68
11218,1,1,31,1898,1867
11219,1,1,840,1315,475
11220,1,1,920,1521,601
11221,0,0,15,0,-15
11222,1,1,430,1839,1409
11223,0,0,44,0,-44
11224,1,0,8,0,-8
11225,1,0,28,0,-28
11226,1,1,603,1641,1038
11227,1,1,383,3041,2658
11228,0,0,61,0,-61
11229,0,0,7,0,-7
11230,0,0,33,0,-33
11231,0,0,15,0,-15
11232,1,0,27,0,-27
11233,0,0,12,0,-12
11234,1,1,770,1660,890
11235,1,0,69,0,-69
11236,1,0,76,0,-76
11237,1,1,1039,2271,1232
11238,1,1,1277,2108,831
11239,1,0,8,0,-8
11240,1,0,167,0,-167
11241,0,0,25,0,-25
11242,0,0,9,0,-9
11243,0,0,2,0,-2
11244,1,0,63,0,-63
11245,1,1,337,1952,1615
11246,0,0,29,0,-29
11247,1,1,1152,1521,369
11248,1,0,11,0,-11
11249,0,0,60,0,-60
11250,0,0,102,0,-102
11251,0,0,17,0,-17
11252,0,0,55,0,-55
11253,1,0,11,0,-11
11254,0,0,49,0,-49
11255,0,0,32,0,-32
11256,0,0,25,0,-25
11257,1,0,64,0,-64
11258,0,0,73,0,-73
11259,1,1,379,3805,3426
11260,0,0,7,0,-7
11261,1,1,360,1321,961
11262,0,0,18,0,-18
11263,0,0,95,0,-95
11264,0,0,71,0,-71
11265,0,0,8,0,-8
11266,0,0,101,0,-101
11267,0,0,6,0,-6
11268,0,0,33,0,-33
11269,1,0,5,0,-5
11270,1,1,1071,1246,175
11271,1,1,496,1605,1109
11272,0,0,24,0,-24
11273,1,1,798,1276,478
11274,1,0,5,0,-5
11275,0,0,115,0,-115
11276,1,0,39,0,-39
11277,0,0,13,0,-13
11278,0,0,23,0,-23
11279,1,1,668,1232,564
11280,0,0,10,0,-10
11281,1,1,385,1656,1271
11282,1,0,107,0,-107
11283,0,0,48,0,-48
11284,0,0,0,0,0
11285,1,0,200,0,-200
11286,0,0,49,0,-49
11287,0,0,60,0,-60
11288,1,0,67,0,-67
11289,1,1,55,1338,1283
11290,1,0,10,0,-10
11291,0,0,37,0,-37
11292,1,1,275,1339,1064
11293,0,0,8,0,-8
11294,1,0,55,0,-55
11295,0,0,14,0,-14
11296,0,0,76,0,-76
11297,1,1,114,1308,1194
11298,1,1,764,1399,635
11299,1,0,9,0,-9
11300,1,0,65,0,-65
11301,0,0,6,0,-6
11302,0,0,53,0,-53
11303,1,1,860,1486,626
11304,1,1,145,1448,1303
11305,0,0,9,0,-9
11306,1,1,515,1487,972
11307,0,0,12,0,-12
11308,1,1,267,2267,2000
11309,1,1,559,1204,645
11310,1,0,61,0,-61
11311,0,0,76,0,-76
11312,1,0,54,0,-54
11313,1,0,27,0,-27
11314,0,0,18,0,-18
11315,0,0,76,0,-76
11316,0,0,5,0,-5
11317,0,0,18,0,-18
11318,1,1,900,1339,439
11319,1,0,11,0,-11
11320,1,1,432,2658,2226
11321,1,1,791,1466,675
11322,1,0,1,0,-1
11323,0,0,42,0,-42
11324,0,0,18,0,-18
11325,0,0,32,0,-32
11326,1,1,1618,2099,481
11327,0,0,3,0,-3
11328,1,1,136,4081,3945
11329,1,1,97,1812,1715
11330,0,0,1,0,-1
11331,1,1,166,1246,1080
11332,1,0,15,0,-15
11333,1,1,149,1312,1163
11334,0,0,14,0,-14
11335,1,0,24,0,-24
11336,0,0,25,0,-25
11337,1,1,314,1335,1021
11338,0,0,120,0,-120
11339,0,0,32,0,-32
11340,1,1,1266,1896,630
11341,1,1,825,1203,378
11342,1,0,35,0,-35
11343,1,1,176,3543,3367
11344,0,0,2,0,-2
11345,1,0,24,0,-24
11346,1,1,205,1299,1094
11347,0,0,17,0,-17
11348,0,0,24,0,-24
11349,0,0,7,0,-7
11350,1,1,417,1794,1377
11351,1,1,1096,1735,639
11352,0,0,68,0,-68
11353,1,1,662,1645,983
11354,0,0,44,0,-44
11355,0,0,5,0,-5
11356,1,1,794,1310,516
11357,1,1,844,1976,1132
11358,1,1,174,1845,1671
11359,1,0,1,0,-1
11360,0,0,29,0,-29
11361,1,1,1229,1383,154
11362,1,0,97,0,-97
11363,0,0,26,0,-26
11364,0,0,14,0,-14
11365,0,0,42,0,-42
11366,0,0,86,0,-86
11367,1,1,1507,1274,-233
11368,0,0,19,0,-19
11369,0,0,8,0,-8
11370,1,0,17,0,-17
11371,1,1,290,1335,1045
11372,0,0,78,0,-78
11373,1,0,110,0,-110
11374,0,0,116,0,-116
11375,0,0,148,0,-148
11376,1,1,919,1395,476
11377,0,0,13,0,-13
11378,1,1,198,1240,1042
11379,0,0,6,0,-6
11380,0,0,0,0,0
11381,1,0,50,0,-50
11382,1,0,76,0,-76
11383,0,0,110,0,-110
11384,0,0,4,0,-4
11385,1,0,2,0,-2
11386,0,0,40,0,-40
11387,1,0,36,0,-36
11388,0,0,52,0,-52
11389,0,0,13,0,-13
11390,0,0,7,0,-7
11391,0,0,34,0,-34
11392,0,0,12,0,-12
11393,1,1,1061,1322,261
11394,1,0,35,0,-35
11395,1,1,25,1215,1190
11396,1,1,81,2020,1939
11397,1,1,78,1233,1155
11398,1,0,144,0,-144
11399,0,0,29,0,-29
11400,0,0,14,0,-14
11401,0,0,56,0,-56
11402,1,1,745,1209,464
11403,1,0,25,0,-25
11404,0,0,47,0,-47
11405,1,0,43,0,-43
11406,0,0,6,0,-6
11407,1,1,808,1279,471
11408,1,0,14,0,-14
11409,1,0,36,0,-36
11410,1,1,850,1315,465
11411,1,1,2669,1335,-1334
11412,0,0,39,0,-39
11413,1,1,367,2243,1876
11414,0,0,7,0,-7
11415,0,0,55,0,-55
11416,1,1,147,1377,1230
11417,0,0,65,0,-65
11418,0,0,21,0,-21
11419,1,1,1281,1406,125
11420,1,1,1687,1416,-271
11421,1,1,1270,2567,1297
11422,1,0,9,0,-9
11423,0,0,0,0,0
11424,0,0,5,0,-5
11425,1,0,33,0,-33
11426,0,0,11,0,-11
11427,1,0,44,0,-44
11428,1,1,1360,1393,33
11429,1,0,25,0,-25
11430,1,0,2,0,-2
11431,1,1,531,1380,849
11432,0,0,2,0,-2
11433,1,0,16,0,-16
11434,1,0,19,0,-19
11435,1,0,14,0,-14
11436,1,0,42,0,-42
11437,0,0,1,0,-1
11438,0,0,58,0,-58
11439,0,0,19,0,-19
11440,0,0,66,0,-66
11441,1,1,704,1294,590
11442,1,1,150,1811,1661
11443,1,0,59,0,-59
11444,0,0,31,0,-31
11445,0,0,100,0,-100
11446,0,0,89,0,-89
11447,0,0,116,0,-116
11448,1,0,14,0,-14
11449,0,0,142,0,-142
11450,0,0,8,0,-8
11451,0,0,3,0,-3
11452,0,0,23,0,-23
11453,1,1,441,1876,1435
11454,0,0,136,0,-136
11455,0,0,38,0,-38
11456,1,1,781,2547,1766
11457,1,0,116,0,-116
11458,1,1,1135,1355,220
11459,1,1,53,2902,2849
11460,0,0,130,0,-130
11461,0,0,139,0,-139
11462,0,0,73,0,-73
11463,1,0,107,0,-107
11464,0,0,141,0,-141
11465,1,0,27,0,-27
11466,0,0,116,0,-116
11467,0,0,37,0,-37
11468,1,0,122,0,-122
11469,1,0,66,0,-66
11470,1,0,11,0,-11
11471,1,0,11,0,-11
11472,1,0,32,0,-32
11473,1,1,140,1347,1207
11474,1,1,256,1424,1168
11475,1,0,16,0,-16
11476,0,0,55,0,-55
11477,0,0,8,0,-8
11478,1,0,4,0,-4
11479,1,1,301,1274,973
11480,0,0,50,0,-50
11481,1,0,16,0,-16
11482,1,1,221,7935,7714
11483,0,0,72,0,-72
11484,0,0,96,0,-96
11485,1,1,8,1304,1296
11486,1,0,26,0,-26
11487,0,0,2,0,-2
11488,1,1,457,1218,761
11489,1,1,59,2333,2274
11490,0,0,120,0,-120
11491,0,0,8,0,-8
11492,1,0,28,0,-28
11493,1,1,383,1362,979
11494,1,0,8,0,-8
11495,1,0,0,0,0
11496,1,0,29,0,-29
11497,0,0,3,0,-3
11498,0,0,32,0,-32
11499,1,1,855,2105,1250
11500,1,0,39,0,-39
11501,0,0,33,0,-33
11502,0,0,54,0,-54
11503,1,1,1286,1739,453
11504,1,0,51,0,-51
11505,1,0,8,0,-8
11506,1,1,79,1368,1289
11507,0,0,5,0,-5
11508,1,1,216,1216,1000
11509,0,0,9,0,-9
11510,0,0,30,0,-30
11511,0,0,9,0,-9
11512,0,0,44,0,-44
11513,1,1,374,1272,898
11514,0,0,4,0,-4
11515,1,0,24,0,-24
11516,1,1,169,1257,1088
11517,1,0,59,0,-59
11518,0,0,305,0,-305
11519,0,0,22,0,-22
11520,1,0,32,0,-32
11521,1,0,8,0,-8
11522,0,0,16,0,-16
11523,0,0,40,0,-40
11524,0,0,7,0,-7
11525,0,0,8,0,-8
11526,1,0,22,0,-22
11527,0,0,6,0,-6
11528,1,0,40,0,-40
11529,1,1,657,1492,835
11530,1,0,1,0,-1
11531,0,0,113,0,-113
11532,0,0,166,0,-166
11533,1,0,3,0,-3
11534,0,0,77,0,-77
11535,0,0,30,0,-30
11536,0,0,23,0,-23
11537,1,0,57,0,-57
11538,1,1,185,1287,1102
11539,1,0,182,0,-182
11540,0,0,100,0,-100
11541,1,0,1,0,-1
11542,0,0,29,0,-29
11543,1,1,946,1234,288
11544,0,0,11,0,-11
11545,0,0,11,0,-11
11546,1,0,106,0,-106
11547,1,0,35,0,-35
11548,0,0,3,0,-3
11549,1,0,11,0,-11
11550,1,1,294,1402,1108
11551,1,0,91,0,-91
11552,1,0,21,0,-21
11553,1,1,773,2286,1513
11554,0,0,59,0,-59
11555,1,0,129,0,-129
11556,1,0,2,0,-2
11557,0,0,17,0,-17
11558,0,0,47,0,-47
11559,0,0,30,0,-30
11560,1,0,52,0,-52
11561,0,0,108,0,-108
11562,1,1,127,1583,1456
11563,1,1,154,1923,1769
11564,1,0,27,0,-27
11565,1,1,371,1463,1092
11566,0,0,83,0,-83
11567,0,0,34,0,-34
11568,1,0,20,0,-20
11569,1,0,100,0,-100
11570,0,0,96,0,-96
11571,0,0,26,0,-26
11572,0,0,25,0,-25
11573,1,0,36,0,-36
11574,1,0,27,0,-27
11575,1,0,29,0,-29
11576,1,0,4,0,-4
11577,1,1,344,1736,1392
11578,1,1,245,1570,1325
11579,0,0,12,0,-12
11580,0,0,11,0,-11
11581,0,0,35,0,-35
11582,1,1,1184,1591,407
11583,1,1,17,2317,2300
11584,1,1,85,1562,1477
11585,1,1,14,1458,1444
11586,1,1,275,1356,1081
11587,1,0,23,0,-23
11588,1,0,28,0,-28
11589,1,1,335,1205,870
11590,0,0,16,0,-16
11591,0,0,114,0,-114
11592,0,0,26,0,-26
11593,1,1,171,1873,1702
11594,1,0,6,0,-6
11595,0,0,4,0,-4
11596,0,0,30,0,-30
11597,0,0,15,0,-15
11598,0,0,5,0,-5
11599,1,0,10,0,-10
11600,1,0,43,0,-43
11601,1,0,30,0,-30
11602,0,0,95,0,-95
11603,1,1,835,1363,528
11604,1,1,744,2971,2227
11605,1,0,82,0,-82
11606,1,0,12,0,-12
11607,0,0,18,0,-18
11608,0,0,83,0,-83
11609,1,0,22,0,-22
11610,1,1,111,1880,1769
11611,0,0,4,0,-4
11612,0,0,21,0,-21
11613,1,0,31,0,-31
11614,1,1,523,1946,1423
11615,1,0,79,0,-79
11616,0,0,4,0,-4
11617,1,0,5,0,-5
11618,1,1,201,2245,2044
11619,0,0,13,0,-13
11620,0,0,23,0,-23
11621,1,1,41,1392,1351
11622,1,0,9,0,-9
11623,0,0,70,0,-70
11624,1,0,43,0,-43
11625,1,0,5,0,-5
11626,0,0,136,0,-136
11627,1,1,85,1271,1186
11628,1,0,34,0,-34
11629,1,0,187,0,-187
11630,0,0,18,0,-18
11631,0,0,195,0,-195
11632,0,0,24,0,-24
11633,1,1,267,2926,2659
11634,0,0,24,0,-24
11635,1,1,1506,1463,-43
11636,1,0,20,0,-20
11637,1,0,19,0,-19
11638,1,0,11,0,-11
11639,0,0,90,0,-90
11640,0,0,34,0,-34
11641,0,0,44,0,-44
11642,1,0,45,0,-45
11643,1,0,182,0,-182
11644,1,0,87,0,-87
11645,0,0,9,0,-9
11646,0,0,47,0,-47
11647,1,1,4215,1382,-2833
11648,0,0,2,0,-2
11649,1,1,60,1818,1758
11650,1,1,490,1341,851
11651,1,1,135,1603,1468
11652,1,0,42,0,-42
11653,0,0,8,0,-8
11654,1,0,73,0,-73
11655,0,0,33,0,-33
11656,1,1,604,1416,812
11657,0,0,60,0,-60
11658,0,0,58,0,-58
11659,0,0,9,0,-9
11660,1,1,191,1345,1154
11661,0,0,31,0,-31
11662,0,0,44,0,-44
11663,1,1,65,4910,4845
11664,1,0,7,0,-7
11665,1,1,893,1227,334
11666,0,0,90,0,-90
11667,0,0,93,0,-93
11668,1,1,407,1708,1301
11669,0,0,78,0,-78
11670,1,0,154,0,-154
11671,0,0,1,0,-1
11672,1,0,67,0,-67
11673,1,0,148,0,-148
11674,1,1,63,1597,1534
11675,1,1,5,1422,1417
11676,1,1,428,1409,981
11677,0,0,4,0,-4
11678,1,1,263,1205,942
11679,1,1,774,1264,490
11680,1,1,287,2352,2065
11681,1,1,180,1425,1245
11682,1,1,102,1294,1192
11683,1,1,1353,1246,-107
11684,0,0,53,0,-53
11685,1,0,190,0,-190
11686,0,0,4,0,-4
11687,1,1,156,1436,1280
11688,1,0,5,0,-5
11689,1,1,647,1395,748
11690,1,0,14,0,-14
11691,0,0,41,0,-41
11692,1,1,128,1677,1549
11693,0,0,38,0,-38
11694,0,0,18,0,-18
11695,1,0,12,0,-12
11696,0,0,48,0,-48
11697,0,0,51,0,-51
11698,1,0,94,0,-94
11699,0,0,51,0,-51
11700,1,1,113,1765,1652
11701,0,0,30,0,-30
11702,0,0,75,0,-75
11703,1,1,261,1236,975
11704,0,0,162,0,-162
11705,1,1,673,1369,696
11706,0,0,23,0,-23
11707,1,1,708,1243,535
11708,0,0,23,0,-23
11709,1,0,16,0,-16
11710,0,0,25,0,-25
11711,0,0,40,0,-40
11712,1,0,13,0,-13
11713,1,0,21,0,-21
11714,1,0,28,0,-28
11715,1,1,203,1364,1161
11716,1,0,8,0,-8
11717,1,0,14,0,-14
11718,1,0,29,0,-29
11719,1,1,49,1297,1248
11720,0,0,72,0,-72
11721,1,1,168,1243,1075
11722,1,0,29,0,-29
11723,1,0,155,0,-155
11724,0,0,25,0,-25
11725,1,0,134,0,-134
11726,1,0,0,0,0
11727,0,0,46,0,-46
11728,1,0,95,0,-95
11729,1,0,5,0,-5
11730,1,1,431,1515,1084
11731,0,0,16,0,-16
11732,1,0,8,0,-8
11733,1,1,2152,2905,753
11734,1,0,108,0,-108
11735,0,0,137,0,-137
11736,1,1,738,1347,609
11737,0,0,119,0,-119
11738,1,0,3,0,-3
11739,0,0,3,0,-3
11740,0,0,6,0,-6
11741,1,1,184,1339,1155
11742,0,0,73,0,-73
11743,1,0,19,0,-19
11744,1,1,277,1262,985
11745,1,1,94,1798,1704
11746,1,0,35,0,-35
11747,1,1,1352,2422,1070
11748,1,0,0,0,0
11749,1,1,1199,1223,24
11750,0,0,30,0,-30
11751,0,0,67,0,-67
11752,0,0,7,0,-7
11753,1,0,12,0,-12
11754,0,0,150,0,-150
11755,1,0,128,0,-128
11756,1,0,11,0,-11
11757,1,1,555,1411,856
11758,1,1,848,2665,1817
11759,0,0,39,0,-39
11760,1,1,318,1566,1248
11761,0,0,97,0,-97
11762,0,0,11,0,-11
11763,1,1,172,1345,1173
11764,1,1,929,2094,1165
11765,1,0,32,0,-32
11766,1,1,438,1291,853
11767,1,0,87,0,-87
11768,0,0,54,0,-54
11769,1,0,10,0,-10
11770,0,0,90,0,-90
11771,1,1,182,1235,1053
11772,1,1,1518,2024,506
11773,0,0,14,0,-14
11774,0,0,54,0,-54
11775,0,0,73,0,-73
11776,1,0,51,0,-51
11777,0,0,57,0,-57
11778,0,0,53,0,-53
11779,1,0,12,0,-12
11780,1,1,606,1971,1365
11781,1,0,96,0,-96
11782,1,1,289,1221,932
11783,1,1,103,1285,1182
11784,1,1,422,1343,921
11785,1,0,95,0,-95
11786,1,0,39,0,-39
11787,0,0,44,0,-44
11788,0,0,32,0,-32
11789,0,0,12,0,-12
11790,0,0,24,0,-24
11791,1,0,190,0,-190
11792,0,0,25,0,-25
11793,1,1,1215,1437,222
11794,0,0,16,0,-16
11795,0,0,11,0,-11
11796,0,0,31,0,-31
11797,1,1,1489,1396,-93
11798,1,1,313,1279,966
11799,0,0,58,0,-58
11800,0,0,40,0,-40
11801,0,0,15,0,-15
11802,0,0,100,0,-100
11803,0,0,72,0,-72
11804,1,0,38,0,-38
11805,0,0,6,0,-6
11806,1,0,96,0,-96
11807,0,0,40,0,-40
11808,1,0,52,0,-52
11809,0,0,22,0,-22
11810,1,1,197,1230,1033
11811,1,1,47,1213,1166
11812,0,0,22,0,-22
11813,1,0,136,0,-136
11814,0,0,39,0,-39
11815,1,0,5,0,-5
11816,1,1,980,1234,254
11817,0,0,63,0,-63
11818,1,0,40,0,-40
11819,1,1,90,1352,1262
11820,0,0,9,0,-9
11821,1,0,17,0,-17
11822,1,1,1181,1338,157
11823,0,0,15,0,-15
11824,1,0,2,0,-2
11825,1,0,47,0,-47
11826,1,1,651,1217,566
11827,1,1,60,1281,1221
11828,0,0,6,0,-6
11829,1,1,482,1462,980
11830,1,0,62,0,-62
11831,0,0,16,0,-16
11832,1,1,568,1539,971
11833,1,1,1107,1469,362
11834,1,0,5,0,-5
11835,0,0,17,0,-17
11836,0,0,12,0,-12
11837,0,0,13,0,-13
11838,0,0,69,0,-69
11839,0,0,127,0,-127
11840,1,1,658,1614,956
11841,1,0,7,0,-7
11842,1,0,127,0,-127
11843,0,0,20,0,-20
11844,1,0,105,0,-105
11845,1,1,95,1294,1199
11846,1,0,9,0,-9
11847,1,1,196,1379,1183
11848,1,1,475,1872,1397
11849,1,0,94,0,-94
11850,1,0,8,0,-8
11851,0,0,4,0,-4
11852,1,0,13,0,-13
11853,0,0,24,0,-24
11854,1,1,202,1859,1657
11855,1,1,2421,1587,-834
11856,1,0,7,0,-7
11857,0,0,50,0,-50
11858,1,1,1310,3744,2434
11859,0,0,20,0,-20
11860,0,0,26,0,-26
11861,1,0,86,0,-86
11862,0,0,4,0,-4
11863,1,1,514,1966,1452
11864,1,0,22,0,-22
11865,0,0,40,0,-40
11866,0,0,56,0,-56
11867,1,0,23,0,-23
11868,1,0,25,0,-25
11869,0,0,85,0,-85
11870,0,0,42,0,-42
11871,1,1,54,2451,2397
11872,1,1,543,1219,676
11873,1,1,90,1247,1157
11874,0,0,122,0,-122
11875,0,0,23,0,-23
11876,0,0,60,0,-60
11877,1,1,307,1539,1232
11878,0,0,23,0,-23
11879,0,0,19,0,-19
11880,1,1,511,1269,758
11881,0,0,11,0,-11
11882,1,1,978,1241,263
11883,0,0,110,0,-110
11884,1,1,394,1243,849
11885,1,1,623,1534,911
11886,1,0,65,0,-65
11887,0,0,62,0,-62
11888,0,0,54,0,-54
11889,0,0,76,0,-76
11890,1,0,35,0,-35
11891,0,0,27,0,-27
11892,1,0,4,0,-4
11893,1,1,18,1562,1544
11894,1,0,56,0,-56
11895,1,1,682,1334,652
11896,1,1,253,1555,1302
11897,1,1,124,2248,2124
11898,1,0,56,0,-56
11899,0,0,24,0,-24
11900,1,1,90,1604,1514
11901,1,1,38,1342,1304
11902,0,0,13,0,-13
11903,1,1,69,1266,1197
11904,0,0,27,0,-27
11905,0,0,57,0,-57
11906,0,0,57,0,-57
11907,0,0,12,0,-12
11908,0,0,78,0,-78
11909,1,1,274,1364,1090
11910,0,0,264,0,-264
11911,0,0,36,0,-36
11912,1,1,634,2472,1838
11913,1,0,83,0,-83
11914,0,0,8,0,-8
11915,1,1,1079,1421,342
11916,0,0,20,0,-20
11917,0,0,93,0,-93
11918,1,1,1263,1301,38
11919,1,1,447,1421,974
11920,0,0,25,0,-25
11921,1,1,346,1768,1422
11922,1,1,699,1308,609
11923,1,0,12,0,-12
11924,0,0,3,0,-3
11925,1,1,158,1611,1453
11926,0,0,181,0,-181
11927,1,0,18,0,-18
11928,0,0,7,0,-7
11929,1,0,25,0,-25
11930,1,1,456,1241,785
11931,0,0,39,0,-39
11932,1,0,64,0,-64
11933,0,0,36,0,-36
11934,1,1,755,1663,908
11935,0,0,9,0,-9
11936,1,1,1743,1301,-442
11937,0,0,32,0,-32
11938,1,1,416,1370,954
11939,0,0,14,0,-14
11940,0,0,31,0,-31
11941,1,0,42,0,-42
11942,1,1,876,1213,337
11943,1,0,103,0,-103
11944,0,0,2,0,-2
11945,0,0,118,0,-118
11946,1,1,1005,1292,287
11947,1,0,11,0,-11
11948,1,1,233,1909,1676
11949,1,0,68,0,-68
11950,1,1,491,1215,724
11951,0,0,7,0,-7
11952,1,0,362,0,-362
11953,0,0,45,0,-45
11954,1,1,642,1248,606
11955,1,1,476,1289,813
11956,1,0,27,0,-27
11957,1,0,62,0,-62
11958,1,1,229,1871,1642
11959,1,0,107,0,-107
11960,1,1,184,1898,1714
11961,1,1,333,1208,875
11962,1,0,94,0,-94
11963,0,0,6,0,-6
11964,1,0,39,0,-39
11965,0,0,50,0,-50
11966,0,0,4,0,-4
11967,0,0,61,0,-61
11968,1,1,1031,1702,671
11969,1,1,54,1586,1532
11970,1,0,14,0,-14
11971,1,1,104,1710,1606
11972,1,0,50,0,-50
11973,1,0,92,0,-92
11974,0,0,101,0,-101
11975,0,0,189,0,-189
11976,0,0,6,0,-6
11977,1,0,92,0,-92
11978,1,0,32,0,-32
11979,1,1,502,3281,2779
11980,0,0,118,0,-118
11981,1,0,2,0,-2
11982,0,0,5,0,-5
11983,1,1,878,1512,634
11984,1,0,99,0,-99
11985,1,0,271,0,-271
11986,1,0,10,0,-10
11987,1,1,338,1472,1134
11988,0,0,23,0,-23
11989,0,0,22,0,-22
11990,0,0,13,0,-13
11991,1,0,61,0,-61
11992,1,0,49,0,-49
11993,0,0,153,0,-153
11994,1,0,63,0,-63
11995,1,0,81,0,-81
11996,0,0,15,0,-15
11997,1,0,35,0,-35
11998,0,0,0,0,0
11999,0,0,55,0,-55
12000,1,1,535,1271,736
12001,1,0,71,0,-71
12002,0,0,19,0,-19
12003,0,0,63,0,-63
12004,1,1,342,1385,1043
12005,0,0,23,0,-23
12006,0,0,1,0,-1
12007,0,0,6,0,-6
12008,1,0,12,0,-12
12009,1,1,475,1485,1010
12010,1,0,168,0,-168
12011,0,0,4,0,-4
12012,0,0,38,0,-38
12013,0,0,48,0,-48
12014,1,1,907,1452,545
12015,0,0,30,0,-30
12016,1,0,8,0,-8
12017,0,0,42,0,-42
12018,1,1,617,1475,858
12019,0,0,213,0,-213
12020,0,0,44,0,-44
12021,1,0,59,0,-59
12022,1,0,43,0,-43
12023,1,0,19,0,-19
12024,0,0,17,0,-17
12025,1,0,92,0,-92
12026,1,0,25,0,-25
12027,1,1,555,1631,1076
12028,1,0,13,0,-13
12029,1,1,177,1230,1053
12030,0,0,19,0,-19
12031,1,0,66,0,-66
12032,1,1,568,1450,882
12033,1,0,10,0,-10
12034,1,0,95,0,-95
12035,1,1,90,1218,1128
12036,0,0,59,0,-59
12037,1,0,64,0,-64
12038,1,0,33,0,-33
12039,1,0,0,0,0
12040,1,1,285,2423,2138
12041,1,0,34,0,-34
12042,1,0,21,0,-21
12043,1,0,17,0,-17
12044,0,0,20,0,-20
12045,1,0,181,0,-181
12046,1,0,135,0,-135
12047,0,0,64,0,-64
12048,1,1,1679,1468,-211
12049,0,0,78,0,-78
12050,1,0,0,0,0
12051,1,1,100,1289,1189
12052,0,0,32,0,-32
12053,1,1,45,1207,1162
12054,0,0,35,0,-35
12055,1,0,4,0,-4
12056,0,0,14,0,-14
12057,0,0,88,0,-88
12058,0,0,25,0,-25
12059,1,0,76,0,-76
12060,0,0,64,0,-64
12061,1,1,157,1290,1133
12062,1,1,53,1278,1225
12063,0,0,120,0,-120
12064,0,0,47,0,-47
12065,0,0,25,0,-25
12066,1,1,468,1240,772
12067,1,1,378,1285,907
12068,1,1,355,1746,1391
12069,0,0,11,0,-11
12070,0,0,18,0,-18
12071,1,0,20,0,-20
12072,0,0,30,0,-30
12073,1,0,2,0,-2
12074,1,1,203,1347,1144
12075,0,0,24,0,-24
12076,1,1,825,1408,583
12077,1,0,89,0,-89
12078,0,0,12,0,-12
12079,1,0,22,0,-22
12080,0,0,25,0,-25
12081,1,0,24,0,-24
12082,1,0,7,0,-7
12083,1,1,174,3050,2876
12084,0,0,93,0,-93
12085,1,0,29,0,-29
12086,1,0,52,0,-52
12087,1,1,364,1633,1269
12088,1,0,35,0,-35
12089,1,0,75,0,-75
12090,1,1,473,1530,1057
12091,1,0,12,0,-12
12092,1,0,44,0,-44
12093,1,0,20,0,-20
12094,0,0,7,0,-7
12095,0,0,73,0,-73
12096,1,1,758,1948,1190
12097,1,1,537,1260,723
12098,1,1,86,1236,1150
12099,1,0,88,0,-88
12100,0,0,1,0,-1
12101,0,0,19,0,-19
12102,0,0,8,0,-8
12103,0,0,69,0,-69
12104,1,1,634,1239,605
12105,0,0,128,0,-128
12106,0,0,69,0,-69
12107,0,0,27,0,-27
12108,0,0,114,0,-114
12109,0,0,21,0,-21
12110,1,1,213,2035,1822
12111,1,0,142,0,-142
12112,1,1,600,1468,868
12113,1,0,53,0,-53
12114,0,0,10,0,-10
12115,0,0,63,0,-63
12116,1,1,26,1374,1348
12117,0,0,8,0,-8
12118,1,0,31,0,-31
12119,1,1,1131,1397,266
12120,1,0,5,0,-5
12121,1,1,398,1536,1138
12122,1,0,119,0,-119
12123,0,0,116,0,-116
12124,0,0,5,0,-5
12125,1,1,211,1889,1678
12126,0,0,84,0,-84
12127,1,1,350,1263,913
12128,1,0,53,0,-53
12129,0,0,5,0,-5
12130,1,0,25,0,-25
12131,0,0,26,0,-26
12132,1,0,15,0,-15
12133,0,0,65,0,-65
12134,0,0,80,0,-80
12135,1,1,173,1405,1232
12136,1,0,10,0,-10
12137,0,0,75,0,-75
12138,1,1,1369,1327,-42
12139,0,0,198,0,-198
12140,1,1,179,1426,1247
12141,1,1,76,1259,1183
12142,0,0,28,0,-28
12143,1,1,598,1835,1237
12144,1,1,279,1230,951
12145,0,0,43,0,-43
12146,1,1,677,1383,706
12147,0,0,73,0,-73
12148,0,0,131,0,-131
12149,1,0,67,0,-67
12150,1,0,26,0,-26
12151,1,1,661,1356,695
12152,1,0,17,0,-17
12153,1,1,243,1282,1039
12154,1,0,60,0,-60
12155,1,1,130,1768,1638
12156,1,0,3,0,-3
12157,1,0,94,0,-94
12158,0,0,63,0,-63
12159,0,0,24,0,-24
12160,1,1,242,1262,1020
12161,0,0,43,0,-43
12162,0,0,29,0,-29
12163,0,0,30,0,-30
12164,1,1,219,1752,1533
12165,1,0,9,0,-9
12166,0,0,11,0,-11
12167,1,1,1264,1405,141
12168,1,1,292,1387,1095
12169,0,0,156,0,-156
12170,1,0,122,0,-122
12171,0,0,10,0,-10
12172,0,0,92,0,-92
12173,0,0,0,0,0
12174,1,1,639,1772,1133
12175,0,0,14,0,-14
12176,0,0,2,0,-2
12177,0,0,65,0,-65
12178,0,0,19,0,-19
12179,1,0,3,0,-3
12180,1,0,55,0,-55
12181,0,0,19,0,-19
12182,1,1,809,1260,451
12183,0,0,248,0,-248
12184,1,0,40,0,-40
12185,0,0,7,0,-7
12186,1,1,793,1420,627
12187,1,0,20,0,-20
12188,1,0,75,0,-75
12189,0,0,155,0,-155
12190,0,0,14,0,-14
12191,0,0,169,0,-169
12192,0,0,7,0,-7
12193,1,1,266,1313,1047
12194,1,1,131,1281,1150
12195,1,0,1,0,-1
12196,1,1,32,1593,1561
12197,1,0,21,0,-21
12198,1,0,107,0,-107
12199,1,1,478,1272,794
12200,1,1,127,1217,1090
12201,1,1,1343,1297,-46
12202,1,1,512,1230,718
12203,1,0,8,0,-8
12204,1,0,12,0,-12
12205,1,1,417,1489,1072
12206,1,1,220,1338,1118
12207,1,1,128,1514,1386
12208,1,1,37,1328,1291
12209,0,0,13,0,-13
12210,0,0,100,0,-100
12211,1,0,159,0,-159
12212,1,1,859,1560,701
12213,1,1,441,1221,780
12214,0,0,1,0,-1
12215,1,1,489,1314,825
12216,1,0,23,0,-23
12217,1,1,835,1386,551
12218,1,1,113,1396,1283
12219,1,1,1008,1332,324
12220,1,0,2,0,-2
12221,1,0,49,0,-49
12222,0,0,96,0,-96
12223,1,1,457,1610,1153
12224,1,0,44,0,-44
12225,1,1,232,1498,1266
12226,1,1,470,4304,3834
12227,1,0,55,0,-55
12228,1,1,229,1537,1308
12229,1,1,1697,2053,356
12230,1,0,143,0,-143
12231,1,0,201,0,-201
12232,0,0,5,0,-5
12233,1,0,131,0,-131
12234,1,1,658,2822,2164
12235,1,0,114,0,-114
12236,0,0,6,0,-6
12237,0,0,48,0,-48
12238,0,0,29,0,-29
12239,0,0,15,0,-15
12240,0,0,0,0,0
12241,0,0,70,0,-70
12242,0,0,20,0,-20
12243,0,0,94,0,-94
12244,1,1,801,1440,639
12245,0,0,22,0,-22
12246,0,0,44,0,-44
12247,0,0,9,0,-9
12248,1,1,35,2022,1987
12249,1,0,15,0,-15
12250,1,0,24,0,-24
12251,1,0,154,0,-154
12252,1,1,1152,2330,1178
12253,0,0,46,0,-46
12254,1,0,119,0,-119
12255,0,0,54,0,-54
12256,1,0,205,0,-205
12257,1,0,6,0,-6
12258,1,1,89,1256,1167
12259,0,0,0,0,0
12260,0,0,111,0,-111
12261,1,0,77,0,-77
12262,0,0,30,0,-30
12263,1,0,37,0,-37
12264,1,0,12,0,-12
12265,1,0,69,0,-69
12266,1,1,717,1745,1028
12267,1,0,16,0,-16
12268,1,0,186,0,-186
12269,1,1,363,1221,858
12270,0,0,10,0,-10
12271,1,1,945,1224,279
12272,1,0,7,0,-7
12273,1,0,37,0,-37
12274,1,1,332,1235,903
12275,0,0,153,0,-153
12276,0,0,65,0,-65
12277,0,0,107,0,-107
12278,1,0,14,0,-14
12279,0,0,43,0,-43
12280,0,0,21,0,-21
12281,0,0,25,0,-25
12282,1,1,250,1314,1064
12283,1,1,421,1273,852
12284,1,0,46,0,-46
12285,1,1,181,1254,1073
12286,0,0,21,0,-21
12287,1,0,51,0,-51
12288,0,0,21,0,-21
12289,1,1,1445,1813,368
12290,0,0,30,0,-30
12291,1,0,32,0,-32
12292,1,1,87,7938,7851
12293,1,1,407,1238,831
12294,1,1,167,1751,1584
12295,1,1,187,5613,5426
12296,0,0,37,0,-37
12297,0,0,72,0,-72
12298,1,1,373,1749,1376
12299,0,0,28,0,-28
12300,1,1,311,1227,916
12301,0,0,123,0,-123
12302,1,1,307,2628,2321
12303,1,1,265,1556,1291
12304,1,0,50,0,-50
12305,1,0,17,0,-17
12306,1,0,4,0,-4
12307,1,1,233,1467,1234
12308,1,1,347,1917,1570
12309,1,0,96,0,-96
12310,0,0,47,0,-47
12311,1,1,676,1273,597
12312,1,0,48,0,-48
12313,1,0,2,0,-2
12314,1,1,914,1350,436
12315,0,0,166,0,-166
12316,0,0,40,0,-40
12317,0,0,10,0,-10
12318,0,0,60,0,-60
12319,0,0,62,0,-62
12320,0,0,327,0,-327
12321,0,0,4,0,-4
12322,0,0,10,0,-10
12323,0,0,113,0,-113
12324,1,1,139,1305,1166
12325,1,1,1135,1415,280
12326,1,0,14,0,-14
12327,0,0,68,0,-68
12328,0,0,11,0,-11
12329,0,0,26,0,-26
12330,1,0,107,0,-107
12331,0,0,172,0,-172
12332,0,0,69,0,-69
12333,1,1,427,1674,1247
12334,0,0,102,0,-102
12335,1,1,1684,1334,-350
12336,1,1,507,1546,1039
12337,1,0,72,0,-72
12338,0,0,35,0,-35
12339,1,0,34,0,-34
12340,1,1,1154,1310,156
12341,0,0,12,0,-12
12342,1,0,20,0,-20
12343,1,0,66,0,-66
12344,0,0,67,0,-67
12345,0,0,53,0,-53
12346,0,0,3,0,-3
12347,1,1,30,1203,1173
12348,0,0,0,0,0
12349,1,0,30,0,-30
12350,1,1,687,1417,730
12351,1,0,44,0,-44
12352,1,0,175,0,-175
12353,1,0,88,0,-88
12354,0,0,44,0,-44
12355,0,0,4,0,-4
12356,0,0,27,0,-27
12357,1,1,532,1676,1144
12358,1,1,329,1373,1044
12359,0,0,90,0,-90
12360,0,0,43,0,-43
12361,0,0,25,0,-25
12362,0,0,30,0,-30
12363,1,0,34,0,-34
12364,1,0,6,0,-6
12365,0,0,95,0,-95
12366,1,0,98,0,-98
12367,1,1,835,1205,370
12368,0,0,27,0,-27
12369,0,0,22,0,-22
12370,0,0,40,0,-40
12371,1,1,293,1378,1085
12372,1,0,125,0,-125
12373,1,1,890,1859,969
12374,1,0,26,0,-26
12375,0,0,20,0,-20
12376,0,0,12,0,-12
12377,1,0,37,0,-37
12378,0,0,1,0,-1
12379,1,0,37,0,-37
12380,0,0,158,0,-158
12381,0,0,49,0,-49
12382,0,0,7,0,-7
12383,0,0,46,0,-46
12384,1,1,317,1367,1050
12385,0,0,60,0,-60
12386,0,0,9,0,-9
12387,1,1,1233,1435,202
12388,1,1,211,2324,2113
12389,1,0,43,0,-43
12390,1,1,820,1323,503
12391,0,0,17,0,-17
12392,1,0,337,0,-337
12393,1,0,27,0,-27
12394,1,0,41,0,-41
12395,1,1,190,1235,1045
12396,1,1,506,1485,979
12397,1,1,130,1426,1296
12398,0,0,78,0,-78
12399,1,1,38,1770,1732
12400,1,1,335,1253,918
12401,0,0,37,0,-37
12402,0,0,15,0,-15
12403,1,0,6,0,-6
12404,0,0,14,0,-14
12405,1,0,82,0,-82
12406,0,0,39,0,-39
12407,0,0,18,0,-18
12408,1,0,196,0,-196
12409,0,0,66,0,-66
12410,1,1,349,1278,929
12411,0,0,1,0,-1
12412,1,0,4,0,-4
12413,1,1,636,1967,1331
12414,1,1,621,1801,1180
12415,1,1,159,1315,1156
12416,1,1,1665,1472,-193
12417,0,0,29,0,-29
12418,0,0,128,0,-128
12419,1,1,322,1678,1356
12420,1,0,15,0,-15
12421,0,0,18,0,-18
12422,1,0,32,0,-32
12423,0,0,63,0,-63
12424,0,0,51,0,-51
12425,1,1,701,1457,756
12426,1,1,33,1834,1801
12427,1,0,88,0,-88
12428,0,0,252,0,-252
12429,1,0,0,0,0
12430,1,0,36,0,-36
12431,0,0,56,0,-56
12432,1,1,94,2030,1936
12433,1,1,121,2055,1934
12434,1,1,407,1329,922
12435,1,0,1,0,-1
12436,0,0,49,0,-49
12437,1,1,1424,2027,603
12438,1,1,306,2587,2281
12439,1,0,43,0,-43
12440,0,0,14,0,-14
12441,0,0,43,0,-43
12442,1,1,69,1226,1157
12443,1,0,90,0,-90
12444,0,0,12,0,-12
12445,1,0,8,0,-8
12446,0,0,152,0,-152
12447,0,0,51,0,-51
12448,1,0,19,0,-19
12449,1,0,51,0,-51
12450,1,0,23,0,-23
12451,0,0,7,0,-7
12452,1,1,629,1245,616
12453,1,1,161,2878,2717
12454,1,0,51,0,-51
12455,0,0,67,0,-67
12456,1,0,16,0,-16
12457,1,0,17,0,-17
12458,0,0,1,0,-1
12459,1,1,791,1504,713
12460,1,0,91,0,-91
12461,1,0,56,0,-56
12462,0,0,11,0,-11
12463,0,0,52,0,-52
12464,1,1,1124,1949,825
12465,1,1,413,1818,1405
12466,1,0,132,0,-132
12467,1,1,589,2478,1889
12468,1,0,10,0,-10
12469,0,0,65,0,-65
12470,1,0,187,0,-187
12471,0,0,83,0,-83
12472,1,0,151,0,-151
12473,1,0,40,0,-40
12474,0,0,37,0,-37
12475,0,0,62,0,-62
12476,1,1,312,2245,1933
12477,1,1,889,1220,331
12478,1,0,67,0,-67
12479,1,1,276,1258,982
12480,1,0,14,0,-14
12481,1,0,21,0,-21
12482,1,1,1205,1203,-2
12483,1,1,174,1329,1155
12484,1,0,40,0,-40
12485,1,1,570,2430,1860
12486,0,0,32,0,-32
12487,0,0,48,0,-48
12488,0,0,8,0,-8
12489,1,0,16,0,-16
12490,1,1,415,1276,861
12491,1,0,225,0,-225
12492,0,0,76,0,-76
12493,0,0,27,0,-27
12494,1,1,135,1730,1595
12495,1,0,35,0,-35
12496,0,0,24,0,-24
12497,1,1,130,1261,1131
12498,0,0,93,0,-93
12499,0,0,48,0,-48
12500,1,1,394,1383,989
12501,0,0,89,0,-89
12502,1,0,7,0,-7
12503,0,0,25,0,-25
12504,0,0,5,0,-5
12505,1,0,124,0,-124
12506,1,1,152,1223,1071
12507,1,1,241,1204,963
12508,0,0,33,0,-33
12509,1,0,135,0,-135
12510,1,0,18,0,-18
12511,0,0,21,0,-21
12512,1,0,104,0,-104
12513,1,1,681,1624,943
12514,1,0,7,0,-7
12515,0,0,289,0,-289
12516,1,1,503,1297,794
12517,1,1,558,1420,862
12518,0,0,3,0,-3
12519,0,0,70,0,-70
12520,0,0,2,0,-2
12521,0,0,124,0,-124
12522,1,1,534,2653,2119
12523,1,1,397,1311,914
12524,1,0,7,0,-7
12525,0,0,54,0,-54
12526,0,0,1,0,-1
12527,1,1,201,1474,1273
12528,1,1,639,1418,779
12529,0,0,5,0,-5
12530,0,0,4,0,-4
12531,1,1,436,1319,883
12532,0,0,25,0,-25
12533,1,0,8,0,-8
12534,1,1,218,1900,1682
12535,1,0,23,0,-23
12536,1,0,17,0,-17
12537,0,0,113,0,-113
12538,1,0,10,0,-10
12539,1,0,103,0,-103
12540,1,0,27,0,-27
12541,0,0,36,0,-36
12542,1,1,457,1207,750
12543,1,1,254,1250,996
12544,0,0,30,0,-30
12545,1,0,26,0,-26
12546,0,0,20,0,-20
12547,0,0,93,0,-93
12548,1,0,7,0,-7
12549,0,0,101,0,-101
12550,0,0,23,0,-23
12551,0,0,135,0,-135
12552,1,0,4,0,-4
12553,0,0,56,0,-56
12554,1,0,87,0,-87
12555,0,0,40,0,-40
12556,0,0,8,0,-8
12557,1,0,24,0,-24
12558,0,0,139,0,-139
12559,1,1,233,2335,2102
12560,1,0,46,0,-46
12561,0,0,101,0,-101
12562,1,1,41,1611,1570
12563,1,1,396,1492,1096
12564,1,0,3,0,-3
12565,0,0,108,0,-108
12566,1,1,269,1541,1272
12567,0,0,37,0,-37
12568,0,0,215,0,-215
12569,1,0,25,0,-25
12570,1,1,1419,1289,-130
12571,1,1,253,1636,1383
12572,0,0,74,0,-74
12573,0,0,16,0,-16
12574,0,0,6,0,-6
12575,0,0,36,0,-36
12576,0,0,18,0,-18
12577,1,1,523,1764,1241
12578,1,1,627,2413,1786
12579,1,1,704,1490,786
12580,0,0,93,0,-93
12581,0,0,77,0,-77
12582,0,0,29,0,-29
12583,1,1,387,1248,861
12584,0,0,52,0,-52
12585,0,0,54,0,-54
12586,0,0,18,0,-18
12587,0,0,59,0,-59
12588,0,0,62,0,-62
12589,0,0,5,0,-5
12590,0,0,73,0,-73
12591,1,0,64,0,-64
12592,0,0,33,0,-33
12593,1,0,19,0,-19
12594,1,0,19,0,-19
12595,1,1,87,1491,1404
12596,1,1,109,2039,1930
12597,1,0,168,0,-168
12598,0,0,175,0,-175
12599,0,0,105,0,-105
12600,0,0,0,0,0
12601,0,0,36,0,-36
12602,0,0,55,0,-55
12603,1,0,163,0,-163
12604,0,0,126,0,-126
12605,1,0,5,0,-5
12606,0,0,77,0,-77
12607,1,1,224,1200,976
12608,1,1,26,1285,1259
12609,0,0,24,0,-24
12610,0,0,20,0,-20
12611,1,1,167,1351,1184
12612,0,0,33,0,-33
12613,1,0,77,0,-77
12614,0,0,27,0,-27
12615,1,0,2,0,-2
12616,1,0,91,0,-91
12617,1,1,420,1307,887
12618,1,1,892,1253,361
12619,1,1,1209,1262,53
12620,1,0,35,0,-35
12621,1,0,263,0,-263
12622,0,0,38,0,-38
12623,1,0,69,0,-69
12624,0,0,144,0,-144
12625,1,0,45,0,-45
12626,1,0,20,0,-20
12627,1,1,64,1496,1432
12628,0,0,5,0,-5
12629,1,0,113,0,-113
12630,1,0,7,0,-7
12631,1,1,1037,1277,240
12632,1,0,160,0,-160
12633,0,0,0,0,0
12634,0,0,4,0,-4
12635,1,1,539,1912,1373
12636,0,0,23,0,-23
12637,1,0,4,0,-4
12638,1,0,1,0,-1
12639,1,0,37,0,-37
12640,0,0,110,0,-110
12641,0,0,11,0,-11
12642,1,0,26,0,-26
12643,1,1,442,1254,812
12644,1,1,245,1201,956
12645,0,0,65,0,-65
12646,0,0,1,0,-1
12647,1,1,1882,1584,-298
12648,0,0,106,0,-106
12649,1,1,802,1345,543
12650,1,0,24,0,-24
12651,1,1,172,1365,1193
12652,1,1,1080,1396,316
12653,0,0,46,0,-46
12654,1,1,366,1229,863
12655,1,1,171,1653,1482
12656,0,0,153,0,-153
12657,1,0,35,0,-35
12658,0,0,33,0,-33
12659,1,1,828,1820,992
12660,1,1,1245,1864,619
12661,0,0,61,0,-61
12662,1,1,2618,1210,-1408
12663,1,1,540,1484,944
12664,0,0,59,0,-59
12665,1,1,416,1903,1487
12666,1,1,234,1737,1503
12667,1,1,102,1232,1130
12668,1,1,263,1310,1047
12669,0,0,44,0,-44
12670,0,0,30,0,-30
12671,0,0,34,0,-34
12672,1,0,101,0,-101
12673,0,0,91,0,-91
12674,1,1,596,2273,1677
12675,1,1,477,1443,966
12676,0,0,96,0,-96
12677,0,0,8,0,-8
12678,1,1,162,1305,1143
12679,0,0,9,0,-9
12680,1,0,26,0,-26
12681,1,0,20,0,-20
12682,1,0,165,0,-165
12683,1,0,45,0,-45
12684,1,0,42,0,-42
12685,0,0,30,0,-30
12686,0,0,9,0,-9
12687,0,0,15,0,-15
12688,1,0,20,0,-20
12689,1,1,1371,1898,527
12690,1,0,96,0,-96
12691,1,1,355,1564,1209
12692,0,0,23,0,-23
12693,1,1,812,1595,783
12694,0,0,0,0,0
12695,0,0,34,0,-34
12696,0,0,69,0,-69
12697,0,0,44,0,-44
12698,1,1,336,1280,944
12699,1,0,149,0,-149
12700,0,0,18,0,-18
12701,1,1,635,1751,1116
12702,0,0,26,0,-26
12703,1,1,946,1509,563
12704,0,0,73,0,-73
12705,0,0,62,0,-62
12706,1,0,63,0,-63
12707,0,0,123,0,-123
12708,1,1,253,1507,1254
12709,1,0,9,0,-9
12710,0,0,8,0,-8
12711,0,0,0,0,0
12712,0,0,40,0,-40
12713,0,0,103,0,-103
12714,1,0,15,0,-15
12715,0,0,35,0,-35
12716,0,0,118,0,-118
12717,1,1,371,1254,883
12718,0,0,5,0,-5
12719,1,0,17,0,-17
12720,1,1,89,1218,1129
12721,1,0,120,0,-120
12722,0,0,75,0,-75
12723,1,0,45,0,-45
12724,1,0,15,0,-15
12725,0,0,11,0,-11
12726,1,0,1,0,-1
12727,1,1,145,3552,3407
12728,0,0,71,0,-71
12729,0,0,40,0,-40
12730,1,0,24,0,-24
12731,1,1,1778,1454,-324
12732,0,0,7,0,-7
12733,1,0,24,0,-24
12734,0,0,47,0,-47
12735,0,0,20,0,-20
12736,0,0,157,0,-157
12737,1,1,1457,1297,-160
12738,1,1,18,1605,1587
12739,0,0,33,0,-33
12740,1,1,895,1273,378
12741,0,0,38,0,-38
12742,0,0,14,0,-14
12743,1,1,509,1589,1080
12744,1,0,2,0,-2
12745,1,1,735,1219,484
12746,0,0,3,0,-3
12747,1,0,131,0,-131
12748,0,0,115,0,-115
12749,1,0,23,0,-23
12750,0,0,61,0,-61
12751,1,1,355,1275,920
12752,1,1,321,1244,923
12753,1,1,14,1214,1200
12754,1,1,88,1372,1284
12755,1,0,106,0,-106
12756,0,0,20,0,-20
12757,0,0,36,0,-36
12758,1,1,1698,1434,-264
12759,1,1,317,2255,1938
12760,1,1,138,1306,1168
12761,0,0,17,0,-17
12762,1,1,480,1844,1364
12763,0,0,26,0,-26
12764,0,0,34,0,-34
12765,1,0,13,0,-13
12766,1,0,5,0,-5
12767,1,1,960,1246,286
12768,0,0,108,0,-108
12769,1,0,11,0,-11
12770,1,1,108,1839,1731
12771,0,0,25,0,-25
12772,0,0,12,0,-12
12773,0,0,40,0,-40
12774,1,1,141,1201,1060
12775,1,1,210,1505,1295
12776,0,0,38,0,-38
12777,0,0,27,0,-27
12778,0,0,41,0,-41
12779,1,0,24,0,-24
12780,1,1,85,1270,1185
12781,0,0,148,0,-148
12782,1,0,15,0,-15
12783,1,1,347,1739,1392
12784,0,0,14,0,-14
12785,1,1,385,1299,914
12786,1,0,52,0,-52
12787,1,1,1364,1775,411
12788,1,1,1581,1531,-50
12789,0,0,12,0,-12
12790,1,0,29,0,-29
12791,1,1,669,1345,676
12792,0,0,39,0,-39
12793,0,0,15,0,-15
12794,0,0,17,0,-17
12795,1,0,4,0,-4
12796,1,0,63,0,-63
12797,1,0,18,0,-18
12798,1,0,136,0,-136
12799,1,1,736,2077,1341
12800,0,0,75,0,-75
12801,0,0,26,0,-26
12802,1,1,638,2402,1764
12803,1,0,99,0,-99
12804,0,0,21,0,-21
12805,0,0,21,0,-21
12806,0,0,3,0,-3
12807,1,0,10,0,-10
12808,1,0,89,0,-89
12809,1,1,141,1429,1288
12810,0,0,63,0,-63
12811,1,0,3,0,-3
12812,0,0,71,0,-71
12813,0,0,16,0,-16
12814,0,0,6,0,-6
12815,0,0,92,0,-92
12816,1,1,1240,1248,8
12817,1,1,1085,2015,930
12818,1,0,34,0,-34
12819,1,1,592,1202,610
12820,1,1,265,1264,999
12821,1,0,17,0,-17
12822,0,0,12,0,-12
12823,1,0,47,0,-47
12824,0,0,138,0,-138
12825,1,0,25,0,-25
12826,1,1,1276,1269,-7
12827,1,0,59,0,-59
12828,1,0,7,0,-7
12829,0,0,21,0,-21
12830,1,1,1102,1246,144
12831,1,0,47,0,-47
12832,0,0,16,0,-16
12833,1,1,482,1353,871
12834,1,1,179,1383,1204
12835,1,1,503,1508,1005
12836,1,0,62,0,-62
12837,0,0,2,0,-2
12838,1,1,1397,1696,299
12839,1,0,129,0,-129
12840,0,0,49,0,-49
12841,1,1,902,1988,1086
12842,1,1,139,1438,1299
12843,1,1,224,1248,1024
12844,1,0,6,0,-6
12845,0,0,131,0,-131
12846,0,0,10,0,-10
12847,1,0,77,0,-77
12848,0,0,16,0,-16
12849,1,1,105,1236,1131
12850,1,1,1074,1280,206
12851,0,0,90,0,-90
12852,1,0,289,0,-289
12853,1,1,82,1308,1226
12854,1,0,12,0,-12
12855,1,1,200,1531,1331
12856,1,0,110,0,-110
12857,1,0,27,0,-27
12858,1,1,1791,1343,-448
12859,1,0,19,0,-19
12860,1,1,4160,1872,-2288
12861,1,0,41,0,-41
12862,1,1,585,1273,688
12863,1,0,120,0,-120
12864,0,0,32,0,-32
12865,0,0,16,0,-16
12866,0,0,12,0,-12
12867,0,0,186,0,-186
12868,0,0,98,0,-98
12869,1,0,99,0,-99
12870,1,0,66,0,-66
12871,0,0,99,0,-99
12872,0,0,112,0,-112
12873,1,1,246,1201,955
12874,1,0,69,0,-69
12875,1,0,27,0,-27
12876,1,0,33,0,-33
12877,0,0,70,0,-70
12878,1,1,62,1849,1787
12879,1,0,53,0,-53
12880,0,0,19,0,-19
12881,1,0,8,0,-8
12882,1,0,23,0,-23
12883,0,0,24,0,-24
12884,1,1,99,1559,1460
12885,1,0,3,0,-3
12886,0,0,2,0,-2
12887,0,0,8,0,-8
12888,0,0,45,0,-45
12889,1,0,13,0,-13
12890,0,0,57,0,-57
12891,1,1,1384,1494,110
12892,1,0,18,0,-18
12893,0,0,17,0,-17
12894,1,1,150,1509,1359
12895,1,1,295,1242,947
12896,1,1,635,1228,593
12897,1,1,2881,1234,-1647
12898,1,1,96,1843,1747
12899,1,1,289,1265,976
12900,1,1,607,1383,776
12901,0,0,37,0,-37
12902,1,0,5,0,-5
12903,1,1,185,1427,1242
12904,1,1,437,1425,988
12905,1,0,51,0,-51
12906,0,0,17,0,-17
12907,0,0,10,0,-10
12908,1,1,235,1724,1489
12909,0,0,19,0,-19
12910,1,0,14,0,-14
12911,1,0,70,0,-70
12912,1,1,1251,1220,-31
12913,0,0,86,0,-86
12914,0,0,2,0,-2
12915,1,1,263,2674,2411
12916,0,0,47,0,-47
12917,1,0,1,0,-1
12918,1,1,1472,1328,-144
12919,0,0,37,0,-37
12920,1,1,32,2116,2084
12921,1,0,63,0,-63
12922,0,0,2,0,-2
12923,1,0,73,0,-73
12924,0,0,86,0,-86
12925,1,0,91,0,-91
12926,0,0,20,0,-20
12927,1,0,68,0,-68
12928,1,0,177,0,-177
12929,0,0,91,0,-91
12930,1,1,1198,1933,735
12931,1,0,8,0,-8
12932,1,0,34,0,-34
12933,1,1,169,1341,1172
12934,0,0,9,0,-9
12935,1,1,130,1204,1074
12936,1,0,20,0,-20
12937,1,1,1072,2514,1442
12938,1,1,1208,1364,156
12939,0,0,4,0,-4
12940,1,1,194,1403,1209
12941,0,0,39,0,-39
12942,1,0,30,0,-30
12943,1,1,44,1326,1282
12944,1,0,29,0,-29
12945,1,0,37,0,-37
12946,1,1,470,1412,942
12947,0,0,171,0,-171
12948,1,0,13,0,-13
12949,0,0,4,0,-4
12950,1,0,35,0,-35
12951,0,0,229,0,-229
12952,0,0,90,0,-90
12953,0,0,68,0,-68
12954,0,0,47,0,-47
12955,0,0,2,0,-2
12956,0,0,122,0,-122
12957,1,1,340,1616,1276
12958,1,0,24,0,-24
12959,1,0,17,0,-17
12960,0,0,47,0,-47
12961,1,1,599,1836,1237
12962,1,1,126,2732,2606
12963,1,0,32,0,-32
12964,1,1,74,1786,1712
12965,0,0,139,0,-139
12966,0,0,14,0,-14
12967,1,1,2412,1367,-1045
12968,1,0,28,0,-28
12969,0,0,1,0,-1
12970,1,1,1000,3391,2391
12971,0,0,13,0,-13
12972,1,0,14,0,-14
12973,0,0,39,0,-39
12974,1,0,14,0,-14
12975,1,0,37,0,-37
12976,1,0,33,0,-33
12977,1,0,141,0,-141
12978,1,1,318,1226,908
12979,0,0,102,0,-102
12980,1,1,591,1220,629
12981,0,0,28,0,-28
12982,1,1,1071,1596,525
12983,1,0,80,0,-80
12984,1,1,47,1406,1359
12985,0,0,10,0,-10
12986,1,0,3,0,-3
12987,0,0,13,0,-13
12988,1,0,9,0,-9
12989,0,0,1,0,-1
12990,0,0,97,0,-97
12991,1,0,45,0,-45
12992,0,0,0,0,0
12993,1,0,62,0,-62
12994,0,0,56,0,-56
12995,1,1,543,1421,878
12996,0,0,29,0,-29
12997,0,0,33,0,-33
12998,1,1,64,1201,1137
12999,1,0,6,0,-6
13000,0,0,123,0,-123
13001,1,1,56,1215,1159
13002,1,1,179,1467,1288
13003,0,0,20,0,-20
13004,0,0,52,0,-52
13005,1,1,211,1272,1061
13006,1,1,905,1205,300
13007,1,0,0,0,0
13008,1,1,757,1449,692
13009,1,1,193,1728,1535
13010,0,0,151,0,-151
13011,1,1,353,1205,852
13012,1,0,20,0,-20
13013,0,0,2,0,-2
13014,0,0,3,0,-3
13015,1,1,319,1203,884
13016,1,1,519,1957,1438
13017,1,1,487,2975,2488
13018,1,1,120,2017,1897
13019,0,0,9,0,-9
13020,1,0,7,0,-7
13021,1,1,51,1611,1560
13022,0,0,64,0,-64
13023,1,0,121,0,-121
13024,1,0,191,0,-191
13025,1,1,500,1813,1313
13026,1,0,79,0,-79
13027,0,0,79,0,-79
13028,1,0,24,0,-24
13029,0,0,49,0,-49
13030,0,0,132,0,-132
13031,1,0,32,0,-32
13032,1,1,212,1290,1078
13033,0,0,8,0,-8
13034,0,0,111,0,-111
13035,1,1,765,1204,439
13036,1,1,466,1275,809
13037,0,0,10,0,-10
13038,0,0,82,0,-82
13039,1,1,61,1879,1818
13040,0,0,24,0,-24
13041,1,0,42,0,-42
13042,1,0,40,0,-40
13043,1,0,79,0,-79
13044,1,0,143,0,-143
13045,1,0,38,0,-38
13046,1,1,177,1218,1041
13047,1,0,16,0,-16
13048,0,0,156,0,-156
13049,1,0,120,0,-120
13050,0,0,10,0,-10
13051,1,1,467,1315,848
13052,0,0,27,0,-27
13053,0,0,5,0,-5
13054,1,0,39,0,-39
13055,0,0,11,0,-11
13056,1,0,244,0,-244
13057,1,1,162,1601,1439
13058,1,1,1183,1292,109
13059,1,0,10,0,-10
13060,0,0,241,0,-241
13061,0,0,50,0,-50
13062,0,0,44,0,-44
13063,1,0,24,0,-24
13064,0,0,0,0,0
13065,1,1,927,1312,385
13066,0,0,68,0,-68
13067,1,1,164,1452,1288
13068,1,0,25,0,-25
13069,0,0,88,0,-88
13070,1,0,42,0,-42
13071,0,0,99,0,-99
13072,0,0,1,0,-1
13073,0,0,51,0,-51
13074,1,1,249,1221,972
13075,1,0,302,0,-302
13076,1,0,93,0,-93
13077,1,0,18,0,-18
13078,0,0,186,0,-186
13079,0,0,230,0,-230
13080,1,1,862,1405,543
13081,0,0,32,0,-32
13082,1,1,460,1364,904
13083,0,0,65,0,-65
13084,1,0,85,0,-85
13085,1,0,67,0,-67
13086,1,0,37,0,-37
13087,1,0,106,0,-106
13088,0,0,3,0,-3
13089,0,0,0,0,0
13090,1,1,630,1471,841
13091,0,0,94,0,-94
13092,1,1,784,1370,586
13093,1,1,931,1356,425
13094,1,0,36,0,-36
13095,1,0,214,0,-214
13096,1,1,680,1820,1140
13097,0,0,31,0,-31
13098,1,0,0,0,0
13099,0,0,25,0,-25
13100,1,1,174,1502,1328
13101,1,0,52,0,-52
13102,0,0,1,0,-1
13103,1,0,37,0,-37
13104,0,0,58,0,-58
13105,0,0,33,0,-33
13106,1,1,187,3209,3022
13107,0,0,3,0,-3
13108,1,1,477,1678,1201
13109,0,0,14,0,-14
13110,1,0,193,0,-193
13111,1,0,2,0,-2
13112,1,1,41,1429,1388
13113,0,0,40,0,-40
13114,1,1,264,2533,2269
13115,1,1,751,1368,617
13116,1,1,1191,1279,88
13117,1,1,1112,1250,138
13118,1,0,37,0,-37
13119,1,0,80,0,-80
13120,0,0,59,0,-59
13121,0,0,9,0,-9
13122,1,0,10,0,-10
13123,1,0,73,0,-73
13124,0,0,7,0,-7
13125,1,0,104,0,-104
13126,0,0,39,0,-39
13127,1,0,96,0,-96
13128,1,0,46,0,-46
13129,1,0,25,0,-25
13130,1,0,24,0,-24
13131,0,0,105,0,-105
13132,1,0,270,0,-270
13133,1,0,13,0,-13
13134,0,0,99,0,-99
13135,1,1,1776,1402,-374
13136,0,0,7,0,-7
13137,0,0,35,0,-35
13138,0,0,72,0,-72
13139,1,0,22,0,-22
13140,1,1,142,1281,1139
13141,1,1,88,1474,1386
13142,1,1,320,1249,929
13143,1,0,137,0,-137
13144,1,0,20,0,-20
13145,0,0,25,0,-25
13146,1,1,572,1580,1008
13147,1,0,4,0,-4
13148,1,0,69,0,-69
13149,1,0,147,0,-147
13150,0,0,24,0,-24
13151,1,1,270,1217,947
13152,0,0,5,0,-5
13153,1,0,116,0,-116
13154,0,0,20,0,-20
13155,1,0,0,0,0
13156,1,1,702,1361,659
13157,0,0,56,0,-56
13158,0,0,9,0,-9
13159,0,0,188,0,-188
13160,0,0,138,0,-138
13161,0,0,56,0,-56
13162,1,0,8,0,-8
13163,0,0,32,0,-32
13164,0,0,4,0,-4
13165,1,1,331,1577,1246
13166,1,0,121,0,-121
13167,1,0,8,0,-8
13168,1,0,80,0,-80
13169,0,0,37,0,-37
13170,0,0,43,0,-43
13171,1,1,144,2229,2085
13172,1,0,37,0,-37
13173,0,0,19,0,-19
13174,0,0,8,0,-8
13175,1,1,86,1242,1156
13176,0,0,4,0,-4
13177,1,1,844,2475,1631
13178,0,0,1,0,-1
13179,1,1,555,1733,1178
13180,0,0,6,0,-6
13181,1,0,98,0,-98
13182,0,0,47,0,-47
13183,1,1,232,1397,1165
13184,1,0,33,0,-33
13185,1,0,33,0,-33
13186,0,0,23,0,-23
13187,1,1,67,1216,1149
13188,1,0,9,0,-9
13189,0,0,7,0,-7
13190,1,0,5,0,-5
13191,0,0,40,0,-40
13192,0,0,16,0,-16
13193,0,0,34,0,-34
13194,0,0,12,0,-12
13195,0,0,6,0,-6
13196,1,0,66,0,-66
13197,1,0,37,0,-37
13198,0,0,137,0,-137
13199,0,0,12,0,-12
13200,0,0,47,0,-47
13201,1,1,438,1449,1011
13202,1,0,51,0,-51
13203,1,1,178,1350,1172
13204,0,0,56,0,-56
13205,1,1,1352,1286,-66
13206,0,0,110,0,-110
13207,0,0,28,0,-28
13208,1,1,531,4805,4274
13209,1,1,1254,1877,623
13210,1,0,2,0,-2
13211,1,1,1068,1596,528
13212,1,0,10,0,-10
13213,0,0,11,0,-11
13214,1,0,29,0,-29
13215,0,0,37,0,-37
13216,0,0,88,0,-88
13217,1,1,396,1333,937
13218,1,1,559,1557,998
13219,1,0,110,0,-110
13220,1,1,555,1353,798
13221,0,0,70,0,-70
13222,1,0,22,0,-22
13223,0,0,31,0,-31
13224,1,1,606,1241,635
13225,0,0,1,0,-1
13226,0,0,37,0,-37
13227,1,0,27,0,-27
13228,0,0,84,0,-84
13229,1,1,181,1212,1031
13230,0,0,103,0,-103
13231,0,0,54,0,-54
13232,0,0,16,0,-16
13233,0,0,1,0,-1
13234,1,0,66,0,-66
13235,0,0,86,0,-86
13236,0,0,147,0,-147
13237,0,0,10,0,-10
13238,0,0,26,0,-26
13239,0,0,11,0,-11
13240,1,0,232,0,-232
13241,1,1,128,1254,1126
13242,0,0,107,0,-107
13243,0,0,196,0,-196
13244,1,0,82,0,-82
13245,1,1,669,1340,671
13246,1,0,5,0,-5
13247,1,1,647,4729,4082
13248,1,0,3,0,-3
13249,0,0,144,0,-144
13250,1,1,752,1465,713
13251,1,0,84,0,-84
13252,0,0,130,0,-130
13253,1,0,7,0,-7
13254,1,1,277,1499,1222
13255,1,1,867,2145,1278
13256,1,1,479,1707,1228
13257,0,0,7,0,-7
13258,1,0,146,0,-146
13259,1,1,277,1679,1402
13260,1,0,55,0,-55
13261,1,1,249,1237,988
13262,1,1,607,1319,712
13263,0,0,28,0,-28
13264,1,1,96,1340,1244
13265,0,0,75,0,-75
13266,1,0,111,0,-111
13267,1,0,56,0,-56
13268,1,0,90,0,-90
13269,1,1,107,1207,1100
13270,0,0,34,0,-34
13271,1,0,7,0,-7
13272,1,1,240,1711,1471
13273,1,0,7,0,-7
13274,1,0,29,0,-29
13275,1,0,50,0,-50
13276,1,0,111,0,-111
13277,0,0,47,0,-47
13278,0,0,47,0,-47
13279,1,1,165,1888,1723
13280,1,0,109,0,-109
13281,1,0,22,0,-22
13282,0,0,43,0,-43
13283,1,0,12,0,-12
13284,1,1,312,1338,1026
13285,0,0,5,0,-5
13286,1,0,0,0,0
13287,0,0,63,0,-63
13288,1,0,3,0,-3
13289,1,0,101,0,-101
13290,0,0,55,0,-55
13291,0,0,1,0,-1
13292,1,0,64,0,-64
13293,1,0,16,0,-16
13294,0,0,7,0,-7
13295,0,0,27,0,-27
13296,1,0,28,0,-28
13297,1,0,88,0,-88
13298,1,0,15,0,-15
13299,0,0,94,0,-94
13300,1,1,1761,1489,-272
13301,1,0,8,0,-8
13302,1,0,59,0,-59
13303,0,0,3,0,-3
13304,1,0,46,0,-46
13305,1,1,351,1699,1348
13306,1,0,16,0,-16
13307,1,0,74,0,-74
13308,1,1,335,1385,1050
13309,1,0,2,0,-2
13310,0,0,22,0,-22
13311,0,0,24,0,-24
13312,1,1,452,1688,1236
13313,1,1,729,2241,1512
13314,1,1,631,1206,575
13315,0,0,50,0,-50
13316,0,0,66,0,-66
13317,1,1,1766,1225,-541
13318,1,0,26,0,-26
13319,0,0,31,0,-31
13320,0,0,2,0,-2
13321,1,1,643,1242,599
13322,0,0,3,0,-3
13323,0,0,15,0,-15
13324,1,0,50,0,-50
13325,0,0,11,0,-11
13326,1,0,80,0,-80
13327,0,0,62,0,-62
13328,0,0,39,0,-39
13329,1,1,375,2263,1888
13330,1,1,351,1415,1064
13331,1,0,140,0,-140
13332,1,1,776,1278,502
13333,1,0,37,0,-37
13334,1,0,38,0,-38
13335,0,0,14,0,-14
13336,1,0,186,0,-186
13337,1,0,22,0,-22
13338,1,0,4,0,-4
13339,0,0,111,0,-111
13340,1,1,292,1340,1048
13341,1,0,132,0,-132
13342,0,0,18,0,-18
13343,0,0,155,0,-155
13344,0,0,39,0,-39
13345,1,1,821,3815,2994
13346,0,0,47,0,-47
13347,0,0,68,0,-68
13348,0,0,63,0,-63
13349,1,1,1784,1558,-226
13350,0,0,116,0,-116
13351,0,0,35,0,-35
13352,0,0,18,0,-18
13353,0,0,30,0,-30
13354,0,0,31,0,-31
13355,0,0,65,0,-65
13356,0,0,97,0,-97
13357,0,0,52,0,-52
13358,0,0,9,0,-9
13359,1,1,238,1329,1091
13360,0,0,317,0,-317
13361,1,0,127,0,-127
13362,1,0,93,0,-93
13363,1,1,429,1474,1045
13364,1,1,264,4021,3757
13365,1,0,38,0,-38
13366,1,1,329,1430,1101
13367,0,0,35,0,-35
13368,0,0,4,0,-4
13369,0,0,28,0,-28
13370,1,0,1,0,-1
13371,1,0,72,0,-72
13372,1,1,903,1292,389
13373,0,0,10,0,-10
13374,0,0,95,0,-95
13375,1,0,16,0,-16
13376,1,0,131,0,-131
13377,1,1,378,2527,2149
13378,1,1,1412,1499,87
13379,0,0,9,0,-9
13380,1,1,364,1473,1109
13381,1,0,6,0,-6
13382,0,0,4,0,-4
13383,0,0,5,0,-5
13384,0,0,67,0,-67
13385,0,0,2,0,-2
13386,1,0,34,0,-34
13387,1,0,9,0,-9
13388,0,0,42,0,-42
13389,0,0,119,0,-119
13390,0,0,44,0,-44
13391,0,0,95,0,-95
13392,1,0,3,0,-3
13393,0,0,59,0,-59
13394,1,1,413,1416,1003
13395,1,1,1091,1255,164
13396,1,0,2,0,-2
13397,0,0,74,0,-74
13398,0,0,14,0,-14
13399,1,0,2,0,-2
13400,0,0,21,0,-21
13401,1,0,9,0,-9
13402,1,0,33,0,-33
13403,1,0,5,0,-5
13404,1,0,48,0,-48
13405,1,1,323,1235,912
13406,0,0,39,0,-39
13407,1,1,154,1579,1425
13408,1,1,655,1819,1164
13409,0,0,79,0,-79
13410,0,0,58,0,-58
13411,1,0,9,0,-9
13412,1,1,266,1553,1287
13413,0,0,41,0,-41
13414,1,1,1472,1987,515
13415,1,1,26,1318,1292
13416,0,0,200,0,-200
13417,1,1,635,1484,849
13418,1,0,7,0,-7
13419,1,1,876,1298,422
13420,1,1,158,1651,1493
13421,1,0,71,0,-71
13422,0,0,8,0,-8
13423,0,0,22,0,-22
13424,1,1,393,1208,815
13425,1,0,99,0,-99
13426,1,1,823,1419,596
13427,1,0,8,0,-8
13428,0,0,91,0,-91
13429,1,1,524,1846,1322
13430,1,0,29,0,-29
13431,0,0,28,0,-28
13432,1,1,1055,1753,698
13433,1,1,215,1493,1278
13434,1,0,25,0,-25
13435,0,0,3,0,-3
13436,1,1,49,2068,2019
13437,0,0,74,0,-74
13438,1,1,1274,1625,351
13439,0,0,50,0,-50
13440,1,0,27,0,-27
13441,0,0,7,0,-7
13442,1,1,502,1200,698
13443,1,1,227,1495,1268
13444,1,0,141,0,-141
13445,0,0,38,0,-38
13446,1,0,17,0,-17
13447,0,0,14,0,-14
13448,1,0,50,0,-50
13449,0,0,51,0,-51
13450,1,1,268,1263,995
13451,0,0,32,0,-32
13452,0,0,45,0,-45
13453,1,1,1006,1573,567
13454,1,1,617,2144,1527
13455,1,0,1,0,-1
13456,1,0,31,0,-31
13457,0,0,12,0,-12
13458,1,1,211,1291,1080
13459,0,0,10,0,-10
13460,1,1,322,1243,921
13461,1,0,5,0,-5
13462,0,0,78,0,-78
13463,0,0,2,0,-2
13464,1,1,1266,1583,317
13465,0,0,30,0,-30
13466,1,0,276,0,-276
13467,1,0,63,0,-63
13468,0,0,182,0,-182
13469,1,1,113,2125,2012
13470,0,0,19,0,-19
13471,0,0,85,0,-85
13472,0,0,122,0,-122
13473,0,0,9,0,-9
13474,0,0,6,0,-6
13475,0,0,33,0,-33
13476,1,0,17,0,-17
13477,1,0,5,0,-5
13478,0,0,38,0,-38
13479,1,0,132,0,-132
13480,1,0,23,0,-23
13481,0,0,44,0,-44
13482,0,0,64,0,-64
13483,1,0,1,0,-1
13484,1,0,17,0,-17
13485,1,1,307,1448,1141
13486,1,0,21,0,-21
13487,0,0,13,0,-13
13488,0,0,58,0,-58
13489,1,0,26,0,-26
13490,1,0,21,0,-21
13491,1,1,106,1460,1354
13492,1,0,43,0,-43
13493,1,1,1667,1342,-325
13494,0,0,28,0,-28
13495,1,0,52,0,-52
13496,1,0,80,0,-80
13497,0,0,2,0,-2
13498,0,0,71,0,-71
13499,0,0,4,0,-4
13500,0,0,13,0,-13
13501,1,1,622,1348,726
13502,1,1,211,2334,2123
13503,1,1,345,1268,923
13504,1,0,12,0,-12
13505,1,1,1537,1975,438
13506,1,1,204,1810,1606
13507,0,0,44,0,-44
13508,1,0,82,0,-82
13509,1,1,1803,1247,-556
13510,0,0,65,0,-65
13511,1,0,1,0,-1
13512,0,0,6,0,-6
13513,1,1,88,1504,1416
13514,0,0,92,0,-92
13515,1,0,11,0,-11
13516,1,1,470,1264,794
13517,0,0,107,0,-107
13518,1,0,32,0,-32
13519,0,0,17,0,-17
13520,1,0,63,0,-63
13521,0,0,2,0,-2
13522,0,0,87,0,-87
13523,0,0,35,0,-35
13524,0,0,216,0,-216
13525,1,1,225,1417,1192
13526,1,0,30,0,-30
13527,0,0,8,0,-8
13528,0,0,5,0,-5
13529,1,0,19,0,-19
13530,1,0,1,0,-1
13531,0,0,33,0,-33
13532,1,0,37,0,-37
13533,0,0,10,0,-10
13534,1,1,305,1254,949
13535,0,0,53,0,-53
13536,0,0,3,0,-3
13537,0,0,94,0,-94
13538,0,0,5,0,-5
13539,1,0,63,0,-63
13540,0,0,126,0,-126
13541,1,0,32,0,-32
13542,1,0,140,0,-140
13543,1,0,72,0,-72
13544,1,0,34,0,-34
13545,0,0,7,0,-7
13546,0,0,30,0,-30
13547,1,1,783,1508,725
13548,1,1,44,1332,1288
13549,1,1,271,1306,1035
13550,1,1,114,2237,2123
13551,1,1,41,1249,1208
13552,1,1,465,1464,999
13553,1,1,425,1976,1551
13554,0,0,16,0,-16
13555,0,0,48,0,-48
13556,1,0,15,0,-15
13557,0,0,38,0,-38
13558,0,0,10,0,-10
13559,1,0,58,0,-58
13560,0,0,21,0,-21
13561,1,0,115,0,-115
13562,0,0,34,0,-34
13563,1,0,1,0,-1
13564,1,1,181,1918,1737
13565,1,1,455,3113,2658
13566,1,0,46,0,-46
13567,0,0,23,0,-23
13568,0,0,75,0,-75
13569,1,0,68,0,-68
13570,0,0,4,0,-4
13571,1,1,307,1416,1109
13572,0,0,46,0,-46
13573,1,0,117,0,-117
13574,0,0,3,0,-3
13575,1,0,4,0,-4
13576,0,0,14,0,-14
13577,1,0,145,0,-145
13578,0,0,91,0,-91
13579,1,1,369,2169,1800
13580,1,1,646,1989,1343
13581,0,0,4,0,-4
13582,1,1,249,1322,1073
13583,0,0,84,0,-84
13584,0,0,34,0,-34
13585,1,0,40,0,-40
13586,0,0,68,0,-68
13587,1,0,68,0,-68
13588,1,1,109,1500,1391
13589,1,0,71,0,-71
13590,1,1,521,1707,1186
13591,1,1,65,1382,1317
13592,1,0,61,0,-61
13593,1,1,41,1297,1256
13594,0,0,112,0,-112
13595,0,0,85,0,-85
13596,1,1,2044,1244,-800
13597,0,0,15,0,-15
13598,1,1,441,1290,849
13599,1,0,54,0,-54
13600,1,0,23,0,-23
13601,1,0,49,0,-49
13602,0,0,17,0,-17
13603,0,0,7,0,-7
13604,1,1,490,1742,1252
13605,1,0,81,0,-81
13606,0,0,30,0,-30
13607,0,0,30,0,-30
13608,0,0,83,0,-83
13609,0,0,46,0,-46
13610,1,1,1250,2544,1294
13611,1,0,44,0,-44
13612,0,0,18,0,-18
13613,0,0,99,0,-99
13614,0,0,96,0,-96
13615,0,0,4,0,-4
13616,1,1,303,1372,1069
13617,1,1,496,1933,1437
13618,0,0,34,0,-34
13619,0,0,0,0,0
13620,1,0,23,0,-23
13621,0,0,118,0,-118
13622,0,0,0,0,0
13623,1,0,0,0,0
13624,1,1,233,1336,1103
13625,1,0,13,0,-13
13626,1,0,138,0,-138
13627,0,0,2,0,-2
13628,1,0,68,0,-68
13629,0,0,78,0,-78
13630,1,0,16,0,-16
13631,0,0,67,0,-67
13632,1,1,145,1224,1079
13633,0,0,13,0,-13
13634,1,1,782,2878,2096
13635,1,0,190,0,-190
13636,1,1,355,1788,1433
13637,1,0,12,0,-12
13638,1,0,41,0,-41
13639,1,1,3281,1380,-1901
13640,0,0,54,0,-54
13641,0,0,89,0,-89
13642,0,0,1,0,-1
13643,0,0,29,0,-29
13644,0,0,91,0,-91
13645,0,0,34,0,-34
13646,0,0,42,0,-42
13647,0,0,1,0,-1
13648,0,0,155,0,-155
13649,1,1,484,1820,1336
13650,1,0,22,0,-22
13651,1,0,20,0,-20
13652,1,1,32,1291,1259
13653,1,1,1172,1209,37
13654,1,0,217,0,-217
13655,0,0,19,0,-19
13656,1,0,21,0,-21
13657,1,1,795,1455,660
13658,1,1,723,1299,576
13659,1,1,491,1549,1058
13660,0,0,53,0,-53
13661,0,0,55,0,-55
13662,1,1,857,1278,421
13663,0,0,56,0,-56
13664,1,0,1,0,-1
13665,0,0,31,0,-31
13666,1,1,606,1384,778
13667,1,1,762,1699,937
13668,0,0,24,0,-24
13669,0,0,96,0,-96
13670,0,0,41,0,-41
13671,1,0,15,0,-15
13672,1,0,6,0,-6
13673,0,0,16,0,-16
13674,0,0,65,0,-65
13675,0,0,44,0,-44
13676,1,1,555,1217,662
13677,0,0,53,0,-53
13678,0,0,3,0,-3
13679,0,0,23,0,-23
13680,1,0,10,0,-10
13681,1,0,49,0,-49
13682,0,0,36,0,-36
13683,1,0,264,0,-264
13684,1,1,54,1324,1270
13685,1,1,752,2198,1446
13686,0,0,72,0,-72
13687,0,0,10,0,-10
13688,1,0,15,0,-15
13689,1,1,650,1246,596
13690,1,0,6,0,-6
13691,0,0,46,0,-46
13692,1,0,18,0,-18
13693,0,0,24,0,-24
13694,1,1,114,1838,1724
13695,1,0,28,0,-28
13696,1,0,51,0,-51
13697,1,1,629,1477,848
13698,0,0,35,0,-35
13699,1,1,682,1330,648
13700,1,1,443,1348,905
13701,0,0,66,0,-66
13702,1,0,35,0,-35
13703,1,1,136,1379,1243
13704,0,0,1,0,-1
13705,0,0,5,0,-5
13706,1,1,627,1210,583
13707,1,1,439,3347,2908
13708,1,1,619,2183,1564
13709,0,0,54,0,-54
13710,0,0,15,0,-15
13711,0,0,59,0,-59
13712,0,0,45,0,-45
13713,1,1,1370,1664,294
13714,0,0,83,0,-83
13715,1,0,2,0,-2
13716,1,0,10,0,-10
13717,1,0,1,0,-1
13718,1,0,67,0,-67
13719,1,0,1,0,-1
13720,0,0,268,0,-268
13721,0,0,28,0,-28
13722,0,0,37,0,-37
13723,1,1,406,1245,839
13724,1,0,69,0,-69
13725,0,0,4,0,-4
13726,1,0,128,0,-128
13727,0,0,40,0,-40
13728,1,1,188,1480,1292
13729,1,1,282,1209,927
13730,0,0,56,0,-56
13731,1,0,23,0,-23
13732,0,0,108,0,-108
13733,1,1,252,1314,1062
13734,0,0,113,0,-113
13735,1,0,51,0,-51
13736,1,0,19,0,-19
13737,0,0,57,0,-57
13738,0,0,34,0,-34
13739,1,1,1469,1334,-135
13740,1,0,2,0,-2
13741,0,0,18,0,-18
13742,1,0,2,0,-2
13743,1,0,14,0,-14
13744,0,0,21,0,-21
13745,1,1,1294,2276,982
13746,0,0,14,0,-14
13747,1,0,60,0,-60
13748,0,0,105,0,-105
13749,0,0,26,0,-26
13750,0,0,27,0,-27
13751,1,0,116,0,-116
13752,0,0,66,0,-66
13753,1,0,9,0,-9
13754,0,0,46,0,-46
13755,1,0,0,0,0
13756,1,1,898,1773,875
13757,0,0,2,0,-2
13758,1,1,2,1711,1709
13759,1,1,706,2424,1718
13760,1,1,1454,1512,58
13761,0,0,54,0,-54
13762,1,1,192,2486,2294
13763,1,0,79,0,-79
13764,0,0,44,0,-44
13765,0,0,3,0,-3
13766,1,1,96,1915,1819
13767,1,1,106,2282,2176
13768,1,0,9,0,-9
13769,0,0,0,0,0
13770,1,0,15,0,-15
13771,1,0,55,0,-55
13772,0,0,159,0,-159
13773,1,1,479,2441,1962
13774,1,0,10,0,-10
13775,1,1,111,1613,1502
13776,1,0,25,0,-25
13777,0,0,20,0,-20
13778,0,0,16,0,-16
13779,1,1,114,1366,1252
13780,0,0,41,0,-41
13781,0,0,9,0,-9
13782,1,1,178,1217,1039
13783,1,1,572,1243,671
13784,0,0,112,0,-112
13785,1,1,376,1420,1044
13786,0,0,132,0,-132
13787,1,1,151,1551,1400
13788,1,1,719,2225,1506
13789,1,1,363,1467,1104
13790,0,0,8,0,-8
13791,1,1,362,1202,840
13792,1,0,9,0,-9
13793,1,1,42,1447,1405
13794,1,1,175,1628,1453
13795,1,0,105,0,-105
13796,1,1,205,1617,1412
13797,0,0,29,0,-29
13798,1,0,39,0,-39
13799,1,0,35,0,-35
13800,1,0,33,0,-33
13801,0,0,54,0,-54
13802,0,0,4,0,-4
13803,1,1,1244,3648,2404
13804,0,0,37,0,-37
13805,0,0,33,0,-33
13806,0,0,10,0,-10
13807,1,1,96,1235,1139
13808,1,0,28,0,-28
13809,1,1,669,1237,568
13810,0,0,73,0,-73
13811,0,0,15,0,-15
13812,0,0,144,0,-144
13813,1,1,522,1709,1187
13814,0,0,13,0,-13
13815,0,0,116,0,-116
13816,1,0,65,0,-65
13817,0,0,8,0,-8
13818,0,0,63,0,-63
13819,1,0,7,0,-7
13820,1,1,2195,1481,-714
13821,0,0,35,0,-35
13822,1,1,689,2561,1872
13823,0,0,5,0,-5
13824,0,0,43,0,-43
13825,1,0,44,0,-44
13826,0,0,1,0,-1
13827,1,1,216,1832,1616
13828,1,1,210,1207,997
13829,1,0,10,0,-10
13830,0,0,45,0,-45
13831,1,0,72,0,-72
13832,1,0,72,0,-72
13833,1,1,520,1411,891
13834,1,0,29,0,-29
13835,0,0,3,0,-3
13836,0,0,2,0,-2
13837,0,0,15,0,-15
13838,0,0,17,0,-17
13839,1,0,19,0,-19
13840,1,0,24,0,-24
13841,0,0,16,0,-16
13842,1,1,740,1244,504
13843,1,1,358,1956,1598
13844,0,0,78,0,-78
13845,0,0,112,0,-112
13846,0,0,134,0,-134
13847,1,1,62,1419,1357
13848,1,1,302,1213,911
13849,0,0,50,0,-50
13850,0,0,184,0,-184
13851,0,0,7,0,-7
13852,0,0,76,0,-76
13853,1,0,65,0,-65
13854,1,1,307,1230,923
13855,1,0,81,0,-81
13856,1,1,1209,1254,45
13857,0,0,52,0,-52
13858,1,0,48,0,-48
13859,1,1,199,1435,1236
13860,1,0,54,0,-54
13861,0,0,37,0,-37
13862,0,0,49,0,-49
13863,1,0,83,0,-83
13864,0,0,11,0,-11
13865,1,1,1063,1267,204
13866,1,1,656,1832,1176
13867,0,0,13,0,-13
13868,0,0,65,0,-65
13869,1,1,145,1888,1743
13870,1,0,14,0,-14
13871,1,1,607,1261,654
13872,1,0,67,0,-67
13873,1,0,86,0,-86
13874,1,0,7,0,-7
13875,0,0,50,0,-50
13876,1,0,62,0,-62
13877,0,0,10,0,-10
13878,1,1,956,1379,423
13879,1,1,412,1575,1163
13880,1,0,4,0,-4
13881,1,0,25,0,-25
13882,1,1,1407,2675,1268
13883,1,0,12,0,-12
13884,0,0,5,0,-5
13885,0,0,0,0,0
13886,0,0,71,0,-71
13887,0,0,7,0,-7
13888,0,0,179,0,-179
13889,1,1,1516,1317,-199
13890,1,1,53,1215,1162
13891,0,0,48,0,-48
13892,0,0,208,0,-208
13893,0,0,39,0,-39
13894,0,0,102,0,-102
13895,0,0,61,0,-61
13896,0,0,5,0,-5
13897,1,1,1144,2134,990
13898,1,0,53,0,-53
13899,1,1,381,1675,1294
13900,1,1,100,1364,1264
13901,1,0,32,0,-32
13902,1,1,590,1695,1105
13903,1,0,112,0,-112
13904,0,0,17,0,-17
13905,1,0,27,0,-27
13906,1,1,102,1459,1357
13907,1,1,436,1352,916
13908,1,1,1120,1424,304
13909,1,0,2,0,-2
13910,0,0,47,0,-47
13911,0,0,145,0,-145
13912,1,1,191,1247,1056
13913,1,0,93,0,-93
13914,1,1,735,1225,490
13915,1,1,1453,1362,-91
13916,0,0,86,0,-86
13917,1,1,112,1486,1374
13918,1,1,373,1446,1073
13919,1,0,2,0,-2
13920,1,0,2,0,-2
13921,0,0,33,0,-33
13922,0,0,32,0,-32
13923,1,0,93,0,-93
13924,1,1,63,1359,1296
13925,0,0,47,0,-47
13926,1,1,961,1467,506
13927,0,0,25,0,-25
13928,0,0,20,0,-20
13929,0,0,5,0,-5
13930,1,0,77,0,-77
13931,0,0,208,0,-208
13932,0,0,87,0,-87
13933,0,0,28,0,-28
13934,1,1,663,1945,1282
13935,0,0,110,0,-110
13936,0,0,278,0,-278
13937,1,0,37,0,-37
13938,0,0,3,0,-3
13939,1,1,55,1307,1252
13940,1,0,94,0,-94
13941,0,0,70,0,-70
13942,0,0,40,0,-40
13943,1,0,51,0,-51
13944,1,0,50,0,-50
13945,1,0,96,0,-96
13946,0,0,0,0,0
13947,0,0,61,0,-61
13948,1,1,163,1220,1057
13949,1,0,5,0,-5
13950,1,1,1432,1247,-185
13951,1,1,426,1388,962
13952,0,0,8,0,-8
13953,1,1,922,1423,501
13954,1,1,302,1928,1626
13955,1,0,17,0,-17
13956,1,0,117,0,-117
13957,1,1,170,1795,1625
13958,1,1,721,1404,683
13959,0,0,10,0,-10
13960,0,0,34,0,-34
13961,0,0,101,0,-101
13962,1,1,622,1485,863
13963,1,1,398,1226,828
13964,0,0,61,0,-61
13965,1,1,737,1543,806
13966,0,0,40,0,-40
13967,1,0,10,0,-10
13968,1,1,483,1322,839
13969,0,0,43,0,-43
13970,0,0,14,0,-14
13971,1,1,537,1202,665
13972,1,1,304,1429,1125
13973,1,0,74,0,-74
13974,1,0,16,0,-16
13975,0,0,56,0,-56
13976,1,1,620,1238,618
13977,1,0,35,0,-35
13978,1,1,196,1428,1232
13979,0,0,49,0,-49
13980,1,0,11,0,-11
13981,1,1,533,1472,939
13982,1,0,3,0,-3
13983,1,0,103,0,-103
13984,0,0,78,0,-78
13985,0,0,8,0,-8
13986,1,0,52,0,-52
13987,1,0,38,0,-38
13988,0,0,23,0,-23
13989,0,0,11,0,-11
13990,1,1,131,1368,1237
13991,0,0,31,0,-31
13992,1,1,1516,1351,-165
13993,1,1,38,1207,1169
13994,1,1,291,1236,945
13995,0,0,3,0,-3
13996,0,0,21,0,-21
13997,1,1,141,1562,1421
13998,1,0,20,0,-20
13999,1,1,247,1487,1240
14000,0,0,91,0,-91
14001,1,0,1,0,-1
14002,0,0,56,0,-56
14003,0,0,16,0,-16
14004,0,0,99,0,-99
14005,0,0,11,0,-11
14006,1,1,277,1254,977
14007,1,0,86,0,-86
14008,1,1,2049,1288,-761
14009,1,0,108,0,-108
14010,1,1,65,1810,1745
14011,1,0,188,0,-188
14012,1,0,16,0,-16
14013,1,0,74,0,-74
14014,1,1,1867,1337,-530
14015,0,0,16,0,-16
14016,1,1,247,1824,1577
14017,1,1,671,3471,2800
14018,1,1,34,1284,1250
14019,1,1,68,1830,1762
14020,1,1,1561,3731,2170
14021,0,0,3,0,-3
14022,0,0,42,0,-42
14023,1,1,142,1638,1496
14024,0,0,17,0,-17
14025,1,0,17,0,-17
14026,0,0,32,0,-32
14027,0,0,7,0,-7
14028,1,1,285,1354,1069
14029,1,1,2771,1345,-1426
14030,0,0,6,0,-6
14031,1,0,23,0,-23
14032,1,0,43,0,-43
14033,1,0,42,0,-42
14034,0,0,16,0,-16
14035,0,0,20,0,-20
14036,1,0,303,0,-303
14037,0,0,2,0,-2
14038,0,0,5,0,-5
14039,0,0,126,0,-126
14040,1,1,1329,1304,-25
14041,1,0,40,0,-40
14042,1,0,5,0,-5
14043,1,0,54,0,-54
14044,1,1,355,1481,1126
14045,1,1,21,1608,1587
14046,0,0,0,0,0
14047,1,1,126,1324,1198
14048,1,0,104,0,-104
14049,1,1,402,1519,1117
14050,1,1,830,1346,516
14051,1,0,12,0,-12
14052,1,0,47,0,-47
14053,0,0,79,0,-79
14054,1,1,2335,1273,-1062
14055,1,1,276,1398,1122
14056,1,0,12,0,-12
14057,1,0,110,0,-110
14058,1,1,153,2340,2187
14059,1,0,1,0,-1
14060,0,0,14,0,-14
14061,0,0,12,0,-12
14062,0,0,144,0,-144
14063,0,0,124,0,-124
14064,1,0,75,0,-75
14065,0,0,113,0,-113
14066,0,0,98,0,-98
14067,0,0,179,0,-179
14068,1,1,849,1351,502
14069,1,0,25,0,-25
14070,1,1,477,1708,1231
14071,1,1,612,1356,744
14072,0,0,141,0,-141
14073,0,0,113,0,-113
14074,1,0,3,0,-3
14075,1,0,0,0,0
14076,1,0,13,0,-13
14077,1,0,114,0,-114
14078,1,0,64,0,-64
14079,0,0,139,0,-139
14080,1,0,14,0,-14
14081,1,1,986,1297,311
14082,0,0,50,0,-50
14083,1,0,85,0,-85
14084,0,0,16,0,-16
14085,0,0,20,0,-20
14086,1,1,466,1583,1117
14087,1,1,933,1385,452
14088,1,1,503,1310,807
14089,0,0,7,0,-7
14090,1,1,168,1533,1365
14091,1,0,1,0,-1
14092,1,1,512,1365,853
14093,1,1,347,1484,1137
14094,1,0,2,0,-2
14095,1,0,19,0,-19
14096,0,0,17,0,-17
14097,1,0,14,0,-14
14098,1,1,632,1243,611
14099,1,0,32,0,-32
14100,0,0,64,0,-64
14101,1,0,92,0,-92
14102,1,1,487,2398,1911
14103,1,0,8,0,-8
14104,1,1,375,1411,1036
14105,1,0,52,0,-52
14106,1,0,27,0,-27
14107,0,0,89,0,-89
14108,1,1,774,1232,458
14109,1,0,48,0,-48
14110,0,0,105,0,-105
14111,0,0,51,0,-51
14112,1,1,182,1740,1558
14113,1,0,3,0,-3
14114,1,1,1096,1576,480
14115,1,1,1594,1519,-75
14116,1,1,176,1361,1185
14117,0,0,50,0,-50
14118,0,0,32,0,-32
14119,1,1,373,1609,1236
14120,0,0,99,0,-99
14121,0,0,38,0,-38
14122,1,0,93,0,-93
14123,1,1,445,2046,1601
14124,1,1,500,1604,1104
14125,1,0,90,0,-90
14126,1,1,420,2038,1618
14127,1,0,30,0,-30
14128,0,0,1,0,-1
14129,0,0,46,0,-46
14130,1,1,2359,1748,-611
14131,1,0,67,0,-67
14132,1,1,1261,1528,267
14133,1,0,46,0,-46
14134,1,1,2219,1355,-864
14135,1,0,29,0,-29
14136,1,0,71,0,-71
14137,0,0,46,0,-46
14138,1,0,23,0,-23
14139,1,0,84,0,-84
14140,0,0,24,0,-24
14141,1,0,12,0,-12
14142,1,1,122,1431,1309
14143,0,0,16,0,-16
14144,0,0,5,0,-5
14145,0,0,31,0,-31
14146,1,0,96,0,-96
14147,0,0,63,0,-63
14148,1,1,229,1637,1408
14149,1,0,0,0,0
14150,0,0,55,0,-55
14151,1,1,1231,1262,31
14152,0,0,74,0,-74
14153,1,1,1381,1418,37
14154,1,1,3998,1371,-2627
14155,1,0,160,0,-160
14156,1,0,55,0,-55
14157,1,0,44,0,-44
14158,1,0,65,0,-65
14159,1,0,11,0,-11
14160,1,1,178,1779,1601
14161,1,1,1044,1430,386
14162,0,0,2,0,-2
14163,1,0,56,0,-56
14164,1,1,119,1503,1384
14165,1,0,73,0,-73
14166,1,1,129,2790,2661
14167,1,1,596,1252,656
14168,0,0,32,0,-32
14169,1,0,15,0,-15
14170,0,0,20,0,-20
14171,1,0,15,0,-15
14172,0,0,18,0,-18
14173,1,0,58,0,-58
14174,0,0,17,0,-17
14175,0,0,11,0,-11
14176,1,1,245,1786,1541
14177,0,0,83,0,-83
14178,1,1,559,1209,650
14179,1,1,484,1314,830
14180,1,0,17,0,-17
14181,1,1,167,1540,1373
14182,0,0,46,0,-46
14183,1,0,0,0,0
14184,0,0,11,0,-11
14185,1,0,2,0,-2
14186,1,1,604,1540,936
14187,1,1,526,1237,711
14188,0,0,49,0,-49
14189,0,0,8,0,-8
14190,0,0,24,0,-24
14191,0,0,8,0,-8
14192,1,1,941,1246,305
14193,0,0,20,0,-20
14194,0,0,40,0,-40
14195,1,0,122,0,-122
14196,1,1,547,1200,653
14197,0,0,9,0,-9
14198,1,1,263,1524,1261
14199,1,1,1183,1654,471
14200,1,1,435,1285,850
14201,1,1,344,1221,877
14202,0,0,15,0,-15
14203,1,0,70,0,-70
14204,1,0,34,0,-34
14205,0,0,76,0,-76
14206,0,0,1,0,-1
14207,0,0,25,0,-25
14208,0,0,167,0,-167
14209,0,0,56,0,-56
14210,1,1,304,1489,1185
14211,1,0,28,0,-28
14212,1,1,613,1254,641
14213,1,1,633,1389,756
14214,0,0,53,0,-53
14215,1,0,54,0,-54
14216,0,0,140,0,-140
14217,1,1,623,1348,725
14218,1,0,64,0,-64
14219,0,0,65,0,-65
14220,0,0,9,0,-9
14221,0,0,36,0,-36
14222,1,0,37,0,-37
14223,1,1,375,1298,923
14224,1,1,879,1247,368
14225,1,0,7,0,-7
14226,1,0,52,0,-52
14227,1,0,10,0,-10
14228,1,1,159,1214,1055
14229,1,0,4,0,-4
14230,1,1,747,1238,491
14231,1,0,47,0,-47
14232,1,0,24,0,-24
14233,0,0,11,0,-11
14234,1,1,20,1206,1186
14235,1,0,8,0,-8
14236,0,0,33,0,-33
14237,0,0,14,0,-14
14238,1,0,8,0,-8
14239,1,0,137,0,-137
14240,0,0,59,0,-59
14241,1,1,251,1477,1226
14242,0,0,2,0,-2
14243,1,1,398,1231,833
14244,1,0,0,0,0
14245,1,1,224,1609,1385
14246,1,1,566,1352,786
14247,1,1,248,1330,1082
14248,0,0,42,0,-42
14249,1,0,13,0,-13
14250,1,1,149,1270,1121
14251,0,0,23,0,-23
14252,0,0,44,0,-44
14253,1,0,4,0,-4
14254,1,0,46,0,-46
14255,1,0,27,0,-27
14256,1,1,302,1264,962
14257,1,0,35,0,-35
14258,1,0,7,0,-7
14259,1,0,53,0,-53
14260,1,0,36,0,-36
14261,1,1,398,1597,1199
14262,1,1,547,1231,684
14263,1,0,20,0,-20
14264,1,0,5,0,-5
14265,1,0,27,0,-27
14266,1,1,166,1356,1190
14267,0,0,73,0,-73
14268,0,0,4,0,-4
14269,0,0,6,0,-6
14270,0,0,88,0,-88
14271,1,0,55,0,-55
14272,1,1,1397,1247,-150
14273,1,1,416,1257,841
14274,1,0,21,0,-21
14275,0,0,68,0,-68
14276,1,0,0,0,0
14277,1,1,493,1432,939
14278,1,1,489,1264,775
14279,1,0,23,0,-23
14280,0,0,16,0,-16
14281,0,0,1,0,-1
14282,1,1,195,1300,1105
14283,1,0,24,0,-24
14284,0,0,96,0,-96
14285,0,0,33,0,-33
14286,0,0,110,0,-110
14287,1,0,2,0,-2
14288,1,1,275,1467,1192
14289,1,1,83,1279,1196
14290,1,1,818,1355,537
14291,1,0,138,0,-138
14292,0,0,46,0,-46
14293,0,0,158,0,-158
14294,0,0,25,0,-25
14295,1,1,407,1241,834
14296,1,1,221,1818,1597
14297,1,1,336,1234,898
14298,1,0,15,0,-15
14299,0,0,77,0,-77
14300,0,0,77,0,-77
14301,0,0,48,0,-48
14302,1,1,979,1740,761
14303,1,0,0,0,0
14304,0,0,4,0,-4
14305,1,0,40,0,-40
14306,0,0,13,0,-13
14307,1,0,29,0,-29
14308,1,1,236,1434,1198
14309,1,0,52,0,-52
14310,1,1,536,1361,825
14311,0,0,18,0,-18
14312,1,0,23,0,-23
14313,0,0,45,0,-45
14314,1,0,80,0,-80
14315,0,0,106,0,-106
14316,0,0,32,0,-32
14317,1,0,36,0,-36
14318,1,0,25,0,-25
14319,1,0,83,0,-83
14320,0,0,1,0,-1
14321,1,0,172,0,-172
14322,0,0,10,0,-10
14323,0,0,58,0,-58
14324,1,0,38,0,-38
14325,1,0,17,0,-17
14326,0,0,57,0,-57
14327,0,0,95,0,-95
14328,1,1,139,1252,1113
14329,1,0,13,0,-13
14330,0,0,10,0,-10
14331,1,1,76,1211,1135
14332,0,0,17,0,-17
14333,1,1,160,1276,1116
14334,1,1,1197,1865,668
14335,1,0,19,0,-19
14336,1,0,61,0,-61
14337,0,0,7,0,-7
14338,0,0,11,0,-11
14339,1,1,711,1732,1021
14340,0,0,38,0,-38
14341,1,0,17,0,-17
14342,0,0,62,0,-62
14343,1,1,212,1989,1777
14344,1,1,1323,1510,187
14345,1,0,57,0,-57
14346,0,0,5,0,-5
14347,0,0,24,0,-24
14348,0,0,37,0,-37
14349,1,1,339,2777,2438
14350,0,0,29,0,-29
14351,0,0,25,0,-25
14352,1,0,24,0,-24
14353,1,1,736,1526,790
14354,1,1,368,1283,915
14355,1,0,37,0,-37
14356,1,1,1729,1816,87
14357,1,0,46,0,-46
14358,0,0,93,0,-93
14359,1,1,580,2109,1529
14360,1,0,36,0,-36
14361,0,0,9,0,-9
14362,1,1,145,1702,1557
14363,1,0,66,0,-66
14364,1,0,22,0,-22
14365,1,1,329,1280,951
14366,1,1,555,1323,768
14367,1,0,3,0,-3
14368,0,0,152,0,-152
14369,1,1,456,1342,886
14370,0,0,33,0,-33
14371,0,0,10,0,-10
14372,1,1,1393,2533,1140
14373,1,1,573,1469,896
14374,1,1,169,1662,1493
14375,0,0,33,0,-33
14376,0,0,9,0,-9
14377,0,0,21,0,-21
14378,1,0,4,0,-4
14379,1,1,1205,1630,425
14380,0,0,7,0,-7
14381,0,0,2,0,-2
14382,0,0,39,0,-39
14383,1,1,158,1241,1083
14384,1,0,4,0,-4
14385,1,0,15,0,-15
14386,0,0,343,0,-343
14387,1,1,379,1332,953
14388,1,1,255,1380,1125
14389,1,1,919,1292,373
14390,1,1,322,1437,1115
14391,1,0,5,0,-5
14392,0,0,91,0,-91
14393,1,0,8,0,-8
14394,1,0,82,0,-82
14395,1,0,80,0,-80
14396,1,0,17,0,-17
14397,1,0,81,0,-81
14398,1,1,1222,3312,2090
14399,1,0,110,0,-110
14400,1,0,58,0,-58
14401,1,1,432,1281,849
14402,0,0,37,0,-37
14403,0,0,12,0,-12
14404,1,1,380,1309,929
14405,1,1,332,1659,1327
14406,1,1,24,1504,1480
14407,1,1,319,1770,1451
14408,0,0,16,0,-16
14409,0,0,19,0,-19
14410,1,1,462,2336,1874
14411,1,1,113,1288,1175
14412,0,0,127,0,-127
14413,0,0,65,0,-65
14414,1,0,29,0,-29
14415,1,0,6,0,-6
14416,1,0,55,0,-55
14417,0,0,15,0,-15
14418,1,0,88,0,-88
14419,1,0,296,0,-296
14420,1,0,45,0,-45
14421,1,1,521,2034,1513
14422,1,1,48,1415,1367
14423,1,1,710,1377,667
14424,0,0,20,0,-20
14425,1,1,120,1414,1294
14426,1,0,13,0,-13
14427,1,0,33,0,-33
14428,0,0,103,0,-103
14429,1,1,104,1485,1381
14430,1,0,32,0,-32
14431,1,0,2,0,-2
14432,1,0,41,0,-41
14433,1,1,250,1777,1527
14434,1,0,15,0,-15
14435,1,1,170,1387,1217
14436,1,0,13,0,-13
14437,1,1,413,1483,1070
14438,1,1,222,1256,1034
14439,0,0,32,0,-32
14440,1,0,2,0,-2
14441,0,0,201,0,-201
14442,1,1,2340,2027,-313
14443,1,1,248,1953,1705
14444,1,1,57,1219,1162
14445,1,0,17,0,-17
14446,1,1,283,2111,1828
14447,1,1,731,1363,632
14448,0,0,2,0,-2
14449,0,0,66,0,-66
14450,0,0,34,0,-34
14451,1,1,563,1733,1170
14452,1,0,35,0,-35
14453,1,0,64,0,-64
14454,1,0,16,0,-16
14455,1,1,802,1463,661
14456,1,1,167,1834,1667
14457,1,1,551,2107,1556
14458,0,0,6,0,-6
14459,0,0,26,0,-26
14460,1,0,11,0,-11
14461,1,1,2970,1381,-1589
14462,1,0,98,0,-98
14463,0,0,68,0,-68
14464,0,0,30,0,-30
14465,1,1,760,1323,563
14466,1,1,770,1441,671
14467,1,0,34,0,-34
14468,0,0,35,0,-35
14469,1,0,29,0,-29
14470,0,0,8,0,-8
14471,0,0,3,0,-3
14472,1,0,20,0,-20
14473,0,0,92,0,-92
14474,1,0,247,0,-247
14475,0,0,100,0,-100
14476,0,0,24,0,-24
14477,0,0,104,0,-104
14478,1,1,306,1756,1450
14479,1,0,95,0,-95
14480,0,0,57,0,-57
14481,0,0,5,0,-5
14482,1,1,444,1685,1241
14483,0,0,66,0,-66
14484,1,0,105,0,-105
14485,0,0,4,0,-4
14486,0,0,11,0,-11
14487,1,0,51,0,-51
14488,0,0,33,0,-33
14489,1,0,10,0,-10
14490,1,0,84,0,-84
14491,1,0,59,0,-59
14492,1,0,95,0,-95
14493,1,1,738,1249,511
14494,1,0,31,0,-31
14495,0,0,126,0,-126
14496,1,1,131,1256,1125
14497,1,1,66,1350,1284
14498,1,1,272,1937,1665
14499,1,1,461,3277,2816
14500,0,0,55,0,-55
14501,1,1,775,1292,517
14502,1,1,242,2044,1802
14503,1,0,9,0,-9
14504,1,1,787,1348,561
14505,1,0,58,0,-58
14506,0,0,9,0,-9
14507,1,0,103,0,-103
14508,1,1,532,1308,776
14509,1,0,14,0,-14
14510,0,0,2,0,-2
14511,1,1,473,1207,734
14512,1,0,18,0,-18
14513,1,1,65,1298,1233
14514,1,1,159,1653,1494
14515,1,1,255,1298,1043
14516,1,0,14,0,-14
14517,1,1,150,1629,1479
14518,1,1,773,1331,558
14519,1,0,22,0,-22
14520,0,0,48,0,-48
14521,1,1,320,1265,945
14522,1,1,1544,1467,-77
14523,0,0,137,0,-137
14524,0,0,14,0,-14
14525,0,0,18,0,-18
14526,0,0,46,0,-46
14527,0,0,45,0,-45
14528,0,0,9,0,-9
14529,0,0,104,0,-104
14530,1,0,36,0,-36
14531,1,0,23,0,-23
14532,1,1,844,1266,422
14533,1,1,555,1440,885
14534,0,0,85,0,-85
14535,1,0,39,0,-39
14536,1,0,0,0,0
14537,1,0,22,0,-22
14538,0,0,33,0,-33
14539,1,0,66,0,-66
14540,1,0,10,0,-10
14541,1,1,183,1319,1136
14542,0,0,71,0,-71
14543,1,1,154,1298,1144
14544,1,0,234,0,-234
14545,0,0,1,0,-1
14546,0,0,58,0,-58
14547,1,0,124,0,-124
14548,0,0,77,0,-77
14549,0,0,2,0,-2
14550,0,0,56,0,-56
14551,1,0,68,0,-68
14552,1,0,22,0,-22
14553,1,0,91,0,-91
14554,1,1,1781,1670,-111
14555,0,0,30,0,-30
14556,0,0,25,0,-25
14557,1,0,15,0,-15
14558,1,0,19,0,-19
14559,1,0,136,0,-136
14560,1,1,114,1597,1483
14561,0,0,36,0,-36
14562,1,0,177,0,-177
14563,0,0,29,0,-29
14564,0,0,12,0,-12
14565,1,0,11,0,-11
14566,1,0,6,0,-6
14567,0,0,64,0,-64
14568,0,0,42,0,-42
14569,0,0,8,0,-8
14570,0,0,62,0,-62
14571,0,0,15,0,-15
14572,1,0,124,0,-124
14573,1,0,0,0,0
14574,0,0,157,0,-157
14575,1,0,25,0,-25
14576,1,0,136,0,-136
14577,0,0,68,0,-68
14578,1,1,685,1250,565
14579,1,0,39,0,-39
14580,1,0,6,0,-6
14581,0,0,118,0,-118
14582,1,1,1972,1263,-709
14583,0,0,3,0,-3
14584,1,1,253,1589,1336
14585,0,0,27,0,-27
14586,1,1,173,1260,1087
14587,0,0,8,0,-8
14588,0,0,29,0,-29
14589,0,0,2,0,-2
14590,1,1,1294,1313,19
14591,0,0,201,0,-201
14592,0,0,13,0,-13
14593,1,0,11,0,-11
14594,1,0,11,0,-11
14595,1,1,484,1635,1151
14596,0,0,20,0,-20
14597,0,0,122,0,-122
14598,0,0,64,0,-64
14599,0,0,46,0,-46
14600,0,0,24,0,-24
14601,0,0,33,0,-33
14602,1,0,34,0,-34
14603,0,0,15,0,-15
14604,0,0,8,0,-8
14605,1,1,638,1307,669
14606,1,0,57,0,-57
14607,1,0,66,0,-66
14608,0,0,67,0,-67
14609,1,0,35,0,-35
14610,1,1,351,1479,1128
14611,0,0,9,0,-9
14612,1,1,335,1403,1068
14613,1,0,20,0,-20
14614,1,0,6,0,-6
14615,1,0,9,0,-9
14616,1,1,528,2010,1482
14617,0,0,49,0,-49
14618,1,0,99,0,-99
14619,0,0,83,0,-83
14620,0,0,84,0,-84
14621,1,1,340,1509,1169
14622,0,0,26,0,-26
14623,0,0,5,0,-5
14624,0,0,114,0,-114
14625,0,0,105,0,-105
14626,1,0,60,0,-60
14627,1,0,313,0,-313
14628,1,0,23,0,-23
14629,1,1,1882,1673,-209
14630,1,1,265,1356,1091
14631,1,0,4,0,-4
14632,1,0,90,0,-90
14633,1,1,549,1251,702
14634,0,0,3,0,-3
14635,1,0,28,0,-28
14636,0,0,22,0,-22
14637,0,0,29,0,-29
14638,1,0,30,0,-30
14639,0,0,4,0,-4
14640,1,1,932,1209,277
14641,1,0,23,0,-23
14642,0,0,218,0,-218
14643,0,0,9,0,-9
14644,1,0,123,0,-123
14645,0,0,24,0,-24
14646,1,1,106,1442,1336
14647,0,0,0,0,0
14648,1,0,78,0,-78
14649,0,0,58,0,-58
14650,1,1,74,1789,1715
14651,1,1,1084,1452,368
14652,0,0,1,0,-1
14653,1,0,30,0,-30
14654,1,1,1075,2550,1475
14655,1,1,413,1581,1168
14656,0,0,11,0,-11
14657,0,0,9,0,-9
14658,0,0,119,0,-119
14659,0,0,47,0,-47
14660,1,0,27,0,-27
14661,1,1,48,1357,1309
14662,0,0,3,0,-3
14663,1,0,32,0,-32
14664,1,0,61,0,-61
14665,1,1,581,1935,1354
14666,1,1,691,1202,511
14667,1,0,3,0,-3
14668,0,0,21,0,-21
14669,0,0,1,0,-1
14670,1,1,145,1283,1138
14671,0,0,72,0,-72
14672,0,0,85,0,-85
14673,1,0,37,0,-37
14674,1,1,366,1692,1326
14675,1,1,1235,1804,569
14676,1,0,4,0,-4
14677,1,1,423,1701,1278
14678,0,0,50,0,-50
14679,0,0,7,0,-7
14680,1,1,740,1221,481
14681,1,1,133,1533,1400
14682,0,0,82,0,-82
14683,1,0,34,0,-34
14684,0,0,36,0,-36
14685,1,0,22,0,-22
14686,1,1,74,1354,1280
14687,1,0,27,0,-27
14688,1,1,824,1251,427
14689,0,0,5,0,-5
14690,1,1,253,1214,961
14691,0,0,28,0,-28
14692,0,0,12,0,-12
14693,1,1,305,1685,1380
14694,1,1,1459,1249,-210
14695,0,0,24,0,-24
14696,0,0,215,0,-215
14697,0,0,69,0,-69
14698,0,0,15,0,-15
14699,1,0,36,0,-36
14700,1,1,153,1225,1072
14701,0,0,17,0,-17
14702,0,0,51,0,-51
14703,0,0,5,0,-5
14704,0,0,29,0,-29
14705,0,0,19,0,-19
14706,0,0,9,0,-9
14707,0,0,151,0,-151
14708,1,1,138,1667,1529
14709,1,0,11,0,-11
14710,1,1,474,1317,843
14711,1,0,149,0,-149
14712,1,1,63,2050,1987
14713,0,0,15,0,-15
14714,1,0,64,0,-64
14715,1,0,27,0,-27
14716,0,0,142,0,-142
14717,1,1,159,1323,1164
14718,1,1,117,1791,1674
14719,0,0,2,0,-2
14720,1,1,54,1356,1302
14721,0,0,92,0,-92
14722,1,1,1722,1265,-457
14723,0,0,2,0,-2
14724,1,1,611,1252,641
14725,0,0,39,0,-39
14726,0,0,14,0,-14
14727,1,0,131,0,-131
14728,0,0,14,0,-14
14729,1,0,131,0,-131
14730,1,1,253,1422,1169
14731,1,0,107,0,-107
14732,0,0,12,0,-12
14733,0,0,82,0,-82
14734,0,0,51,0,-51
14735,1,1,271,1406,1135
14736,0,0,6,0,-6
14737,1,1,158,2097,1939
14738,1,0,60,0,-60
14739,0,0,16,0,-16
14740,1,1,899,1504,605
14741,0,0,62,0,-62
14742,1,1,300,1201,901
14743,1,0,37,0,-37
14744,1,0,8,0,-8
14745,0,0,48,0,-48
14746,1,0,96,0,-96
14747,0,0,13,0,-13
14748,1,0,3,0,-3
14749,1,0,34,0,-34
14750,1,1,97,1315,1218
14751,1,0,14,0,-14
14752,0,0,16,0,-16
14753,1,1,626,1541,915
14754,1,1,1303,1661,358
14755,1,1,197,1419,1222
14756,1,1,537,1521,984
14757,0,0,2,0,-2
14758,0,0,8,0,-8
14759,1,1,1857,2790,933
14760,1,1,482,1452,970
14761,0,0,105,0,-105
14762,0,0,7,0,-7
14763,0,0,69,0,-69
14764,1,1,60,5280,5220
14765,0,0,141,0,-141
14766,1,1,31,1795,1764
14767,1,1,1217,1311,94
14768,0,0,13,0,-13
14769,0,0,36,0,-36
14770,1,1,149,1391,1242
14771,0,0,3,0,-3
14772,1,1,1192,1240,48
14773,0,0,101,0,-101
14774,1,0,3,0,-3
14775,0,0,39,0,-39
14776,1,1,317,1499,1182
14777,1,1,428,1280,852
14778,0,0,26,0,-26
14779,0,0,3,0,-3
14780,1,1,46,1246,1200
14781,1,1,143,1205,1062
14782,1,0,266,0,-266
14783,0,0,2,0,-2
14784,1,0,41,0,-41
14785,1,1,68,2249,2181
14786,0,0,80,0,-80
14787,0,0,53,0,-53
14788,1,1,457,1572,1115
14789,1,1,215,1435,1220
14790,1,0,42,0,-42
14791,1,0,51,0,-51
14792,0,0,120,0,-120
14793,1,0,76,0,-76
14794,0,0,7,0,-7
14795,0,0,58,0,-58
14796,1,1,1807,2376,569
14797,1,1,724,1592,868
14798,0,0,97,0,-97
14799,0,0,0,0,0
14800,0,0,7,0,-7
14801,0,0,108,0,-108
14802,1,1,501,1773,1272
14803,1,0,53,0,-53
14804,0,0,1,0,-1
14805,0,0,139,0,-139
14806,0,0,6,0,-6
14807,0,0,7,0,-7
14808,0,0,54,0,-54
14809,1,1,115,1585,1470
14810,1,1,438,1360,922
14811,1,0,6,0,-6
14812,0,0,64,0,-64
14813,0,0,30,0,-30
14814,1,0,37,0,-37
14815,1,0,11,0,-11
14816,1,1,47,1399,1352
14817,1,1,844,1334,490
14818,1,0,25,0,-25
14819,0,0,19,0,-19
14820,0,0,23,0,-23
14821,1,0,72,0,-72
14822,1,0,5,0,-5
14823,0,0,71,0,-71
14824,0,0,148,0,-148
14825,0,0,65,0,-65
14826,1,1,724,1305,581
14827,1,0,8,0,-8
14828,1,0,83,0,-83
14829,1,0,19,0,-19
14830,1,1,369,1220,851
14831,0,0,29,0,-29
14832,1,0,27,0,-27
14833,1,1,261,1513,1252
14834,0,0,55,0,-55
14835,1,1,796,1591,795
14836,1,1,55,1414,1359
14837,0,0,17,0,-17
14838,0,0,67,0,-67
14839,0,0,26,0,-26
14840,0,0,161,0,-161
14841,1,0,18,0,-18
14842,1,0,42,0,-42
14843,0,0,82,0,-82
14844,1,0,16,0,-16
14845,1,1,937,1313,376
14846,0,0,4,0,-4
14847,1,1,499,1226,727
14848,1,1,159,1466,1307
14849,1,1,182,1392,1210
14850,0,0,32,0,-32
14851,1,0,29,0,-29
14852,1,1,644,1517,873
14853,1,1,142,1284,1142
14854,1,1,26,1364,1338
14855,0,0,155,0,-155
14856,0,0,22,0,-22
14857,0,0,3,0,-3
14858,1,0,57,0,-57
14859,1,1,187,1308,1121
14860,1,0,20,0,-20
14861,0,0,19,0,-19
14862,1,0,35,0,-35
14863,0,0,71,0,-71
14864,0,0,109,0,-109
14865,1,0,0,0,0
14866,0,0,50,0,-50
14867,0,0,102,0,-102
14868,0,0,38,0,-38
14869,1,1,350,1272,922
14870,1,1,54,1371,1317
14871,1,1,219,1704,1485
14872,0,0,8,0,-8
14873,1,0,9,0,-9
14874,1,0,140,0,-140
14875,1,0,47,0,-47
14876,1,1,248,1521,1273
14877,0,0,75,0,-75
14878,0,0,62,0,-62
14879,0,0,66,0,-66
14880,0,0,83,0,-83
14881,0,0,43,0,-43
14882,1,0,9,0,-9
14883,1,1,258,1764,1506
14884,1,1,138,1407,1269
14885,1,1,408,1537,1129
14886,1,1,254,1352,1098
14887,1,0,46,0,-46
14888,1,1,194,1495,1301
14889,1,1,717,1759,1042
14890,1,1,127,1292,1165
14891,1,1,26,1202,1176
14892,1,1,73,1411,1338
14893,1,0,2,0,-2
14894,1,0,167,0,-167
14895,1,0,1,0,-1
14896,0,0,11,0,-11
14897,1,0,16,0,-16
14898,1,0,119,0,-119
14899,1,1,234,1465,1231
14900,0,0,60,0,-60
14901,1,1,1358,1332,-26
14902,0,0,21,0,-21
14903,0,0,38,0,-38
14904,1,1,575,1977,1402
14905,0,0,108,0,-108
14906,1,0,10,0,-10
14907,1,1,111,1654,1543
14908,0,0,8,0,-8
14909,1,0,74,0,-74
14910,0,0,50,0,-50
14911,1,0,25,0,-25
14912,1,0,93,0,-93
14913,0,0,61,0,-61
14914,1,1,2466,1311,-1155
14915,1,0,56,0,-56
14916,1,1,82,1260,1178
14917,1,1,228,1323,1095
14918,1,1,712,1210,498
14919,1,1,1943,1213,-730
14920,1,1,1108,1479,371
14921,1,1,1944,1355,-589
14922,0,0,17,0,-17
14923,1,0,55,0,-55
14924,1,1,111,1457,1346
14925,1,0,3,0,-3
14926,1,0,35,0,-35
14927,1,0,75,0,-75
14928,0,0,105,0,-105
14929,1,1,607,1256,649
14930,0,0,49,0,-49
14931,0,0,34,0,-34
14932,0,0,40,0,-40
14933,0,0,121,0,-121
14934,0,0,53,0,-53
14935,0,0,18,0,-18
14936,0,0,17,0,-17
14937,1,1,479,2942,2463
14938,0,0,64,0,-64
14939,0,0,1,0,-1
14940,1,0,12,0,-12
14941,1,0,4,0,-4
14942,1,0,19,0,-19
14943,1,0,9,0,-9
14944,0,0,56,0,-56
14945,1,0,29,0,-29
14946,0,0,1,0,-1
14947,1,0,27,0,-27
14948,1,1,146,1206,1060
14949,0,0,82,0,-82
14950,1,1,1759,1269,-490
14951,1,0,21,0,-21
14952,0,0,68,0,-68
14953,1,0,15,0,-15
14954,0,0,7,0,-7
14955,1,0,52,0,-52
14956,1,1,345,1288,943
14957,1,0,18,0,-18
14958,1,1,1860,2714,854
14959,1,1,232,1341,1109
14960,0,0,49,0,-49
14961,1,1,620,2012,1392
14962,1,1,470,1457,987
14963,1,1,579,1630,1051
14964,1,0,53,0,-53
14965,1,0,33,0,-33
14966,0,0,55,0,-55
14967,1,0,0,0,0
14968,1,0,45,0,-45
14969,1,1,457,3171,2714
14970,1,0,240,0,-240
14971,0,0,8,0,-8
14972,1,1,931,2006,1075
14973,0,0,7,0,-7
14974,1,1,563,1651,1088
14975,0,0,190,0,-190
14976,0,0,24,0,-24
14977,0,0,21,0,-21
14978,0,0,94,0,-94
14979,0,0,25,0,-25
14980,0,0,52,0,-52
14981,1,0,47,0,-47
14982,1,0,46,0,-46
14983,0,0,24,0,-24
14984,1,0,11,0,-11
14985,1,1,2062,1393,-669
14986,1,1,480,1205,725
14987,0,0,2,0,-2
14988,0,0,7,0,-7
14989,1,0,75,0,-75
14990,1,1,420,1279,859
14991,1,0,47,0,-47
14992,1,1,93,1345,1252
14993,1,0,93,0,-93
14994,1,0,55,0,-55
14995,0,0,96,0,-96
14996,1,1,488,1483,995
14997,0,0,18,0,-18
14998,0,0,112,0,-112
14999,0,0,14,0,-14
15000,1,1,333,1322,989
15001,1,0,50,0,-50
15002,1,0,19,0,-19
15003,1,1,493,1231,738
15004,1,0,139,0,-139
15005,0,0,13,0,-13
15006,1,1,113,2525,2412
15007,1,0,11,0,-11
15008,0,0,33,0,-33
15009,0,0,82,0,-82
15010,0,0,82,0,-82
15011,0,0,88,0,-88
15012,0,0,40,0,-40
15013,0,0,59,0,-59
15014,0,0,8,0,-8
15015,1,0,27,0,-27
15016,0,0,28,0,-28
15017,1,1,155,1526,1371
15018,0,0,100,0,-100
15019,1,1,238,1520,1282
15020,1,1,460,1251,791
15021,1,1,223,1356,1133
15022,1,0,26,0,-26
15023,0,0,75,0,-75
15024,0,0,112,0,-112
15025,1,0,22,0,-22
15026,1,0,31,0,-31
15027,0,0,80,0,-80
15028,0,0,36,0,-36
15029,0,0,56,0,-56
15030,1,0,167,0,-167
15031,1,1,691,1413,722
15032,0,0,6,0,-6
15033,1,0,261,0,-261
15034,0,0,192,0,-192
15035,1,1,600,1254,654
15036,1,1,839,2561,1722
15037,1,1,189,1292,1103
15038,1,0,43,0,-43
15039,1,1,202,1624,1422
15040,0,0,54,0,-54
15041,1,1,1221,1373,152
15042,1,1,1394,2676,1282
15043,0,0,183,0,-183
15044,0,0,29,0,-29
15045,1,0,7,0,-7
15046,1,1,1415,1861,446
15047,1,1,147,1219,1072
15048,1,1,188,1374,1186
15049,0,0,84,0,-84
15050,1,0,28,0,-28
15051,0,0,67,0,-67
15052,0,0,72,0,-72
15053,1,0,133,0,-133
15054,1,1,341,1993,1652
15055,0,0,120,0,-120
15056,1,0,3,0,-3
15057,1,0,170,0,-170
15058,0,0,11,0,-11
15059,1,1,317,1249,932
15060,1,0,11,0,-11
15061,1,1,102,1644,1542
15062,1,0,122,0,-122
15063,1,1,552,2285,1733
15064,0,0,2,0,-2
15065,0,0,43,0,-43
15066,1,1,205,1933,1728
15067,0,0,92,0,-92
15068,1,0,1,0,-1
15069,1,0,54,0,-54
15070,0,0,83,0,-83
15071,1,0,57,0,-57
15072,1,0,125,0,-125
15073,1,0,41,0,-41
15074,1,1,842,1353,511
15075,0,0,6,0,-6
15076,1,0,67,0,-67
15077,1,0,98,0,-98
15078,1,0,83,0,-83
15079,1,0,60,0,-60
15080,1,1,128,2168,2040
15081,1,0,1,0,-1
15082,1,1,190,1392,1202
15083,0,0,140,0,-140
15084,0,0,3,0,-3
15085,1,0,6,0,-6
15086,1,0,54,0,-54
15087,0,0,17,0,-17
15088,1,0,179,0,-179
15089,1,0,38,0,-38
15090,0,0,132,0,-132
15091,0,0,62,0,-62
15092,0,0,27,0,-27
15093,1,0,50,0,-50
15094,0,0,24,0,-24
15095,0,0,3,0,-3
15096,0,0,16,0,-16
15097,1,1,170,1268,1098
15098,0,0,5,0,-5
15099,0,0,38,0,-38
15100,0,0,13,0,-13
15101,1,1,219,1955,1736
15102,0,0,143,0,-143
15103,1,0,5,0,-5
15104,1,0,91,0,-91
15105,0,0,87,0,-87
15106,0,0,35,0,-35
15107,0,0,47,0,-47
15108,0,0,14,0,-14
15109,0,0,36,0,-36
15110,0,0,57,0,-57
15111,1,0,5,0,-5
15112,1,1,325,2721,2396
15113,0,0,18,0,-18
15114,0,0,62,0,-62
15115,0,0,38,0,-38
15116,1,1,1711,1552,-159
15117,1,1,191,1221,1030
15118,0,0,43,0,-43
15119,0,0,11,0,-11
15120,0,0,34,0,-34
15121,0,0,36,0,-36
15122,1,0,11,0,-11
15123,1,0,72,0,-72
15124,0,0,67,0,-67
15125,1,0,37,0,-37
15126,0,0,145,0,-145
15127,1,1,359,1334,975
15128,0,0,138,0,-138
15129,1,0,10,0,-10
15130,1,1,315,2795,2480
15131,1,1,387,1408,1021
15132,0,0,20,0,-20
15133,1,0,48,0,-48
15134,0,0,15,0,-15
15135,1,0,2,0,-2
15136,0,0,14,0,-14
15137,1,1,130,1320,1190
15138,1,1,642,1781,1139
15139,0,0,2,0,-2
15140,1,1,240,1941,1701
15141,0,0,62,0,-62
15142,1,0,69,0,-69
15143,1,1,123,1593,1470
15144,0,0,50,0,-50
15145,0,0,96,0,-96
15146,1,0,10,0,-10
15147,0,0,30,0,-30
15148,1,1,208,3197,2989
15149,1,1,2270,1294,-976
15150,0,0,5,0,-5
15151,0,0,13,0,-13
15152,1,0,23,0,-23
15153,1,1,362,1305,943
15154,0,0,37,0,-37
15155,1,0,35,0,-35
15156,0,0,29,0,-29
15157,0,0,85,0,-85
15158,1,0,60,0,-60
15159,1,0,89,0,-89
15160,1,0,155,0,-155
15161,0,0,30,0,-30
15162,0,0,86,0,-86
15163,0,0,58,0,-58
15164,0,0,25,0,-25
15165,1,0,41,0,-41
15166,0,0,57,0,-57
15167,0,0,42,0,-42
15168,1,0,95,0,-95
15169,1,1,284,1381,1097
15170,1,1,154,1399,1245
15171,0,0,11,0,-11
15172,1,1,1113,1417,304
15173,0,0,100,0,-100
15174,1,1,799,1243,444
15175,0,0,15,0,-15
15176,1,1,114,1453,1339
15177,0,0,44,0,-44
15178,1,0,7,0,-7
15179,1,1,577,1206,629
15180,1,1,957,1218,261
15181,0,0,178,0,-178
15182,0,0,11,0,-11
15183,1,0,107,0,-107
15184,1,1,124,1756,1632
15185,0,0,21,0,-21
15186,0,0,150,0,-150
15187,0,0,22,0,-22
15188,1,1,745,1622,877
15189,1,0,45,0,-45
15190,1,1,130,1545,1415
15191,0,0,14,0,-14
15192,0,0,122,0,-122
15193,1,1,243,1857,1614
15194,1,1,1411,1504,93
15195,1,1,1144,1377,233
15196,0,0,59,0,-59
15197,1,0,4,0,-4
15198,1,1,83,1237,1154
15199,1,0,25,0,-25
15200,1,0,58,0,-58
15201,1,0,12,0,-12
15202,0,0,5,0,-5
15203,1,1,44,1243,1199
15204,0,0,19,0,-19
15205,1,1,221,1473,1252
15206,1,0,2,0,-2
15207,1,0,12,0,-12
15208,1,1,1497,1269,-228
15209,0,0,93,0,-93
15210,0,0,0,0,0
15211,0,0,41,0,-41
15212,1,1,1216,1340,124
15213,1,1,583,1581,998
15214,1,0,61,0,-61
15215,0,0,18,0,-18
15216,0,0,145,0,-145
15217,0,0,8,0,-8
15218,0,0,70,0,-70
15219,0,0,26,0,-26
15220,1,1,215,1686,1471
15221,0,0,119,0,-119
15222,1,1,1528,1261,-267
15223,0,0,49,0,-49
15224,1,1,485,1825,1340
15225,1,0,0,0,0
15226,1,0,18,0,-18
15227,1,0,11,0,-11
15228,1,0,93,0,-93
15229,0,0,291,0,-291
15230,1,0,25,0,-25
15231,0,0,51,0,-51
15232,1,0,15,0,-15
15233,1,0,8,0,-8
15234,0,0,29,0,-29
15235,1,1,260,2650,2390
15236,1,1,169,1213,1044
15237,1,1,1162,1478,316
15238,0,0,62,0,-62
15239,0,0,18,0,-18
15240,1,1,47,1450,1403
15241,0,0,42,0,-42
15242,0,0,21,0,-21
15243,1,1,655,1336,681
15244,1,0,62,0,-62
15245,1,1,380,1246,866
15246,1,1,558,1208,650
15247,0,0,15,0,-15
15248,0,0,135,0,-135
15249,1,1,599,1296,697
15250,0,0,54,0,-54
15251,0,0,133,0,-133
15252,1,0,64,0,-64
15253,0,0,5,0,-5
15254,1,1,793,1243,450
15255,1,0,13,0,-13
15256,1,0,104,0,-104
15257,1,1,261,1760,1499
15258,1,1,675,1267,592
15259,0,0,10,0,-10
15260,1,0,34,0,-34
15261,1,1,109,1668,1559
15262,0,0,8,0,-8
15263,0,0,30,0,-30
15264,1,0,21,0,-21
15265,1,1,771,1399,628
15266,0,0,23,0,-23
15267,0,0,10,0,-10
15268,0,0,39,0,-39
15269,1,0,11,0,-11
15270,1,1,942,1369,427
15271,1,1,449,1211,762
15272,0,0,0,0,0
15273,0,0,26,0,-26
15274,0,0,1,0,-1
15275,0,0,27,0,-27
15276,0,0,61,0,-61
15277,1,0,24,0,-24
15278,1,0,120,0,-120
15279,1,0,216,0,-216
15280,1,1,72,1335,1263
15281,1,0,180,0,-180
15282,1,1,1424,1410,-14
15283,1,1,278,1280,1002
15284,0,0,36,0,-36
15285,1,0,12,0,-12
15286,1,1,171,1305,1134
15287,0,0,9,0,-9
15288,1,0,6,0,-6
15289,1,1,591,2308,1717
15290,1,0,30,0,-30
15291,0,0,25,0,-25
15292,1,0,59,0,-59
15293,1,1,188,1325,1137
15294,0,0,70,0,-70
15295,1,1,13,3128,3115
15296,1,0,146,0,-146
15297,1,1,68,1314,1246
15298,1,1,174,2697,2523
15299,1,0,37,0,-37
15300,1,1,241,1587,1346
15301,1,0,14,0,-14
15302,1,1,218,1300,1082
15303,0,0,46,0,-46
15304,1,1,1682,2090,408
15305,0,0,2,0,-2
15306,1,0,17,0,-17
15307,0,0,44,0,-44
15308,1,1,346,1779,1433
15309,0,0,15,0,-15
15310,1,1,169,1209,1040
15311,1,0,124,0,-124
15312,0,0,8,0,-8
15313,1,1,552,1498,946
15314,1,1,667,1592,925
15315,1,0,53,0,-53
15316,1,0,33,0,-33
15317,0,0,21,0,-21
15318,1,0,50,0,-50
15319,1,0,66,0,-66
15320,0,0,147,0,-147
15321,1,1,242,1203,961
15322,0,0,1,0,-1
15323,1,1,147,1397,1250
15324,0,0,26,0,-26
15325,0,0,23,0,-23
15326,1,0,21,0,-21
15327,1,0,111,0,-111
15328,1,0,19,0,-19
15329,1,1,261,1655,1394
15330,1,1,16,1608,1592
15331,0,0,20,0,-20
15332,1,0,39,0,-39
15333,1,0,47,0,-47
15334,1,1,112,1898,1786
15335,1,1,885,1399,514
15336,0,0,198,0,-198
15337,0,0,25,0,-25
15338,1,0,61,0,-61
15339,1,0,66,0,-66
15340,1,1,52,1695,1643
15341,1,0,51,0,-51
15342,0,0,98,0,-98
15343,1,1,588,1415,827
15344,0,0,22,0,-22
15345,1,1,2119,1661,-458
15346,0,0,146,0,-146
15347,1,1,104,3903,3799
15348,1,1,454,1272,818
15349,1,0,13,0,-13
15350,1,0,109,0,-109
15351,1,1,103,1258,1155
15352,0,0,78,0,-78
15353,1,0,22,0,-22
15354,1,1,164,1214,1050
15355,0,0,13,0,-13
15356,0,0,36,0,-36
15357,1,0,291,0,-291
15358,1,1,1242,2975,1733
15359,0,0,23,0,-23
15360,1,0,21,0,-21
15361,1,1,549,1746,1197
15362,0,0,68,0,-68
15363,0,0,97,0,-97
15364,1,1,154,1260,1106
15365,1,0,47,0,-47
15366,1,0,49,0,-49
15367,1,1,37,1351,1314
15368,1,1,135,1283,1148
15369,1,0,11,0,-11
15370,1,1,287,1235,948
15371,1,1,1889,1783,-106
15372,1,1,381,1883,1502
15373,0,0,42,0,-42
15374,0,0,80,0,-80
15375,1,0,78,0,-78
15376,1,1,144,3321,3177
15377,1,1,145,1346,1201
15378,0,0,11,0,-11
15379,1,1,120,1202,1082
15380,1,1,81,1442,1361
15381,0,0,87,0,-87
15382,1,0,18,0,-18
15383,0,0,113,0,-113
15384,0,0,17,0,-17
15385,1,0,82,0,-82
15386,1,1,85,1432,1347
15387,1,0,1,0,-1
15388,1,1,451,1797,1346
15389,1,1,513,1224,711
15390,1,1,505,3302,2797
15391,1,1,699,1257,558
15392,1,0,0,0,0
15393,0,0,67,0,-67
15394,0,0,23,0,-23
15395,0,0,2,0,-2
15396,0,0,62,0,-62
15397,0,0,23,0,-23
15398,0,0,32,0,-32
15399,1,0,128,0,-128
15400,1,0,5,0,-5
15401,0,0,27,0,-27
15402,1,0,37,0,-37
15403,0,0,14,0,-14
15404,1,0,27,0,-27
15405,1,0,58,0,-58
15406,0,0,57,0,-57
15407,1,1,97,1575,1478
15408,0,0,86,0,-86
15409,0,0,1,0,-1
15410,1,1,1272,1358,86
15411,0,0,28,0,-28
15412,0,0,1,0,-1
15413,1,0,3,0,-3
15414,1,1,276,1225,949
15415,1,1,1250,1235,-15
15416,0,0,26,0,-26
15417,1,0,5,0,-5
15418,1,1,495,1597,1102
15419,1,0,10,0,-10
15420,1,1,169,1571,1402
15421,1,1,2515,1374,-1141
15422,0,0,33,0,-33
15423,1,1,55,1785,1730
15424,1,0,31,0,-31
15425,1,1,2013,1456,-557
15426,1,0,19,0,-19
15427,1,1,84,1280,1196
15428,0,0,27,0,-27
15429,1,1,1174,1295,121
15430,1,1,884,1375,491
15431,0,0,62,0,-62
15432,1,0,35,0,-35
15433,0,0,47,0,-47
15434,0,0,93,0,-93
15435,1,1,1263,3570,2307
15436,0,0,51,0,-51
15437,1,1,366,1506,1140
15438,1,0,17,0,-17
15439,1,1,212,1515,1303
15440,1,1,427,1855,1428
15441,1,0,10,0,-10
15442,1,1,125,1876,1751
15443,0,0,37,0,-37
15444,0,0,163,0,-163
15445,1,0,34,0,-34
15446,0,0,4,0,-4
15447,1,1,113,1377,1264
15448,1,0,4,0,-4
15449,1,1,132,1427,1295
15450,0,0,168,0,-168
15451,1,0,6,0,-6
15452,1,1,233,1309,1076
15453,1,0,23,0,-23
15454,1,1,541,1457,916
15455,1,1,380,1437,1057
15456,1,1,63,1316,1253
15457,1,1,598,2323,1725
15458,0,0,24,0,-24
15459,1,0,91,0,-91
15460,0,0,21,0,-21
15461,1,0,83,0,-83
15462,1,0,60,0,-60
15463,0,0,7,0,-7
15464,1,0,3,0,-3
15465,0,0,17,0,-17
15466,0,0,6,0,-6
15467,0,0,68,0,-68
15468,0,0,2,0,-2
15469,1,1,133,1371,1238
15470,1,1,571,1273,702
15471,0,0,17,0,-17
15472,1,0,0,0,0
15473,1,0,83,0,-83
15474,1,1,226,2430,2204
15475,1,0,20,0,-20
15476,1,0,18,0,-18
15477,0,0,6,0,-6
15478,0,0,128,0,-128
15479,0,0,66,0,-66
15480,1,1,654,1473,819
15481,1,1,285,1587,1302
15482,1,0,25,0,-25
15483,1,1,383,1213,830
15484,1,1,598,1270,672
15485,1,0,5,0,-5
15486,1,1,659,1263,604
15487,0,0,39,0,-39
15488,1,0,203,0,-203
15489,0,0,5,0,-5
15490,1,1,62,1773,1711
15491,1,0,71,0,-71
15492,1,0,29,0,-29
15493,1,1,559,1275,716
15494,0,0,4,0,-4
15495,0,0,32,0,-32
15496,1,1,224,1688,1464
15497,0,0,270,0,-270
15498,0,0,154,0,-154
15499,0,0,61,0,-61
15500,1,1,111,1791,1680
15501,0,0,69,0,-69
15502,0,0,48,0,-48
15503,1,0,6,0,-6
15504,0,0,92,0,-92
15505,0,0,16,0,-16
15506,1,1,366,1909,1543
15507,1,1,112,1831,1719
15508,0,0,93,0,-93
15509,0,0,58,0,-58
15510,0,0,25,0,-25
15511,1,0,3,0,-3
15512,0,0,166,0,-166
15513,1,1,337,1681,1344
15514,0,0,10,0,-10
15515,0,0,16,0,-16
15516,0,0,52,0,-52
15517,1,1,826,1539,713
15518,1,1,93,2186,2093
15519,0,0,79,0,-79
15520,1,1,760,1683,923
15521,0,0,162,0,-162
15522,1,1,70,1276,1206
15523,1,1,434,2982,2548
15524,0,0,3,0,-3
15525,1,0,1,0,-1
15526,1,1,98,1645,1547
15527,1,0,5,0,-5
15528,1,1,1693,1422,-271
15529,1,1,1724,1329,-395
15530,0,0,97,0,-97
15531,1,1,82,1482,1400
15532,0,0,12,0,-12
15533,0,0,8,0,-8
15534,0,0,46,0,-46
15535,1,1,482,1897,1415
15536,1,0,141,0,-141
15537,1,0,38,0,-38
15538,1,1,1365,1221,-144
15539,0,0,0,0,0
15540,1,0,25,0,-25
15541,1,1,528,1409,881
15542,0,0,5,0,-5
15543,0,0,18,0,-18
15544,1,1,569,1204,635
15545,0,0,18,0,-18
15546,1,1,155,1213,1058
15547,0,0,25,0,-25
15548,1,0,46,0,-46
15549,0,0,74,0,-74
15550,1,0,52,0,-52
15551,0,0,86,0,-86
15552,1,1,556,1395,839
15553,0,0,31,0,-31
15554,1,1,1092,1331,239
15555,1,1,1093,1202,109
15556,1,1,844,1228,384
15557,1,0,102,0,-102
15558,0,0,67,0,-67
15559,1,1,232,1313,1081
15560,1,0,97,0,-97
15561,1,1,379,1661,1282
15562,1,1,1299,2181,882
15563,1,0,4,0,-4
15564,1,0,62,0,-62
15565,1,0,16,0,-16
15566,1,1,1485,1388,-97
15567,0,0,25,0,-25
15568,0,0,27,0,-27
15569,1,1,215,2250,2035
15570,0,0,87,0,-87
15571,1,1,174,3227,3053
15572,1,1,190,1369,1179
15573,1,1,977,1231,254
15574,0,0,25,0,-25
15575,1,1,281,1768,1487
15576,0,0,11,0,-11
15577,0,0,33,0,-33
15578,1,0,14,0,-14
15579,0,0,25,0,-25
15580,1,0,5,0,-5
15581,0,0,8,0,-8
15582,1,1,139,1327,1188
15583,1,0,73,0,-73
15584,1,0,11,0,-11
15585,1,1,307,1527,1220
15586,0,0,17,0,-17
15587,1,1,1014,2126,1112
15588,1,0,0,0,0
15589,1,0,13,0,-13
15590,1,1,193,1823,1630
15591,1,1,254,1223,969
15592,0,0,6,0,-6
15593,1,1,876,1966,1090
15594,1,1,277,1276,999
15595,1,0,77,0,-77
15596,0,0,186,0,-186
15597,1,0,20,0,-20
15598,1,1,166,2474,2308
15599,1,0,19,0,-19
15600,0,0,73,0,-73
15601,1,1,84,1544,1460
15602,1,1,717,1762,1045
15603,1,0,33,0,-33
15604,1,0,29,0,-29
15605,1,0,13,0,-13
15606,1,0,2,0,-2
15607,1,1,111,1479,1368
15608,0,0,22,0,-22
15609,1,0,25,0,-25
15610,1,1,69,1300,1231
15611,1,0,20,0,-20
15612,0,0,9,0,-9
15613,1,0,22,0,-22
15614,0,0,5,0,-5
15615,0,0,116,0,-116
15616,1,1,1227,1784,557
15617,0,0,17,0,-17
15618,1,0,14,0,-14
15619,0,0,67,0,-67
15620,1,0,45,0,-45
15621,1,1,1888,1541,-347
15622,0,0,42,0,-42
15623,0,0,41,0,-41
15624,0,0,9,0,-9
15625,1,1,103,1218,1115
15626,1,1,391,1331,940
15627,0,0,180,0,-180
15628,1,0,19,0,-19
15629,0,0,215,0,-215
15630,1,0,26,0,-26
15631,1,1,735,1372,637
15632,1,1,579,1997,1418
15633,1,1,273,1830,1557
15634,0,0,10,0,-10
15635,0,0,16,0,-16
15636,0,0,88,0,-88
15637,0,0,53,0,-53
15638,1,1,145,2657,2512
15639,0,0,13,0,-13
15640,1,0,69,0,-69
15641,1,0,5,0,-5
15642,0,0,108,0,-108
15643,1,0,21,0,-21
15644,1,1,361,1384,1023
15645,0,0,27,0,-27
15646,0,0,77,0,-77
15647,0,0,10,0,-10
15648,0,0,3,0,-3
15649,1,0,34,0,-34
15650,0,0,20,0,-20
15651,1,0,78,0,-78
15652,0,0,103,0,-103
15653,1,1,130,2228,2098
15654,1,1,915,1292,377
15655,1,1,1268,1218,-50
15656,0,0,157,0,-157
15657,0,0,37,0,-37
15658,1,0,58,0,-58
15659,1,1,1002,1367,365
15660,1,0,42,0,-42
15661,0,0,57,0,-57
15662,1,0,22,0,-22
15663,1,0,82,0,-82
15664,1,1,1155,1239,84
15665,1,1,136,1213,1077
15666,1,0,26,0,-26
15667,1,0,42,0,-42
15668,0,0,45,0,-45
15669,0,0,5,0,-5
15670,1,1,72,1490,1418
15671,0,0,0,0,0
15672,1,1,416,1285,869
15673,0,0,11,0,-11
15674,1,0,30,0,-30
15675,1,0,53,0,-53
15676,0,0,34,0,-34
15677,1,1,281,1390,1109
15678,0,0,18,0,-18
15679,1,1,276,1365,1089
15680,1,0,4,0,-4
15681,1,0,3,0,-3
15682,0,0,31,0,-31
15683,0,0,85,0,-85
15684,0,0,70,0,-70
15685,0,0,37,0,-37
15686,0,0,20,0,-20
15687,1,1,389,1815,1426
15688,0,0,0,0,0
15689,0,0,138,0,-138
15690,0,0,81,0,-81
15691,0,0,42,0,-42
15692,0,0,117,0,-117
15693,0,0,16,0,-16
15694,1,0,50,0,-50
15695,1,1,1362,1437,75
15696,0,0,16,0,-16
15697,0,0,115,0,-115
15698,0,0,14,0,-14
15699,1,0,1,0,-1
15700,1,0,0,0,0
15701,0,0,6,0,-6
15702,1,0,131,0,-131
15703,1,0,155,0,-155
15704,0,0,39,0,-39
15705,1,0,37,0,-37
15706,1,0,34,0,-34
15707,0,0,109,0,-109
15708,1,0,32,0,-32
15709,0,0,75,0,-75
15710,0,0,40,0,-40
15711,0,0,6,0,-6
15712,1,0,166,0,-166
15713,1,0,86,0,-86
15714,0,0,43,0,-43
15715,1,0,39,0,-39
15716,0,0,24,0,-24
15717,0,0,96,0,-96
15718,1,1,688,1295,607
15719,1,0,4,0,-4
15720,0,0,86,0,-86
15721,1,0,33,0,-33
15722,0,0,52,0,-52
15723,0,0,19,0,-19
15724,0,0,128,0,-128
15725,0,0,88,0,-88
15726,1,1,444,1297,853
15727,0,0,13,0,-13
15728,1,0,12,0,-12
15729,1,1,388,1238,850
15730,0,0,112,0,-112
15731,0,0,6,0,-6
15732,1,0,12,0,-12
15733,1,1,218,1774,1556
15734,1,1,9,1290,1281
15735,1,1,453,1865,1412
15736,1,1,1005,1204,199
15737,1,0,84,0,-84
15738,0,0,7,0,-7
15739,1,0,23,0,-23
15740,0,0,13,0,-13
15741,0,0,1,0,-1
15742,0,0,14,0,-14
15743,0,0,13,0,-13
15744,1,1,292,1527,1235
15745,0,0,21,0,-21
15746,0,0,22,0,-22
15747,1,0,49,0,-49
15748,1,0,82,0,-82
15749,1,1,189,1635,1446
15750,0,0,118,0,-118
15751,0,0,88,0,-88
15752,1,1,371,2918,2547
15753,0,0,68,0,-68
15754,0,0,117,0,-117
15755,1,1,228,1788,1560
15756,1,0,48,0,-48
15757,1,1,413,1643,1230
15758,1,1,834,1508,674
15759,1,1,3237,1304,-1933
15760,0,0,92,0,-92
15761,1,0,0,0,0
15762,1,0,108,0,-108
15763,1,1,1158,3047,1889
15764,0,0,22,0,-22
15765,1,0,91,0,-91
15766,0,0,98,0,-98
15767,0,0,17,0,-17
15768,0,0,80,0,-80
15769,1,0,20,0,-20
15770,1,1,361,1729,1368
15771,0,0,17,0,-17
15772,1,1,493,1691,1198
15773,1,1,475,1727,1252
15774,0,0,19,0,-19
15775,0,0,4,0,-4
15776,1,1,1308,1633,325
15777,1,0,5,0,-5
15778,0,0,137,0,-137
15779,1,1,129,2325,2196
15780,0,0,178,0,-178
15781,1,0,3,0,-3
15782,1,1,1224,1532,308
15783,1,0,10,0,-10
15784,1,1,556,1373,817
15785,0,0,40,0,-40
15786,1,0,170,0,-170
15787,1,0,58,0,-58
15788,1,1,178,1801,1623
15789,1,1,1773,1739,-34
15790,1,0,132,0,-132
15791,0,0,24,0,-24
15792,1,1,303,1467,1164
15793,0,0,16,0,-16
15794,1,1,76,1398,1322
15795,1,1,172,1205,1033
15796,0,0,31,0,-31
15797,0,0,196,0,-196
15798,1,1,547,1246,699
15799,1,0,24,0,-24
15800,0,0,38,0,-38
15801,0,0,67,0,-67
15802,0,0,78,0,-78
15803,1,0,9,0,-9
15804,1,0,19,0,-19
15805,1,0,17,0,-17
15806,1,0,90,0,-90
15807,0,0,88,0,-88
15808,1,0,62,0,-62
15809,1,1,46,1207,1161
15810,1,1,400,2037,1637
15811,1,0,23,0,-23
15812,1,1,129,1315,1186
15813,0,0,0,0,0
15814,1,0,29,0,-29
15815,1,1,707,1407,700
15816,1,1,447,1336,889
15817,1,0,8,0,-8
15818,1,0,96,0,-96
15819,0,0,47,0,-47
15820,1,1,2512,1664,-848
15821,0,0,21,0,-21
15822,1,0,29,0,-29
15823,0,0,25,0,-25
15824,1,0,1,0,-1
15825,1,1,444,1209,765
15826,1,0,26,0,-26
15827,1,0,1,0,-1
15828,0,0,10,0,-10
15829,1,0,18,0,-18
15830,1,0,114,0,-114
15831,1,1,157,1342,1185
15832,1,0,1,0,-1
15833,1,0,50,0,-50
15834,0,0,47,0,-47
15835,1,0,125,0,-125
15836,0,0,8,0,-8
15837,1,1,108,1390,1282
15838,0,0,0,0,0
15839,0,0,38,0,-38
15840,1,0,38,0,-38
15841,0,0,95,0,-95
15842,0,0,58,0,-58
15843,1,0,112,0,-112
15844,1,0,30,0,-30
15845,0,0,34,0,-34
15846,1,0,49,0,-49
15847,0,0,5,0,-5
15848,1,0,7,0,-7
15849,1,0,34,0,-34
15850,1,0,26,0,-26
15851,1,1,311,1564,1253
15852,0,0,0,0,0
15853,1,1,479,1322,843
15854,1,1,474,1669,1195
15855,1,0,16,0,-16
15856,0,0,44,0,-44
15857,1,0,61,0,-61
15858,0,0,180,0,-180
15859,1,0,74,0,-74
15860,0,0,34,0,-34
15861,1,0,14,0,-14
15862,0,0,54,0,-54
15863,1,1,322,1613,1291
15864,0,0,5,0,-5
15865,1,0,86,0,-86
15866,1,0,51,0,-51
15867,1,0,52,0,-52
15868,0,0,38,0,-38
15869,1,0,300,0,-300
15870,1,0,164,0,-164
15871,1,0,41,0,-41
15872,1,0,81,0,-81
15873,0,0,55,0,-55
15874,1,1,172,1236,1064
15875,1,0,20,0,-20
15876,0,0,64,0,-64
15877,1,0,50,0,-50
15878,1,1,502,1419,917
15879,0,0,93,0,-93
15880,0,0,9,0,-9
15881,1,0,30,0,-30
15882,0,0,68,0,-68
15883,1,0,30,0,-30
15884,0,0,3,0,-3
15885,1,1,940,1488,548
15886,1,0,29,0,-29
15887,0,0,21,0,-21
15888,0,0,31,0,-31
15889,1,0,3,0,-3
15890,0,0,4,0,-4
15891,1,1,1022,1921,899
15892,0,0,5,0,-5
15893,0,0,75,0,-75
15894,1,0,132,0,-132
15895,0,0,160,0,-160
15896,1,0,22,0,-22
15897,0,0,9,0,-9
15898,1,0,20,0,-20
15899,1,1,78,1203,1125
15900,0,0,15,0,-15
15901,1,1,720,1245,525
15902,1,0,133,0,-133
15903,1,1,653,1236,583
15904,1,0,76,0,-76
15905,0,0,29,0,-29
15906,1,1,1521,1958,437
15907,1,1,270,2143,1873
15908,1,1,1311,1218,-93
15909,1,1,959,1282,323
15910,1,1,99,1818,1719
15911,0,0,15,0,-15
15912,1,1,975,1440,465
15913,1,1,367,1461,1094
15914,1,1,488,4197,3709
15915,1,0,57,0,-57
15916,1,1,193,2268,2075
15917,1,1,193,1402,1209
15918,1,0,27,0,-27
15919,0,0,102,0,-102
15920,0,0,70,0,-70
15921,0,0,72,0,-72
15922,1,0,0,0,0
15923,1,0,33,0,-33
15924,1,1,788,2314,1526
15925,1,0,16,0,-16
15926,0,0,5,0,-5
15927,0,0,89,0,-89
15928,1,1,483,1840,1357
15929,1,1,236,1796,1560
15930,1,1,396,1554,1158
15931,0,0,30,0,-30
15932,0,0,10,0,-10
15933,1,0,17,0,-17
15934,1,1,469,1492,1023
15935,1,0,13,0,-13
15936,0,0,29,0,-29
15937,1,1,111,1304,1193
15938,0,0,14,0,-14
15939,1,1,527,1580,1053
15940,1,1,123,1423,1300
15941,1,0,31,0,-31
15942,0,0,45,0,-45
15943,0,0,37,0,-37
15944,0,0,12,0,-12
15945,1,1,429,1831,1402
15946,1,0,24,0,-24
15947,1,1,23,1685,1662
15948,1,0,25,0,-25
15949,1,0,20,0,-20
15950,1,1,170,1619,1449
15951,1,1,114,1386,1272
15952,0,0,55,0,-55
15953,0,0,5,0,-5
15954,1,1,340,1281,941
15955,1,1,1007,1667,660
15956,1,1,1685,1290,-395
15957,1,1,1053,1228,175
15958,0,0,77,0,-77
15959,1,1,878,1802,924
15960,0,0,85,0,-85
15961,1,0,44,0,-44
15962,1,1,177,1589,1412
15963,0,0,214,0,-214
15964,0,0,81,0,-81
15965,1,1,314,1561,1247
15966,0,0,23,0,-23
15967,1,1,643,2090,1447
15968,0,0,54,0,-54
15969,0,0,1,0,-1
15970,1,1,190,1293,1103
15971,0,0,56,0,-56
15972,1,1,451,1397,946
15973,1,0,25,0,-25
15974,1,0,74,0,-74
15975,0,0,0,0,0
15976,1,0,15,0,-15
15977,1,1,585,3622,3037
15978,0,0,18,0,-18
15979,1,1,223,1303,1080
15980,1,0,32,0,-32
15981,1,0,15,0,-15
15982,0,0,20,0,-20
15983,0,0,91,0,-91
15984,1,1,239,1564,1325
15985,0,0,142,0,-142
15986,1,0,45,0,-45
15987,0,0,41,0,-41
15988,1,0,39,0,-39
15989,1,1,261,1247,986
15990,0,0,29,0,-29
15991,1,0,16,0,-16
15992,1,1,425,1510,1085
15993,0,0,80,0,-80
15994,1,0,9,0,-9
15995,0,0,6,0,-6
15996,1,0,19,0,-19
15997,1,0,0,0,0
15998,0,0,49,0,-49
15999,1,0,15,0,-15
16000,1,0,52,0,-52
16001,1,1,811,1229,418
16002,1,0,4,0,-4
16003,1,0,99,0,-99
16004,0,0,105,0,-105
16005,1,1,86,1773,1687
16006,1,1,406,1202,796
16007,1,1,397,1592,1195
16008,0,0,1,0,-1
16009,1,0,90,0,-90
16010,1,1,1006,1228,222
16011,0,0,15,0,-15
16012,1,0,16,0,-16
16013,0,0,21,0,-21
16014,1,1,433,1362,929
16015,1,0,32,0,-32
16016,0,0,131,0,-131
16017,1,1,578,1264,686
16018,1,1,243,1608,1365
16019,1,1,96,1497,1401
16020,1,1,250,2266,2016
16021,1,0,18,0,-18
16022,1,1,55,1520,1465
16023,1,1,131,1495,1364
16024,0,0,51,0,-51
16025,0,0,191,0,-191
16026,0,0,88,0,-88
16027,1,0,49,0,-49
16028,0,0,42,0,-42
16029,0,0,28,0,-28
16030,1,0,188,0,-188
16031,1,0,17,0,-17
16032,0,0,131,0,-131
16033,0,0,32,0,-32
16034,0,0,22,0,-22
16035,1,0,50,0,-50
16036,0,0,4,0,-4
16037,1,1,138,1269,1131
16038,0,0,77,0,-77
16039,1,0,3,0,-3
16040,0,0,10,0,-10
16041,1,0,2,0,-2
16042,0,0,10,0,-10
16043,1,0,56,0,-56
16044,0,0,27,0,-27
16045,1,1,1283,1267,-16
16046,1,1,693,1662,969
16047,1,1,465,1246,781
16048,0,0,7,0,-7
16049,0,0,19,0,-19
16050,1,1,201,1420,1219
16051,0,0,92,0,-92
16052,0,0,65,0,-65
16053,1,0,8,0,-8
16054,0,0,191,0,-191
16055,1,0,12,0,-12
16056,1,1,78,1654,1576
16057,1,0,95,0,-95
16058,1,1,287,1245,958
16059,0,0,23,0,-23
16060,0,0,11,0,-11
16061,1,0,49,0,-49
16062,1,1,843,1334,491
16063,0,0,58,0,-58
16064,0,0,22,0,-22
16065,1,1,1768,1763,-5
16066,0,0,25,0,-25
16067,0,0,50,0,-50
16068,0,0,80,0,-80
16069,1,0,17,0,-17
16070,0,0,49,0,-49
16071,1,0,73,0,-73
16072,1,0,68,0,-68
16073,1,1,110,1357,1247
16074,1,1,940,1248,308
16075,0,0,26,0,-26
16076,1,1,431,1668,1237
16077,0,0,5,0,-5
16078,1,1,195,1250,1055
16079,0,0,47,0,-47
16080,0,0,23,0,-23
16081,1,1,2434,1222,-1212
16082,1,1,200,1831,1631
16083,1,1,666,1230,564
16084,0,0,44,0,-44
16085,1,0,82,0,-82
16086,1,0,7,0,-7
16087,1,1,797,1344,547
16088,0,0,34,0,-34
16089,1,1,194,1241,1047
16090,1,0,69,0,-69
16091,0,0,8,0,-8
16092,0,0,5,0,-5
16093,1,1,573,1265,692
16094,0,0,6,0,-6
16095,0,0,49,0,-49
16096,1,0,4,0,-4
16097,0,0,18,0,-18
16098,1,0,10,0,-10
16099,1,1,476,1384,908
16100,0,0,40,0,-40
16101,0,0,88,0,-88
16102,0,0,41,0,-41
16103,1,0,29,0,-29
16104,1,1,111,1241,1130
16105,1,0,64,0,-64
16106,0,0,41,0,-41
16107,0,0,153,0,-153
16108,0,0,0,0,0
16109,0,0,42,0,-42
16110,1,0,110,0,-110
16111,0,0,64,0,-64
16112,1,0,19,0,-19
16113,0,0,97,0,-97
16114,1,1,937,1331,394
16115,1,0,5,0,-5
16116,1,0,17,0,-17
16117,1,1,160,1251,1091
16118,1,1,144,1386,1242
16119,1,1,391,1307,916
16120,0,0,48,0,-48
16121,1,0,23,0,-23
16122,1,1,663,1471,808
16123,0,0,42,0,-42
16124,1,1,177,2326,2149
16125,0,0,0,0,0
16126,0,0,31,0,-31
16127,1,0,3,0,-3
16128,0,0,2,0,-2
16129,0,0,5,0,-5
16130,1,0,90,0,-90
16131,0,0,14,0,-14
16132,0,0,121,0,-121
16133,1,1,943,1213,270
16134,0,0,95,0,-95
16135,1,0,13,0,-13
16136,0,0,46,0,-46
16137,1,1,608,1693,1085
16138,0,0,22,0,-22
16139,1,1,355,1336,981
16140,1,0,35,0,-35
16141,1,0,78,0,-78
16142,0,0,4,0,-4
16143,1,0,19,0,-19
16144,0,0,6,0,-6
16145,0,0,95,0,-95
16146,0,0,48,0,-48
16147,0,0,9,0,-9
16148,1,0,102,0,-102
16149,0,0,24,0,-24
16150,0,0,33,0,-33
16151,1,1,434,1252,818
16152,0,0,1,0,-1
16153,1,1,117,1618,1501
16154,1,1,410,1648,1238
16155,1,1,396,1340,944
16156,0,0,0,0,0
16157,1,1,172,1208,1036
16158,0,0,21,0,-21
16159,1,0,27,0,-27
16160,1,1,693,1253,560
16161,1,0,51,0,-51
16162,0,0,130,0,-130
16163,0,0,78,0,-78
16164,0,0,5,0,-5
16165,1,1,84,1391,1307
16166,1,0,90,0,-90
16167,1,0,81,0,-81
16168,0,0,37,0,-37
16169,1,0,169,0,-169
16170,1,1,1234,2568,1334
16171,0,0,48,0,-48
16172,1,1,335,1268,933
16173,1,1,548,1232,684
16174,1,1,71,3817,3746
16175,1,1,325,1329,1004
16176,1,0,136,0,-136
16177,0,0,38,0,-38
16178,1,1,2056,3506,1450
16179,1,1,998,1568,570
16180,1,1,3759,1933,-1826
16181,1,0,42,0,-42
16182,1,0,53,0,-53
16183,1,0,72,0,-72
16184,0,0,61,0,-61
16185,1,1,1256,1912,656
16186,1,1,1657,1295,-362
16187,1,0,54,0,-54
16188,0,0,7,0,-7
16189,0,0,7,0,-7
16190,0,0,54,0,-54
16191,0,0,8,0,-8
16192,1,0,40,0,-40
16193,1,0,18,0,-18
16194,1,0,25,0,-25
16195,1,0,13,0,-13
16196,1,0,16,0,-16
16197,1,1,731,1357,626
16198,1,0,0,0,0
16199,1,0,110,0,-110
16200,1,0,6,0,-6
16201,1,1,535,1229,694
16202,0,0,42,0,-42
16203,1,0,17,0,-17
16204,1,1,2627,2606,-21
16205,1,0,86,0,-86
16206,0,0,5,0,-5
16207,1,1,757,1305,548
16208,0,0,11,0,-11
16209,0,0,75,0,-75
16210,0,0,131,0,-131
16211,1,1,251,1259,1008
16212,1,0,67,0,-67
16213,0,0,6,0,-6
16214,1,0,17,0,-17
16215,1,1,491,1465,974
16216,0,0,33,0,-33
16217,1,1,150,1213,1063
16218,1,0,10,0,-10
16219,1,0,98,0,-98
16220,0,0,86,0,-86
16221,1,0,62,0,-62
16222,1,0,30,0,-30
16223,1,0,6,0,-6
16224,1,1,312,3188,2876
16225,0,0,98,0,-98
16226,0,0,89,0,-89
16227,1,1,1010,1357,347
16228,0,0,94,0,-94
16229,0,0,164,0,-164
16230,0,0,17,0,-17
16231,0,0,61,0,-61
16232,1,0,9,0,-9
16233,0,0,37,0,-37
16234,1,0,67,0,-67
16235,0,0,37,0,-37
16236,1,1,1365,1369,4
16237,1,0,30,0,-30
16238,1,0,59,0,-59
16239,1,0,9,0,-9
16240,0,0,26,0,-26
16241,1,0,8,0,-8
16242,1,0,31,0,-31
16243,1,0,64,0,-64
16244,0,0,5,0,-5
16245,1,1,190,2032,1842
16246,1,0,10,0,-10
16247,1,1,1529,1590,61
16248,0,0,118,0,-118
16249,0,0,20,0,-20
16250,1,1,298,1788,1490
16251,0,0,30,0,-30
16252,1,0,19,0,-19
16253,1,1,552,1289,737
16254,1,1,171,1258,1087
16255,0,0,3,0,-3
16256,0,0,17,0,-17
16257,1,0,51,0,-51
16258,1,1,163,1567,1404
16259,1,1,716,1396,680
16260,0,0,48,0,-48
16261,0,0,125,0,-125
16262,1,1,787,2009,1222
16263,1,1,487,1277,790
16264,1,0,34,0,-34
16265,1,0,1,0,-1
16266,0,0,41,0,-41
16267,1,0,6,0,-6
16268,0,0,38,0,-38
16269,1,0,15,0,-15
16270,1,0,50,0,-50
16271,0,0,101,0,-101
16272,1,0,139,0,-139
16273,1,0,116,0,-116
16274,0,0,53,0,-53
16275,1,0,61,0,-61
16276,1,0,13,0,-13
16277,0,0,25,0,-25
16278,1,1,158,1564,1406
16279,1,0,37,0,-37
16280,0,0,2,0,-2
16281,1,1,1213,1415,202
16282,0,0,26,0,-26
16283,1,1,979,1206,227
16284,1,0,43,0,-43
16285,0,0,48,0,-48
16286,0,0,22,0,-22
16287,1,1,1221,1353,132
16288,0,0,65,0,-65
16289,1,0,209,0,-209
16290,0,0,8,0,-8
16291,1,1,281,2604,2323
16292,1,1,427,1430,1003
16293,0,0,12,0,-12
16294,1,0,10,0,-10
16295,1,1,94,1705,1611
16296,1,0,79,0,-79
16297,0,0,0,0,0
16298,1,0,13,0,-13
16299,0,0,4,0,-4
16300,1,0,0,0,0
16301,0,0,4,0,-4
16302,1,1,1108,1351,243
16303,0,0,18,0,-18
16304,1,1,170,1212,1042
16305,1,1,238,2480,2242
16306,0,0,57,0,-57
16307,0,0,35,0,-35
16308,1,1,130,1717,1587
16309,1,0,112,0,-112
16310,1,0,123,0,-123
16311,0,0,3,0,-3
16312,1,1,124,1327,1203
16313,1,0,139,0,-139
16314,1,0,72,0,-72
16315,1,1,605,1265,660
16316,0,0,22,0,-22
16317,0,0,21,0,-21
16318,1,0,12,0,-12
16319,1,1,249,1214,965
16320,1,1,101,1327,1226
16321,1,1,470,1487,1017
16322,0,0,82,0,-82
16323,1,0,84,0,-84
16324,1,1,1326,1382,56
16325,1,0,67,0,-67
16326,0,0,225,0,-225
16327,1,0,21,0,-21
16328,0,0,20,0,-20
16329,0,0,13,0,-13
16330,1,0,17,0,-17
16331,1,1,1030,3450,2420
16332,1,1,85,1478,1393
16333,1,0,91,0,-91
16334,0,0,92,0,-92
16335,0,0,24,0,-24
16336,0,0,60,0,-60
16337,1,1,216,1374,1158
16338,0,0,0,0,0
16339,1,1,659,1698,1039
16340,1,1,60,1309,1249
16341,1,0,5,0,-5
16342,1,1,33,1986,1953
16343,1,0,64,0,-64
16344,1,1,338,1407,1069
16345,1,1,347,1337,990
16346,1,0,9,0,-9
16347,1,1,302,1209,907
16348,1,0,43,0,-43
16349,1,1,386,1254,868
16350,1,0,7,0,-7
16351,1,1,603,1556,953
16352,0,0,6,0,-6
16353,1,1,759,1346,587
16354,1,1,391,1347,956
16355,1,1,99,1279,1180
16356,0,0,37,0,-37
16357,1,0,45,0,-45
16358,0,0,7,0,-7
16359,0,0,18,0,-18
16360,1,1,2777,1758,-1019
16361,0,0,10,0,-10
16362,0,0,35,0,-35
16363,1,0,34,0,-34
16364,1,0,48,0,-48
16365,1,1,82,1398,1316
16366,0,0,26,0,-26
16367,0,0,9,0,-9
16368,1,0,201,0,-201
16369,0,0,143,0,-143
16370,0,0,69,0,-69
16371,1,0,22,0,-22
16372,0,0,62,0,-62
16373,1,0,57,0,-57
16374,1,1,54,1245,1191
16375,1,0,4,0,-4
16376,1,1,137,2549,2412
16377,1,1,373,1204,831
16378,1,1,422,2182,1760
16379,0,0,55,0,-55
16380,0,0,139,0,-139
16381,1,1,90,1294,1204
16382,1,1,286,1424,1138
16383,0,0,6,0,-6
16384,0,0,6,0,-6
16385,0,0,38,0,-38
16386,0,0,5,0,-5
16387,1,1,1053,1857,804
16388,0,0,14,0,-14
16389,0,0,9,0,-9
16390,0,0,49,0,-49
16391,1,0,52,0,-52
16392,1,1,236,2233,1997
16393,0,0,15,0,-15
16394,0,0,8,0,-8
16395,1,0,17,0,-17
16396,1,1,234,2091,1857
16397,0,0,9,0,-9
16398,0,0,52,0,-52
16399,1,0,65,0,-65
16400,1,1,1214,1415,201
16401,0,0,21,0,-21
16402,1,0,17,0,-17
16403,1,1,137,1380,1243
16404,0,0,73,0,-73
16405,1,1,180,1517,1337
16406,1,0,6,0,-6
16407,1,1,561,2228,1667
16408,0,0,43,0,-43
16409,1,0,0,0,0
16410,0,0,57,0,-57
16411,1,1,174,1209,1035
16412,1,1,672,1556,884
16413,0,0,6,0,-6
16414,1,0,89,0,-89
16415,0,0,7,0,-7
16416,1,1,259,1367,1108
16417,1,0,33,0,-33
16418,1,1,467,1367,900
16419,1,1,404,1731,1327
16420,1,1,307,1930,1623
16421,1,0,58,0,-58
16422,0,0,11,0,-11
16423,0,0,118,0,-118
16424,1,0,27,0,-27
16425,1,0,11,0,-11
16426,0,0,102,0,-102
16427,0,0,18,0,-18
16428,0,0,25,0,-25
16429,1,0,123,0,-123
16430,0,0,115,0,-115
16431,0,0,207,0,-207
16432,1,0,15,0,-15
16433,0,0,95,0,-95
16434,0,0,12,0,-12
16435,1,0,17,0,-17
16436,1,0,51,0,-51
16437,1,0,30,0,-30
16438,0,0,26,0,-26
16439,0,0,80,0,-80
16440,1,1,221,1286,1065
16441,0,0,59,0,-59
16442,1,1,185,1439,1254
16443,1,0,23,0,-23
16444,1,0,154,0,-154
16445,0,0,44,0,-44
16446,1,1,50,2248,2198
16447,1,0,13,0,-13
16448,1,1,296,1286,990
16449,1,0,4,0,-4
16450,1,0,7,0,-7
16451,1,0,65,0,-65
16452,0,0,43,0,-43
16453,1,0,9,0,-9
16454,1,0,29,0,-29
16455,0,0,53,0,-53
16456,1,1,653,1327,674
16457,0,0,145,0,-145
16458,0,0,49,0,-49
16459,1,1,85,1431,1346
16460,0,0,41,0,-41
16461,1,1,191,1458,1267
16462,0,0,114,0,-114
16463,0,0,7,0,-7
16464,1,0,2,0,-2
16465,1,1,678,1782,1104
16466,1,0,2,0,-2
16467,0,0,2,0,-2
16468,1,0,7,0,-7
16469,1,0,12,0,-12
16470,1,0,158,0,-158
16471,1,1,759,1260,501
16472,1,0,115,0,-115
16473,1,0,58,0,-58
16474,0,0,45,0,-45
16475,0,0,35,0,-35
16476,1,1,417,1879,1462
16477,1,0,4,0,-4
16478,1,0,73,0,-73
16479,1,1,168,1657,1489
16480,1,0,18,0,-18
16481,0,0,87,0,-87
16482,1,1,620,1811,1191
16483,1,0,34,0,-34
16484,0,0,23,0,-23
16485,1,1,355,1320,965
16486,0,0,42,0,-42
16487,1,1,259,3382,3123
16488,1,0,9,0,-9
16489,1,1,824,1574,750
16490,0,0,121,0,-121
16491,0,0,13,0,-13
16492,1,0,26,0,-26
16493,1,1,401,1541,1140
16494,0,0,17,0,-17
16495,0,0,17,0,-17
16496,0,0,25,0,-25
16497,1,0,23,0,-23
16498,0,0,1,0,-1
16499,1,0,15,0,-15
16500,0,0,38,0,-38
16501,0,0,9,0,-9
16502,0,0,0,0,0
16503,1,0,30,0,-30
16504,1,0,29,0,-29
16505,0,0,59,0,-59
16506,1,1,117,3851,3734
16507,1,1,428,1616,1188
16508,1,1,447,1213,766
16509,1,0,3,0,-3
16510,0,0,25,0,-25
16511,0,0,1,0,-1
16512,0,0,8,0,-8
16513,1,0,29,0,-29
16514,0,0,25,0,-25
16515,1,1,396,1582,1186
16516,0,0,61,0,-61
16517,1,0,6,0,-6
16518,1,1,276,1538,1262
16519,1,0,3,0,-3
16520,1,1,687,1303,616
16521,1,1,58,2124,2066
16522,1,0,7,0,-7
16523,1,1,916,1514,598
16524,0,0,41,0,-41
16525,1,0,114,0,-114
16526,0,0,47,0,-47
16527,0,0,4,0,-4
16528,0,0,6,0,-6
16529,1,0,46,0,-46
16530,1,1,234,1415,1181
16531,0,0,89,0,-89
16532,0,0,133,0,-133
16533,0,0,4,0,-4
16534,1,0,14,0,-14
16535,0,0,145,0,-145
16536,0,0,31,0,-31
16537,1,0,134,0,-134
16538,1,0,1,0,-1
16539,1,0,128,0,-128
16540,0,0,19,0,-19
16541,1,1,267,1760,1493
16542,1,1,711,1458,747
16543,0,0,20,0,-20
16544,0,0,56,0,-56
16545,1,0,10,0,-10
16546,1,1,1677,1681,4
16547,1,0,4,0,-4
16548,1,0,23,0,-23
16549,1,0,170,0,-170
16550,1,0,86,0,-86
16551,0,0,12,0,-12
16552,1,0,11,0,-11
16553,0,0,19,0,-19
16554,1,0,89,0,-89
16555,1,0,26,0,-26
16556,1,0,15,0,-15
16557,1,0,62,0,-62
16558,1,1,813,1789,976
16559,0,0,2,0,-2
16560,1,0,14,0,-14
16561,1,0,135,0,-135
16562,1,1,167,2742,2575
16563,1,1,725,1247,522
16564,1,0,67,0,-67
16565,0,0,16,0,-16
16566,1,1,937,1826,889
16567,1,0,43,0,-43
16568,0,0,4,0,-4
16569,0,0,27,0,-27
16570,1,0,47,0,-47
16571,1,0,27,0,-27
16572,1,1,84,1820,1736
16573,1,0,20,0,-20
16574,0,0,25,0,-25
16575,1,0,46,0,-46
16576,1,1,814,1330,516
16577,1,1,787,1255,468
16578,1,1,184,2503,2319
16579,1,0,276,0,-276
16580,1,1,1552,1945,393
16581,0,0,24,0,-24
16582,1,1,502,2038,1536
16583,0,0,99,0,-99
16584,1,0,19,0,-19
16585,1,0,113,0,-113
16586,1,0,26,0,-26
16587,1,0,51,0,-51
16588,1,1,70,1686,1616
16589,0,0,7,0,-7
16590,0,0,51,0,-51
16591,1,1,192,1344,1152
16592,1,0,19,0,-19
16593,0,0,19,0,-19
16594,1,0,51,0,-51
16595,0,0,45,0,-45
16596,1,0,13,0,-13
16597,1,1,72,1449,1377
16598,1,0,222,0,-222
16599,0,0,0,0,0
16600,1,1,536,1225,689
16601,0,0,67,0,-67
16602,1,1,392,2492,2100
16603,0,0,256,0,-256
16604,1,1,363,1807,1444
16605,1,0,29,0,-29
16606,1,0,20,0,-20
16607,1,0,49,0,-49
16608,1,1,757,1383,626
16609,0,0,10,0,-10
16610,1,1,789,1611,822
16611,0,0,58,0,-58
16612,0,0,22,0,-22
16613,1,0,32,0,-32
16614,1,1,1396,1583,187
16615,0,0,107,0,-107
16616,0,0,3,0,-3
16617,1,0,58,0,-58
16618,0,0,77,0,-77
16619,0,0,132,0,-132
16620,0,0,59,0,-59
16621,1,0,8,0,-8
16622,0,0,24,0,-24
16623,1,1,1107,1426,319
16624,1,1,1868,1201,-667
16625,1,0,45,0,-45
16626,1,0,27,0,-27
16627,1,1,512,1702,1190
16628,1,1,944,1446,502
16629,1,1,1014,1414,400
16630,1,0,76,0,-76
16631,0,0,27,0,-27
16632,0,0,16,0,-16
16633,0,0,24,0,-24
16634,1,0,94,0,-94
16635,1,0,120,0,-120
16636,0,0,9,0,-9
16637,1,0,31,0,-31
16638,1,1,141,1890,1749
16639,0,0,27,0,-27
16640,0,0,29,0,-29
16641,1,0,18,0,-18
16642,0,0,0,0,0
16643,1,0,4,0,-4
16644,0,0,104,0,-104
16645,1,0,62,0,-62
16646,1,1,346,1390,1044
16647,0,0,0,0,0
16648,0,0,14,0,-14
16649,0,0,111,0,-111
16650,0,0,0,0,0
16651,1,1,722,1247,525
16652,0,0,41,0,-41
16653,1,0,103,0,-103
16654,1,0,6,0,-6
16655,0,0,71,0,-71
16656,1,0,11,0,-11
16657,1,0,0,0,0
16658,1,0,78,0,-78
16659,1,1,33,2120,2087
16660,1,1,91,1853,1762
16661,1,1,223,1267,1044
16662,1,0,121,0,-121
16663,0,0,56,0,-56
16664,1,0,27,0,-27
16665,1,0,69,0,-69
16666,0,0,26,0,-26
16667,0,0,32,0,-32
16668,1,0,0,0,0
16669,1,0,1,0,-1
16670,0,0,143,0,-143
16671,0,0,150,0,-150
16672,0,0,11,0,-11
16673,0,0,37,0,-37
16674,0,0,17,0,-17
16675,0,0,38,0,-38
16676,0,0,33,0,-33
16677,1,0,225,0,-225
16678,1,1,121,3908,3787
16679,0,0,27,0,-27
16680,0,0,6,0,-6
16681,0,0,11,0,-11
16682,0,0,271,0,-271
16683,1,0,63,0,-63
16684,1,0,24,0,-24
16685,0,0,65,0,-65
16686,1,0,51,0,-51
16687,1,0,95,0,-95
16688,1,0,21,0,-21
16689,0,0,144,0,-144
16690,0,0,38,0,-38
16691,1,0,242,0,-242
16692,1,1,664,1431,767
16693,0,0,124,0,-124
16694,1,0,65,0,-65
16695,1,1,1456,1435,-21
16696,1,0,31,0,-31
16697,0,0,13,0,-13
16698,0,0,31,0,-31
16699,0,0,14,0,-14
16700,1,1,1224,1337,113
16701,1,1,1047,1624,577
16702,1,1,106,1505,1399
16703,1,0,12,0,-12
16704,1,0,59,0,-59
16705,0,0,16,0,-16
16706,1,0,45,0,-45
16707,1,0,45,0,-45
16708,0,0,3,0,-3
16709,0,0,72,0,-72
16710,1,0,4,0,-4
16711,1,0,67,0,-67
16712,1,0,16,0,-16
16713,0,0,45,0,-45
16714,0,0,20,0,-20
16715,1,1,2929,1308,-1621
16716,0,0,168,0,-168
16717,1,0,38,0,-38
16718,0,0,72,0,-72
16719,0,0,68,0,-68
16720,1,0,107,0,-107
16721,1,0,0,0,0
16722,0,0,3,0,-3
16723,1,0,88,0,-88
16724,0,0,153,0,-153
16725,1,0,123,0,-123
16726,0,0,2,0,-2
16727,0,0,315,0,-315
16728,0,0,9,0,-9
16729,0,0,30,0,-30
16730,1,0,71,0,-71
16731,1,1,144,1754,1610
16732,1,1,458,1817,1359
16733,0,0,75,0,-75
16734,1,1,454,1220,766
16735,0,0,24,0,-24
16736,0,0,39,0,-39
16737,0,0,9,0,-9
16738,1,0,5,0,-5
16739,1,0,42,0,-42
16740,0,0,20,0,-20
16741,1,0,3,0,-3
16742,1,1,248,1355,1107
16743,1,0,51,0,-51
16744,0,0,79,0,-79
16745,0,0,4,0,-4
16746,0,0,22,0,-22
16747,1,1,592,1367,775
16748,0,0,69,0,-69
16749,1,0,107,0,-107
16750,1,1,1254,1550,296
16751,1,0,7,0,-7
16752,1,0,18,0,-18
16753,1,0,9,0,-9
16754,0,0,18,0,-18
16755,0,0,1,0,-1
16756,1,0,75,0,-75
16757,0,0,7,0,-7
16758,1,1,286,1363,1077
16759,1,1,364,1310,946
16760,1,1,427,1340,913
16761,1,0,56,0,-56
16762,1,0,11,0,-11
16763,0,0,2,0,-2
16764,0,0,50,0,-50
16765,1,0,55,0,-55
16766,1,1,383,1308,925
16767,0,0,119,0,-119
16768,1,1,1087,1206,119
16769,0,0,49,0,-49
16770,1,0,18,0,-18
16771,1,1,147,1374,1227
16772,0,0,25,0,-25
16773,0,0,105,0,-105
16774,1,1,207,1287,1080
16775,0,0,70,0,-70
16776,1,1,569,1298,729
16777,1,0,125,0,-125
16778,0,0,12,0,-12
16779,1,0,31,0,-31
16780,1,1,179,1385,1206
16781,0,0,107,0,-107
16782,0,0,61,0,-61
16783,0,0,28,0,-28
16784,1,0,161,0,-161
16785,0,0,11,0,-11
16786,1,1,74,1275,1201
16787,1,1,1371,1224,-147
16788,1,1,111,1492,1381
16789,0,0,64,0,-64
16790,0,0,106,0,-106
16791,1,1,219,1299,1080
16792,0,0,93,0,-93
16793,1,0,2,0,-2
16794,1,1,150,2163,2013
16795,0,0,18,0,-18
16796,1,0,50,0,-50
16797,1,0,6,0,-6
16798,1,0,146,0,-146
16799,1,0,42,0,-42
16800,1,0,27,0,-27
16801,0,0,48,0,-48
16802,0,0,106,0,-106
16803,0,0,8,0,-8
16804,0,0,10,0,-10
16805,0,0,80,0,-80
16806,0,0,12,0,-12
16807,0,0,28,0,-28
16808,1,0,3,0,-3
16809,0,0,18,0,-18
16810,1,1,549,1968,1419
16811,1,1,81,1501,1420
16812,1,0,4,0,-4
16813,1,1,93,1222,1129
16814,0,0,70,0,-70
16815,1,1,177,1330,1153
16816,1,0,71,0,-71
16817,0,0,13,0,-13
16818,1,1,1074,1696,622
16819,1,0,32,0,-32
16820,0,0,7,0,-7
16821,1,1,84,1220,1136
16822,1,0,72,0,-72
16823,1,0,7,0,-7
16824,0,0,35,0,-35
16825,1,0,121,0,-121
16826,0,0,4,0,-4
16827,1,1,1850,1833,-17
16828,1,1,1687,1279,-408
16829,0,0,7,0,-7
16830,1,0,1,0,-1
16831,1,1,807,1291,484
16832,0,0,7,0,-7
16833,1,0,1,0,-1
16834,0,0,27,0,-27
16835,0,0,54,0,-54
16836,0,0,72,0,-72
16837,1,1,672,3514,2842
16838,1,0,7,0,-7
16839,0,0,132,0,-132
16840,1,0,59,0,-59
16841,1,0,16,0,-16
16842,0,0,13,0,-13
16843,0,0,44,0,-44
16844,1,0,34,0,-34
16845,1,1,111,1280,1169
16846,0,0,43,0,-43
16847,1,0,16,0,-16
16848,0,0,96,0,-96
16849,0,0,11,0,-11
16850,1,0,44,0,-44
16851,0,0,4,0,-4
16852,1,1,392,1620,1228
16853,0,0,40,0,-40
16854,0,0,60,0,-60
16855,0,0,34,0,-34
16856,1,0,15,0,-15
16857,1,0,2,0,-2
16858,0,0,56,0,-56
16859,0,0,36,0,-36
16860,1,1,59,1799,1740
16861,1,1,408,1232,824
16862,1,1,378,1428,1050
16863,1,1,306,1662,1356
16864,0,0,5,0,-5
16865,1,1,1970,1692,-278
16866,0,0,45,0,-45
16867,0,0,79,0,-79
16868,0,0,131,0,-131
16869,1,0,46,0,-46
16870,1,0,37,0,-37
16871,1,1,46,1453,1407
16872,1,1,151,1263,1112
16873,0,0,50,0,-50
16874,1,1,125,1654,1529
16875,1,1,289,2094,1805
16876,1,1,263,1362,1099
16877,1,0,88,0,-88
16878,1,0,89,0,-89
16879,0,0,18,0,-18
16880,1,1,133,1217,1084
16881,1,1,325,1414,1089
16882,0,0,20,0,-20
16883,0,0,24,0,-24
16884,1,0,0,0,0
16885,1,0,2,0,-2
16886,1,0,7,0,-7
16887,0,0,16,0,-16
16888,1,0,35,0,-35
16889,0,0,3,0,-3
16890,1,1,1263,1871,608
16891,0,0,8,0,-8
16892,1,0,48,0,-48
16893,0,0,24,0,-24
16894,1,1,64,1221,1157
16895,0,0,112,0,-112
16896,1,1,373,1511,1138
16897,0,0,50,0,-50
16898,1,1,1220,1884,664
16899,1,0,10,0,-10
16900,1,1,208,1208,1000
16901,1,0,28,0,-28
16902,1,0,63,0,-63
16903,1,1,547,1308,761
16904,1,0,16,0,-16
16905,1,1,589,1335,746
16906,1,1,46,1653,1607
16907,1,1,271,1264,993
16908,1,0,62,0,-62
16909,0,0,10,0,-10
16910,0,0,80,0,-80
16911,0,0,0,0,0
16912,0,0,120,0,-120
16913,0,0,1,0,-1
16914,0,0,99,0,-99
16915,0,0,4,0,-4
16916,0,0,178,0,-178
16917,1,0,41,0,-41
16918,0,0,38,0,-38
16919,0,0,47,0,-47
16920,1,0,161,0,-161
16921,1,0,52,0,-52
16922,1,1,249,1548,1299
16923,1,1,2236,1383,-853
16924,1,0,68,0,-68
16925,0,0,47,0,-47
16926,0,0,28,0,-28
16927,1,1,616,1216,600
16928,1,0,0,0,0
16929,1,0,126,0,-126
16930,1,1,456,2188,1732
16931,1,0,11,0,-11
16932,0,0,12,0,-12
16933,0,0,190,0,-190
16934,0,0,5,0,-5
16935,1,1,1596,1220,-376
16936,1,1,845,1226,381
16937,1,0,2,0,-2
16938,0,0,72,0,-72
16939,1,1,823,1353,530
16940,1,0,12,0,-12
16941,0,0,159,0,-159
16942,0,0,113,0,-113
16943,1,0,23,0,-23
16944,1,1,1411,1325,-86
16945,0,0,51,0,-51
16946,0,0,5,0,-5
16947,0,0,53,0,-53
16948,0,0,30,0,-30
16949,1,0,45,0,-45
16950,1,0,121,0,-121
16951,0,0,159,0,-159
16952,1,0,45,0,-45
16953,1,0,36,0,-36
16954,1,0,2,0,-2
16955,1,1,1875,1372,-503
16956,0,0,70,0,-70
16957,1,0,137,0,-137
16958,1,1,272,1485,1213
16959,0,0,214,0,-214
16960,1,1,756,1325,569
16961,0,0,71,0,-71
16962,0,0,4,0,-4
16963,0,0,82,0,-82
16964,0,0,0,0,0
16965,1,0,101,0,-101
16966,0,0,14,0,-14
16967,1,0,19,0,-19
16968,1,0,255,0,-255
16969,1,0,221,0,-221
16970,1,1,607,1945,1338
16971,1,0,40,0,-40
16972,0,0,65,0,-65
16973,1,1,70,1279,1209
16974,0,0,49,0,-49
16975,1,0,31,0,-31
16976,1,0,21,0,-21
16977,0,0,28,0,-28
16978,1,1,298,1444,1146
16979,1,1,1096,1583,487
16980,0,0,32,0,-32
16981,0,0,73,0,-73
16982,1,1,112,1713,1601
16983,1,0,68,0,-68
16984,1,1,1493,1236,-257
16985,0,0,16,0,-16
16986,1,0,71,0,-71
16987,1,0,274,0,-274
16988,1,1,664,1300,636
16989,0,0,62,0,-62
16990,1,0,16,0,-16
16991,1,0,32,0,-32
16992,0,0,2,0,-2
16993,1,0,2,0,-2
16994,1,1,793,1453,660
16995,1,0,17,0,-17
16996,0,0,21,0,-21
16997,0,0,293,0,-293
16998,1,1,340,1322,982
16999,0,0,29,0,-29
17000,0,0,52,0,-52
17001,1,1,255,1472,1217
17002,0,0,44,0,-44
17003,0,0,18,0,-18
17004,1,0,45,0,-45
17005,0,0,55,0,-55
17006,1,1,1542,1405,-137
17007,1,0,53,0,-53
17008,1,1,177,2237,2060
17009,1,1,99,1382,1283
17010,1,1,407,1260,853
17011,1,0,144,0,-144
17012,0,0,31,0,-31
17013,0,0,108,0,-108
17014,0,0,3,0,-3
17015,1,0,12,0,-12
17016,1,1,153,1538,1385
17017,0,0,2,0,-2
17018,1,0,13,0,-13
17019,0,0,4,0,-4
17020,0,0,205,0,-205
17021,0,0,4,0,-4
17022,1,1,1155,2367,1212
17023,1,0,34,0,-34
17024,1,0,69,0,-69
17025,1,1,260,1747,1487
17026,1,1,399,1957,1558
17027,0,0,7,0,-7
17028,1,0,89,0,-89
17029,1,1,208,3365,3157
17030,0,0,123,0,-123
17031,1,0,7,0,-7
17032,0,0,2,0,-2
17033,1,0,54,0,-54
17034,0,0,16,0,-16
17035,1,0,9,0,-9
17036,0,0,53,0,-53
17037,0,0,24,0,-24
17038,1,0,12,0,-12
17039,1,0,30,0,-30
17040,0,0,45,0,-45
17041,0,0,2,0,-2
17042,0,0,10,0,-10
17043,1,0,37,0,-37
17044,1,0,8,0,-8
17045,1,0,99,0,-99
17046,0,0,85,0,-85
17047,1,1,951,1209,258
17048,0,0,13,0,-13
17049,0,0,47,0,-47
17050,1,0,30,0,-30
17051,0,0,13,0,-13
17052,0,0,215,0,-215
17053,1,0,84,0,-84
17054,0,0,0,0,0
17055,1,0,119,0,-119
17056,0,0,8,0,-8
17057,1,0,145,0,-145
17058,0,0,12,0,-12
17059,1,0,130,0,-130
17060,0,0,133,0,-133
17061,0,0,43,0,-43
17062,1,1,222,1517,1295
17063,1,0,112,0,-112
17064,1,1,349,1207,858
17065,0,0,6,0,-6
17066,0,0,25,0,-25
17067,0,0,68,0,-68
17068,0,0,59,0,-59
17069,0,0,109,0,-109
17070,0,0,138,0,-138
17071,1,1,83,1708,1625
17072,1,0,17,0,-17
17073,1,0,17,0,-17
17074,0,0,10,0,-10
17075,1,1,158,2426,2268
17076,1,0,276,0,-276
17077,1,1,170,1236,1066
17078,1,1,428,2199,1771
17079,1,1,1464,2321,857
17080,1,1,329,1271,942
17081,1,1,114,4449,4335
17082,1,1,621,1246,625
17083,1,1,140,1335,1195
17084,0,0,12,0,-12
17085,0,0,45,0,-45
17086,1,1,269,1200,931
17087,1,1,334,1225,891
17088,0,0,175,0,-175
17089,1,0,13,0,-13
17090,0,0,2,0,-2
17091,0,0,27,0,-27
17092,1,1,1061,2920,1859
17093,0,0,213,0,-213
17094,0,0,47,0,-47
17095,1,0,27,0,-27
17096,1,1,335,1325,990
17097,1,0,31,0,-31
17098,0,0,21,0,-21
17099,1,1,600,1448,848
17100,0,0,12,0,-12
17101,0,0,47,0,-47
17102,1,0,58,0,-58
17103,1,1,415,1440,1025
17104,0,0,19,0,-19
17105,1,0,38,0,-38
17106,1,0,81,0,-81
17107,0,0,171,0,-171
17108,1,0,385,0,-385
17109,1,1,112,1241,1129
17110,1,0,27,0,-27
17111,0,0,147,0,-147
17112,1,1,885,1596,711
17113,1,1,115,1373,1258
17114,0,0,8,0,-8
17115,1,0,1,0,-1
17116,0,0,134,0,-134
17117,1,0,36,0,-36
17118,1,0,3,0,-3
17119,0,0,50,0,-50
17120,1,0,89,0,-89
17121,0,0,29,0,-29
17122,1,1,52,1775,1723
17123,0,0,64,0,-64
17124,1,1,1415,1251,-164
17125,1,0,23,0,-23
17126,1,1,251,1393,1142
17127,1,0,63,0,-63
17128,0,0,180,0,-180
17129,1,0,9,0,-9
17130,1,1,1366,2242,876
17131,1,1,406,1795,1389
17132,0,0,17,0,-17
17133,0,0,16,0,-16
17134,1,0,23,0,-23
17135,0,0,1,0,-1
17136,1,0,115,0,-115
17137,0,0,17,0,-17
17138,0,0,70,0,-70
17139,1,0,15,0,-15
17140,0,0,125,0,-125
17141,1,1,111,1219,1108
17142,1,1,621,1211,590
17143,1,1,104,2431,2327
17144,1,0,2,0,-2
17145,1,1,827,2091,1264
17146,1,1,183,1401,1218
17147,1,1,857,1482,625
17148,1,0,86,0,-86
17149,0,0,29,0,-29
17150,1,1,126,1492,1366
17151,1,0,136,0,-136
17152,0,0,41,0,-41
17153,1,0,2,0,-2
17154,1,1,374,1706,1332
17155,0,0,39,0,-39
17156,1,1,279,1308,1029
17157,1,1,64,2281,2217
17158,0,0,43,0,-43
17159,1,0,18,0,-18
17160,0,0,133,0,-133
17161,1,0,88,0,-88
17162,0,0,230,0,-230
17163,1,1,229,1273,1044
17164,1,0,10,0,-10
17165,1,1,607,1807,1200
17166,1,1,165,1236,1071
17167,1,0,10,0,-10
17168,1,0,16,0,-16
17169,1,1,726,1301,575
17170,0,0,2,0,-2
17171,1,0,3,0,-3
17172,0,0,12,0,-12
17173,1,1,123,1271,1148
17174,1,1,178,2286,2108
17175,1,0,47,0,-47
17176,0,0,168,0,-168
17177,0,0,180,0,-180
17178,1,0,235,0,-235
17179,0,0,68,0,-68
17180,0,0,26,0,-26
17181,0,0,66,0,-66
17182,0,0,82,0,-82
17183,1,0,5,0,-5
17184,1,1,320,1655,1335
17185,1,1,407,1658,1251
17186,0,0,49,0,-49
17187,1,0,26,0,-26
17188,1,1,222,1272,1050
17189,1,0,11,0,-11
17190,1,0,83,0,-83
17191,1,1,257,2049,1792
17192,1,1,861,1459,598
17193,1,0,17,0,-17
17194,0,0,64,0,-64
17195,0,0,58,0,-58
17196,1,1,387,1308,921
17197,1,0,57,0,-57
17198,0,0,10,0,-10
17199,0,0,8,0,-8
17200,0,0,19,0,-19
17201,1,1,1094,1297,203
17202,1,1,645,1284,639
17203,1,1,234,1453,1219
17204,1,1,677,1227,550
17205,1,0,54,0,-54
17206,1,1,1416,1226,-190
17207,1,0,22,0,-22
17208,1,1,211,1807,1596
17209,1,1,828,1257,429
17210,1,1,771,1413,642
17211,1,0,18,0,-18
17212,1,0,16,0,-16
17213,1,1,65,1794,1729
17214,1,1,1423,1265,-158
17215,1,0,40,0,-40
17216,1,1,165,1297,1132
17217,1,1,618,1320,702
17218,0,0,84,0,-84
17219,1,1,311,1581,1270
17220,0,0,41,0,-41
17221,0,0,41,0,-41
17222,0,0,16,0,-16
17223,0,0,21,0,-21
17224,1,1,157,1288,1131
17225,1,1,40,1556,1516
17226,1,0,33,0,-33
17227,1,1,964,1302,338
17228,1,1,2127,1987,-140
17229,0,0,11,0,-11
17230,1,1,1121,1550,429
17231,1,0,29,0,-29
17232,1,1,158,1201,1043
17233,1,0,64,0,-64
17234,1,0,3,0,-3
17235,1,0,49,0,-49
17236,1,1,2356,2685,329
17237,0,0,26,0,-26
17238,1,1,129,1457,1328
17239,1,1,679,1407,728
17240,0,0,16,0,-16
17241,1,0,23,0,-23
17242,0,0,25,0,-25
17243,0,0,59,0,-59
17244,0,0,30,0,-30
17245,1,1,362,1417,1055
17246,0,0,14,0,-14
17247,1,1,725,1302,577
17248,0,0,22,0,-22
17249,1,1,553,1645,1092
17250,0,0,10,0,-10
17251,0,0,6,0,-6
17252,0,0,92,0,-92
17253,1,0,113,0,-113
17254,1,0,133,0,-133
17255,1,1,20,1450,1430
17256,1,1,66,1573,1507
17257,0,0,7,0,-7
17258,0,0,117,0,-117
17259,1,1,288,2035,1747
17260,1,1,141,1276,1135
17261,0,0,17,0,-17
17262,0,0,32,0,-32
17263,0,0,7,0,-7
17264,1,0,3,0,-3
17265,0,0,4,0,-4
17266,1,0,24,0,-24
17267,0,0,9,0,-9
17268,1,0,7,0,-7
17269,1,0,50,0,-50
17270,0,0,23,0,-23
17271,0,0,61,0,-61
17272,1,1,94,1225,1131
17273,0,0,10,0,-10
17274,0,0,14,0,-14
17275,1,0,4,0,-4
17276,1,1,226,1242,1016
17277,1,0,97,0,-97
17278,0,0,42,0,-42
17279,1,1,735,1410,675
17280,1,1,280,1474,1194
17281,1,1,1508,1489,-19
17282,1,1,772,1200,428
17283,1,1,284,2282,1998
17284,1,1,218,1279,1061
17285,1,1,403,1578,1175
17286,0,0,81,0,-81
17287,0,0,23,0,-23
17288,0,0,15,0,-15
17289,1,1,2957,1336,-1621
17290,1,1,119,1506,1387
17291,0,0,16,0,-16
17292,1,1,963,1606,643
17293,0,0,131,0,-131
17294,1,0,16,0,-16
17295,1,0,11,0,-11
17296,1,0,44,0,-44
17297,0,0,28,0,-28
17298,0,0,18,0,-18
17299,1,1,110,1636,1526
17300,1,1,530,1414,884
17301,1,0,69,0,-69
17302,1,0,18,0,-18
17303,0,0,22,0,-22
17304,1,0,173,0,-173
17305,1,1,426,1741,1315
17306,1,1,154,1220,1066
17307,1,1,537,1706,1169
17308,1,1,48,1597,1549
17309,1,0,33,0,-33
17310,1,1,209,1549,1340
17311,0,0,6,0,-6
17312,1,0,6,0,-6
17313,1,0,2,0,-2
17314,1,1,337,1501,1164
17315,0,0,35,0,-35
17316,0,0,3,0,-3
17317,1,1,258,1409,1151
17318,1,0,81,0,-81
17319,1,1,320,1220,900
17320,1,1,87,1289,1202
17321,0,0,28,0,-28
17322,0,0,20,0,-20
17323,1,1,66,1319,1253
17324,1,1,132,1530,1398
17325,1,0,109,0,-109
17326,0,0,51,0,-51
17327,0,0,1,0,-1
17328,1,0,111,0,-111
17329,0,0,37,0,-37
17330,1,0,169,0,-169
17331,1,1,137,1373,1236
17332,0,0,65,0,-65
17333,1,0,73,0,-73
17334,0,0,37,0,-37
17335,1,1,1570,2355,785
17336,1,0,20,0,-20
17337,1,1,550,1809,1259
17338,1,0,11,0,-11
17339,0,0,80,0,-80
17340,1,1,297,1589,1292
17341,1,1,282,1210,928
17342,0,0,189,0,-189
17343,1,1,203,1344,1141
17344,1,0,4,0,-4
17345,1,1,249,1589,1340
17346,1,1,31,2149,2118
17347,1,1,717,1204,487
17348,1,1,264,1792,1528
17349,0,0,55,0,-55
17350,1,0,31,0,-31
17351,0,0,6,0,-6
17352,1,0,9,0,-9
17353,0,0,14,0,-14
17354,1,1,242,1812,1570
17355,1,0,55,0,-55
17356,1,1,352,2155,1803
17357,0,0,99,0,-99
17358,1,0,130,0,-130
17359,0,0,49,0,-49
17360,0,0,12,0,-12
17361,0,0,1,0,-1
17362,1,0,0,0,0
17363,1,0,38,0,-38
17364,1,0,1,0,-1
17365,1,0,23,0,-23
17366,0,0,67,0,-67
17367,1,1,314,1409,1095
17368,1,1,322,1513,1191
17369,1,0,42,0,-42
17370,0,0,14,0,-14
17371,1,1,819,1497,678
17372,1,1,1218,4112,2894
17373,1,1,461,1714,1253
17374,1,0,15,0,-15
17375,1,0,22,0,-22
17376,1,0,3,0,-3
17377,1,1,364,1627,1263
17378,0,0,106,0,-106
17379,1,1,284,1472,1188
17380,1,1,806,2061,1255
17381,0,0,37,0,-37
17382,1,0,8,0,-8
17383,1,0,10,0,-10
17384,0,0,62,0,-62
17385,0,0,182,0,-182
17386,1,1,952,1203,251
17387,1,1,1882,1268,-614
17388,1,0,14,0,-14
17389,1,0,154,0,-154
17390,1,1,977,1683,706
17391,0,0,48,0,-48
17392,1,1,171,1331,1160
17393,1,0,29,0,-29
17394,1,0,60,0,-60
17395,1,1,663,1486,823
17396,1,0,1,0,-1
17397,0,0,108,0,-108
17398,1,0,87,0,-87
17399,1,1,142,2119,1977
17400,1,1,413,1343,930
17401,0,0,72,0,-72
17402,1,0,45,0,-45
17403,0,0,16,0,-16
17404,1,1,518,1494,976
17405,0,0,56,0,-56
17406,0,0,104,0,-104
17407,0,0,2,0,-2
17408,1,1,333,2490,2157
17409,1,0,0,0,0
17410,0,0,44,0,-44
17411,0,0,1,0,-1
17412,0,0,99,0,-99
17413,1,1,586,1584,998
17414,1,0,120,0,-120
17415,0,0,53,0,-53
17416,1,0,141,0,-141
17417,0,0,50,0,-50
17418,0,0,17,0,-17
17419,1,0,21,0,-21
17420,0,0,146,0,-146
17421,0,0,2,0,-2
17422,1,1,131,1690,1559
17423,1,1,99,1877,1778
17424,0,0,15,0,-15
17425,0,0,98,0,-98
17426,0,0,66,0,-66
17427,1,0,113,0,-113
17428,1,0,108,0,-108
17429,0,0,19,0,-19
17430,0,0,49,0,-49
17431,1,1,339,1275,936
17432,0,0,37,0,-37
17433,1,0,16,0,-16
17434,1,0,6,0,-6
17435,0,0,101,0,-101
17436,1,1,305,1291,986
17437,0,0,29,0,-29
17438,1,1,47,1759,1712
17439,0,0,43,0,-43
17440,0,0,194,0,-194
17441,0,0,47,0,-47
17442,1,1,512,1448,936
17443,1,1,152,2741,2589
17444,1,1,121,1493,1372
17445,1,0,43,0,-43
17446,1,1,271,1224,953
17447,1,0,16,0,-16
17448,0,0,48,0,-48
17449,1,0,27,0,-27
17450,1,0,15,0,-15
17451,0,0,82,0,-82
17452,1,0,25,0,-25
17453,1,0,50,0,-50
17454,1,1,301,1256,955
17455,1,1,265,2835,2570
17456,0,0,89,0,-89
17457,1,0,35,0,-35
17458,0,0,33,0,-33
17459,1,1,399,2198,1799
17460,0,0,1,0,-1
17461,0,0,55,0,-55
17462,0,0,9,0,-9
17463,0,0,86,0,-86
17464,1,1,480,1869,1389
17465,1,1,308,1448,1140
17466,0,0,168,0,-168
17467,1,1,403,1388,985
17468,0,0,70,0,-70
17469,0,0,80,0,-80
17470,0,0,64,0,-64
17471,1,1,966,1707,741
17472,1,1,215,1206,991
17473,1,0,83,0,-83
17474,0,0,3,0,-3
17475,1,0,8,0,-8
17476,0,0,22,0,-22
17477,1,0,4,0,-4
17478,1,1,1571,1448,-123
17479,1,0,135,0,-135
17480,0,0,16,0,-16
17481,1,1,93,2181,2088
17482,1,1,275,1291,1016
17483,1,0,36,0,-36
17484,1,1,113,2427,2314
17485,0,0,20,0,-20
17486,1,1,1386,1405,19
17487,1,1,966,1373,407
17488,1,1,45,1282,1237
17489,0,0,25,0,-25
17490,0,0,27,0,-27
17491,0,0,1,0,-1
17492,1,0,2,0,-2
17493,1,0,45,0,-45
17494,0,0,9,0,-9
17495,1,0,75,0,-75
17496,1,0,9,0,-9
17497,1,1,1087,1227,140
17498,1,0,124,0,-124
17499,1,1,434,2549,2115
17500,1,0,95,0,-95
17501,1,1,184,1557,1373
17502,1,0,34,0,-34
17503,0,0,9,0,-9
17504,0,0,145,0,-145
17505,1,0,6,0,-6
17506,1,0,87,0,-87
17507,0,0,32,0,-32
17508,0,0,139,0,-139
17509,0,0,48,0,-48
17510,0,0,43,0,-43
17511,0,0,31,0,-31
17512,1,0,5,0,-5
17513,1,0,0,0,0
17514,1,0,35,0,-35
17515,1,1,86,1419,1333
17516,1,1,1138,1844,706
17517,0,0,9,0,-9
17518,0,0,29,0,-29
17519,0,0,95,0,-95
17520,1,1,285,1307,1022
17521,1,0,52,0,-52
17522,1,0,91,0,-91
17523,1,0,50,0,-50
17524,1,0,65,0,-65
17525,1,1,105,1902,1797
17526,1,1,628,1426,798
17527,0,0,2,0,-2
17528,1,1,209,1309,1100
17529,0,0,25,0,-25
17530,0,0,99,0,-99
17531,1,1,1027,1482,455
17532,1,0,161,0,-161
17533,0,0,14,0,-14
17534,1,1,315,1363,1048
17535,1,1,482,1482,1000
17536,1,1,75,1253,1178
17537,0,0,92,0,-92
17538,0,0,38,0,-38
17539,1,0,88,0,-88
17540,1,0,125,0,-125
17541,1,1,1060,1615,555
17542,0,0,2,0,-2
17543,1,1,1172,1207,35
17544,1,1,333,1271,938
17545,1,0,162,0,-162
17546,0,0,82,0,-82
17547,1,0,80,0,-80
17548,1,1,98,1474,1376
17549,1,0,21,0,-21
17550,0,0,43,0,-43
17551,0,0,7,0,-7
17552,1,1,501,1275,774
17553,1,1,112,1255,1143
17554,1,0,20,0,-20
17555,1,1,29,1218,1189
17556,1,1,281,1873,1592
17557,0,0,46,0,-46
17558,0,0,62,0,-62
17559,0,0,5,0,-5
17560,1,0,6,0,-6
17561,0,0,85,0,-85
17562,1,1,238,1337,1099
17563,0,0,53,0,-53
17564,1,1,248,1676,1428
17565,1,1,426,1605,1179
17566,1,1,619,1284,665
17567,1,0,1,0,-1
17568,1,1,96,1462,1366
17569,1,0,52,0,-52
17570,0,0,86,0,-86
17571,1,1,621,1680,1059
17572,1,1,804,1410,606
17573,0,0,21,0,-21
17574,1,0,83,0,-83
17575,1,1,908,1235,327
17576,0,0,48,0,-48
17577,0,0,97,0,-97
17578,1,1,856,6124,5268
17579,1,1,1050,1228,178
17580,1,0,103,0,-103
17581,1,1,835,1744,909
17582,0,0,43,0,-43
17583,1,0,34,0,-34
17584,1,1,78,1460,1382
17585,1,0,53,0,-53
17586,1,0,27,0,-27
17587,1,1,553,1243,690
17588,1,0,17,0,-17
17589,0,0,24,0,-24
17590,1,1,448,1340,892
17591,0,0,52,0,-52
17592,0,0,16,0,-16
17593,0,0,7,0,-7
17594,1,0,61,0,-61
17595,0,0,70,0,-70
17596,0,0,14,0,-14
17597,1,0,4,0,-4
17598,1,1,252,1583,1331
17599,1,0,4,0,-4
17600,0,0,12,0,-12
17601,1,0,125,0,-125
17602,1,0,58,0,-58
17603,1,0,60,0,-60
17604,1,1,1721,1240,-481
17605,0,0,14,0,-14
17606,0,0,16,0,-16
17607,0,0,38,0,-38
17608,1,0,115,0,-115
17609,0,0,129,0,-129
17610,0,0,30,0,-30
17611,1,0,3,0,-3
17612,0,0,9,0,-9
17613,1,0,72,0,-72
17614,1,1,70,1607,1537
17615,1,1,387,1732,1345
17616,1,1,101,2858,2757
17617,0,0,21,0,-21
17618,0,0,80,0,-80
17619,1,0,2,0,-2
17620,1,0,40,0,-40
17621,0,0,79,0,-79
17622,1,0,189,0,-189
17623,0,0,32,0,-32
17624,0,0,0,0,0
17625,1,0,3,0,-3
17626,1,1,336,2342,2006
17627,1,1,213,1268,1055
17628,0,0,29,0,-29
17629,1,0,18,0,-18
17630,1,0,2,0,-2
17631,1,0,17,0,-17
17632,1,0,35,0,-35
17633,1,0,101,0,-101
17634,1,1,301,1354,1053
17635,1,1,116,1514,1398
17636,1,0,72,0,-72
17637,0,0,27,0,-27
17638,1,0,40,0,-40
17639,0,0,14,0,-14
17640,0,0,24,0,-24
17641,1,0,142,0,-142
17642,1,0,44,0,-44
17643,1,1,863,1327,464
17644,1,1,1582,1409,-173
17645,1,0,28,0,-28
17646,0,0,76,0,-76
17647,1,1,537,1281,744
17648,1,1,616,1277,661
17649,0,0,74,0,-74
17650,1,1,666,1374,708
17651,1,0,43,0,-43
17652,0,0,77,0,-77
17653,0,0,45,0,-45
17654,0,0,0,0,0
17655,0,0,46,0,-46
17656,0,0,130,0,-130
17657,0,0,14,0,-14
17658,1,1,88,2045,1957
17659,1,0,93,0,-93
17660,0,0,9,0,-9
17661,1,1,657,1430,773
17662,0,0,37,0,-37
17663,1,0,67,0,-67
17664,0,0,66,0,-66
17665,0,0,60,0,-60
17666,0,0,50,0,-50
17667,1,1,554,1654,1100
17668,1,1,1437,2014,577
17669,1,1,432,1246,814
17670,0,0,75,0,-75
17671,1,1,13,1975,1962
17672,1,1,1883,2000,117
17673,0,0,36,0,-36
17674,1,0,3,0,-3
17675,1,0,29,0,-29
17676,0,0,6,0,-6
17677,1,1,868,1458,590
17678,1,0,57,0,-57
17679,1,0,43,0,-43
17680,1,1,144,1473,1329
17681,1,1,42,1424,1382
17682,0,0,46,0,-46
17683,1,0,79,0,-79
17684,1,1,100,1556,1456
17685,1,0,63,0,-63
17686,1,1,628,1375,747
17687,0,0,54,0,-54
17688,0,0,12,0,-12
17689,1,0,43,0,-43
17690,1,0,2,0,-2
17691,1,1,21,1455,1434
17692,1,1,167,1243,1076
17693,1,1,910,1494,584
17694,1,1,388,1551,1163
17695,0,0,3,0,-3
17696,0,0,149,0,-149
17697,1,1,198,1384,1186
17698,0,0,37,0,-37
17699,1,1,870,1625,755
17700,1,1,350,2638,2288
17701,1,1,45,1698,1653
17702,1,0,89,0,-89
17703,1,1,238,1229,991
17704,1,0,48,0,-48
17705,0,0,6,0,-6
17706,0,0,6,0,-6
17707,1,0,56,0,-56
17708,0,0,18,0,-18
17709,0,0,162,0,-162
17710,1,0,1,0,-1
17711,1,1,427,1430,1003
17712,1,1,970,1238,268
17713,1,1,1239,1290,51
17714,1,1,592,1441,849
17715,0,0,44,0,-44
17716,1,0,63,0,-63
17717,0,0,34,0,-34
17718,1,1,187,1237,1050
17719,0,0,91,0,-91
17720,0,0,87,0,-87
17721,1,1,303,1426,1123
17722,0,0,31,0,-31
17723,1,0,61,0,-61
17724,0,0,10,0,-10
17725,1,0,52,0,-52
17726,0,0,10,0,-10
17727,1,1,1705,1331,-374
17728,1,0,26,0,-26
17729,0,0,14,0,-14
17730,1,1,1773,1448,-325
17731,1,0,39,0,-39
17732,1,0,14,0,-14
17733,1,1,1290,1203,-87
17734,0,0,0,0,0
17735,1,1,2058,1260,-798
17736,0,0,163,0,-163
17737,1,1,605,1240,635
17738,1,1,135,2069,1934
17739,1,1,376,1448,1072
17740,1,0,4,0,-4
17741,1,0,77,0,-77
17742,0,0,116,0,-116
17743,1,1,855,1239,384
17744,0,0,17,0,-17
17745,0,0,141,0,-141
17746,0,0,10,0,-10
17747,0,0,67,0,-67
17748,0,0,42,0,-42
17749,1,0,164,0,-164
17750,1,0,71,0,-71
17751,0,0,60,0,-60
17752,1,0,69,0,-69
17753,0,0,39,0,-39
17754,1,1,248,2055,1807
17755,0,0,79,0,-79
17756,0,0,47,0,-47
17757,1,1,67,1684,1617
17758,1,0,37,0,-37
17759,0,0,38,0,-38
17760,0,0,95,0,-95
17761,0,0,49,0,-49
17762,0,0,6,0,-6
17763,1,0,34,0,-34
17764,0,0,6,0,-6
17765,1,0,54,0,-54
17766,1,1,170,1329,1159
17767,1,0,141,0,-141
17768,1,0,19,0,-19
17769,0,0,125,0,-125
17770,0,0,31,0,-31
17771,1,1,2904,1850,-1054
17772,1,0,0,0,0
17773,1,1,245,1203,958
17774,0,0,6,0,-6
17775,1,1,1999,1277,-722
17776,1,1,1356,1680,324
17777,0,0,23,0,-23
17778,0,0,1,0,-1
17779,1,1,66,1269,1203
17780,1,0,34,0,-34
17781,1,0,197,0,-197
17782,1,1,802,2212,1410
17783,0,0,52,0,-52
17784,0,0,54,0,-54
17785,1,0,130,0,-130
17786,0,0,34,0,-34
17787,1,0,65,0,-65
17788,0,0,47,0,-47
17789,1,0,24,0,-24
17790,0,0,19,0,-19
17791,0,0,14,0,-14
17792,1,1,120,1275,1155
17793,0,0,39,0,-39
17794,1,1,624,1200,576
17795,0,0,14,0,-14
17796,0,0,43,0,-43
17797,1,0,2,0,-2
17798,1,0,69,0,-69
17799,0,0,187,0,-187
17800,1,1,781,1956,1175
17801,0,0,17,0,-17
17802,0,0,63,0,-63
17803,0,0,12,0,-12
17804,1,1,112,1441,1329
17805,1,0,35,0,-35
17806,0,0,81,0,-81
17807,1,1,126,1313,1187
17808,0,0,37,0,-37
17809,1,0,56,0,-56
17810,1,0,10,0,-10
17811,0,0,62,0,-62
17812,1,1,290,1430,1140
17813,1,1,858,1413,555
17814,0,0,29,0,-29
17815,1,0,9,0,-9
17816,1,1,653,1324,671
17817,1,0,48,0,-48
17818,1,1,918,1213,295
17819,0,0,6,0,-6
17820,1,1,83,1493,1410
17821,0,0,55,0,-55
17822,1,0,97,0,-97
17823,1,1,540,1263,723
17824,1,1,578,1455,877
17825,0,0,28,0,-28
17826,0,0,5,0,-5
17827,1,0,21,0,-21
17828,1,0,1,0,-1
17829,0,0,41,0,-41
17830,1,1,71,1417,1346
17831,1,0,61,0,-61
17832,0,0,16,0,-16
17833,1,1,362,2091,1729
17834,0,0,31,0,-31
17835,1,1,2494,1228,-1266
17836,1,1,239,1940,1701
17837,0,0,50,0,-50
17838,1,0,32,0,-32
17839,1,1,1390,1722,332
17840,1,0,43,0,-43
17841,0,0,103,0,-103
17842,0,0,18,0,-18
17843,1,1,134,1873,1739
17844,1,0,20,0,-20
17845,1,0,0,0,0
17846,1,1,385,1421,1036
17847,0,0,15,0,-15
17848,0,0,21,0,-21
17849,0,0,27,0,-27
17850,1,1,1143,1252,109
17851,0,0,25,0,-25
17852,1,1,413,1316,903
17853,1,1,707,1235,528
17854,1,1,903,1206,303
17855,0,0,1,0,-1
17856,1,1,593,1232,639
17857,1,1,169,1481,1312
17858,1,0,51,0,-51
17859,0,0,81,0,-81
17860,0,0,10,0,-10
17861,0,0,184,0,-184
17862,1,1,63,1539,1476
17863,1,0,6,0,-6
17864,1,1,207,1746,1539
17865,1,1,123,1237,1114
17866,1,1,423,1524,1101
17867,1,1,1607,1227,-380
17868,1,0,32,0,-32
17869,0,0,2,0,-2
17870,1,0,54,0,-54
17871,0,0,99,0,-99
17872,1,0,9,0,-9
17873,1,1,1284,1933,649
17874,1,1,127,1356,1229
17875,1,0,10,0,-10
17876,0,0,65,0,-65
17877,1,1,197,1681,1484
17878,1,0,19,0,-19
17879,0,0,111,0,-111
17880,0,0,4,0,-4
17881,1,0,40,0,-40
17882,1,0,48,0,-48
17883,0,0,0,0,0
17884,0,0,134,0,-134
17885,0,0,15,0,-15
17886,0,0,39,0,-39
17887,1,1,266,1816,1550
17888,0,0,123,0,-123
17889,0,0,67,0,-67
17890,1,1,466,1206,740
17891,1,0,0,0,0
17892,1,0,46,0,-46
17893,0,0,0,0,0
17894,0,0,17,0,-17
17895,0,0,44,0,-44
17896,0,0,6,0,-6
17897,1,1,50,1506,1456
17898,0,0,160,0,-160
17899,1,1,173,1324,1151
17900,0,0,16,0,-16
17901,0,0,4,0,-4
17902,0,0,65,0,-65
17903,0,0,3,0,-3
17904,1,0,22,0,-22
17905,1,0,55,0,-55
17906,0,0,136,0,-136
17907,0,0,55,0,-55
17908,0,0,82,0,-82
17909,1,0,16,0,-16
17910,0,0,16,0,-16
17911,0,0,46,0,-46
17912,1,0,11,0,-11
17913,1,1,809,1553,744
17914,0,0,2,0,-2
17915,0,0,27,0,-27
17916,0,0,8,0,-8
17917,1,1,102,1969,1867
17918,1,1,1217,1295,78
17919,0,0,57,0,-57
17920,1,0,34,0,-34
17921,0,0,49,0,-49
17922,1,0,0,0,0
17923,1,1,644,1224,580
17924,0,0,21,0,-21
17925,1,1,338,1314,976
17926,0,0,53,0,-53
17927,0,0,9,0,-9
17928,0,0,94,0,-94
17929,0,0,19,0,-19
17930,0,0,58,0,-58
17931,0,0,49,0,-49
17932,1,0,13,0,-13
17933,1,1,91,1333,1242
17934,0,0,4,0,-4
17935,1,1,757,1313,556
17936,1,1,1256,3114,1858
17937,0,0,349,0,-349
17938,1,1,637,1391,754
17939,1,1,711,1266,555
17940,1,1,403,1395,992
17941,1,0,21,0,-21
17942,1,0,64,0,-64
17943,0,0,27,0,-27
17944,1,0,10,0,-10
17945,1,1,228,1352,1124
17946,0,0,79,0,-79
17947,0,0,140,0,-140
17948,0,0,4,0,-4
17949,1,1,291,1941,1650
17950,0,0,10,0,-10
17951,1,1,184,1260,1076
17952,1,0,32,0,-32
17953,0,0,95,0,-95
17954,1,0,204,0,-204
17955,1,1,231,1989,1758
17956,0,0,14,0,-14
17957,1,0,11,0,-11
17958,0,0,111,0,-111
17959,0,0,102,0,-102
17960,1,0,2,0,-2
17961,1,0,11,0,-11
17962,1,1,1062,1820,758
17963,1,1,760,1969,1209
17964,1,1,96,1653,1557
17965,1,0,43,0,-43
17966,1,0,123,0,-123
17967,0,0,10,0,-10
17968,1,1,381,1348,967
17969,1,0,55,0,-55
17970,0,0,7,0,-7
17971,0,0,32,0,-32
17972,1,0,22,0,-22
17973,1,1,158,1353,1195
17974,1,0,32,0,-32
17975,1,1,640,1833,1193
17976,1,1,149,1403,1254
17977,1,1,576,1605,1029
17978,0,0,8,0,-8
17979,1,0,18,0,-18
17980,1,0,5,0,-5
17981,1,1,418,1301,883
17982,0,0,165,0,-165
17983,1,0,98,0,-98
17984,1,0,50,0,-50
17985,1,0,58,0,-58
17986,0,0,174,0,-174
17987,0,0,14,0,-14
17988,1,0,2,0,-2
17989,1,0,21,0,-21
17990,1,1,1608,1374,-234
17991,1,0,4,0,-4
17992,1,0,151,0,-151
17993,1,0,267,0,-267
17994,0,0,2,0,-2
17995,0,0,86,0,-86
17996,1,0,158,0,-158
17997,0,0,8,0,-8
17998,0,0,6,0,-6
17999,1,1,209,1289,1080
18000,0,0,26,0,-26
18001,1,1,959,1925,966
18002,0,0,19,0,-19
18003,1,1,333,1710,1377
18004,1,0,14,0,-14
18005,1,0,11,0,-11
18006,1,1,328,1292,964
18007,1,1,531,1330,799
18008,1,0,91,0,-91
18009,0,0,8,0,-8
18010,1,1,1074,1809,735
18011,0,0,23,0,-23
18012,1,0,31,0,-31
18013,0,0,1,0,-1
18014,1,0,152,0,-152
18015,1,1,401,1290,889
18016,0,0,9,0,-9
18017,1,1,409,1270,861
18018,1,1,230,1360,1130
18019,1,1,94,1296,1202
18020,0,0,33,0,-33
18021,1,1,785,1334,549
18022,1,0,70,0,-70
18023,1,0,8,0,-8
18024,0,0,23,0,-23
18025,0,0,23,0,-23
18026,0,0,6,0,-6
18027,0,0,3,0,-3
18028,1,0,8,0,-8
18029,1,0,133,0,-133
18030,1,0,45,0,-45
18031,1,1,47,1514,1467
18032,1,0,165,0,-165
18033,1,1,665,1784,1119
18034,0,0,0,0,0
18035,0,0,68,0,-68
18036,1,0,0,0,0
18037,0,0,67,0,-67
18038,1,1,307,1589,1282
18039,1,1,238,2529,2291
18040,0,0,42,0,-42
18041,1,0,19,0,-19
18042,0,0,5,0,-5
18043,1,0,105,0,-105
18044,1,0,84,0,-84
18045,1,0,20,0,-20
18046,0,0,10,0,-10
18047,1,0,265,0,-265
18048,0,0,80,0,-80
18049,0,0,62,0,-62
18050,0,0,6,0,-6
18051,1,0,75,0,-75
18052,1,0,198,0,-198
18053,1,0,65,0,-65
18054,1,0,4,0,-4
18055,0,0,51,0,-51
18056,1,0,97,0,-97
18057,0,0,18,0,-18
18058,1,0,13,0,-13
18059,0,0,10,0,-10
18060,0,0,135,0,-135
18061,0,0,88,0,-88
18062,1,1,847,1380,533
18063,1,1,693,1482,789
18064,1,0,51,0,-51
18065,1,0,43,0,-43
18066,1,1,1796,1219,-577
18067,1,0,203,0,-203
18068,1,0,27,0,-27
18069,1,1,824,2391,1567
18070,1,0,57,0,-57
18071,1,0,37,0,-37
18072,1,0,28,0,-28
18073,1,1,814,1609,795
18074,1,1,257,1686,1429
18075,1,1,398,1248,850
18076,1,1,221,1457,1236
18077,0,0,6,0,-6
18078,1,0,74,0,-74
18079,1,1,258,1321,1063
18080,1,0,36,0,-36
18081,0,0,25,0,-25
18082,1,1,209,2188,1979
18083,1,0,54,0,-54
18084,1,0,18,0,-18
18085,1,0,143,0,-143
18086,1,0,12,0,-12
18087,1,0,88,0,-88
18088,0,0,67,0,-67
18089,0,0,2,0,-2
18090,1,1,207,1309,1102
18091,1,1,398,1365,967
18092,0,0,64,0,-64
18093,0,0,90,0,-90
18094,1,0,35,0,-35
18095,1,0,30,0,-30
18096,0,0,27,0,-27
18097,0,0,193,0,-193
18098,1,0,10,0,-10
18099,1,1,348,1340,992
18100,1,0,4,0,-4
18101,0,0,2,0,-2
18102,0,0,27,0,-27
18103,0,0,42,0,-42
18104,0,0,83,0,-83
18105,1,1,731,2137,1406
18106,1,1,1349,1520,171
18107,0,0,100,0,-100
18108,1,0,27,0,-27
18109,0,0,21,0,-21
18110,0,0,94,0,-94
18111,0,0,3,0,-3
18112,1,1,430,1269,839
18113,1,1,172,1378,1206
18114,0,0,130,0,-130
18115,0,0,12,0,-12
18116,1,0,32,0,-32
18117,0,0,24,0,-24
18118,1,1,580,2331,1751
18119,1,1,1489,1712,223
18120,0,0,9,0,-9
18121,0,0,42,0,-42
18122,0,0,25,0,-25
18123,0,0,148,0,-148
18124,0,0,70,0,-70
18125,1,0,25,0,-25
18126,0,0,0,0,0
18127,0,0,44,0,-44
18128,1,1,498,1263,765
18129,0,0,49,0,-49
18130,1,1,680,1250,570
18131,1,0,28,0,-28
18132,1,0,3,0,-3
18133,1,1,1026,1543,517
18134,1,1,210,1414,1204
18135,1,0,3,0,-3
18136,1,0,66,0,-66
18137,1,0,74,0,-74
18138,1,0,136,0,-136
18139,0,0,34,0,-34
18140,0,0,25,0,-25
18141,1,0,16,0,-16
18142,1,0,128,0,-128
18143,0,0,13,0,-13
18144,1,0,18,0,-18
18145,1,1,11,1249,1238
18146,1,1,900,1343,443
18147,1,0,104,0,-104
18148,1,0,24,0,-24
18149,0,0,8,0,-8
18150,1,0,2,0,-2
18151,1,1,1628,2049,421
18152,1,1,31,1288,1257
18153,1,0,27,0,-27
18154,1,0,14,0,-14
18155,1,1,471,1848,1377
18156,1,0,149,0,-149
18157,1,1,2003,1997,-6
18158,0,0,54,0,-54
18159,1,1,566,1639,1073
18160,0,0,50,0,-50
18161,1,0,2,0,-2
18162,1,1,1580,1563,-17
18163,0,0,53,0,-53
18164,0,0,132,0,-132
18165,1,1,143,1239,1096
18166,1,0,14,0,-14
18167,1,0,39,0,-39
18168,1,0,25,0,-25
18169,1,0,73,0,-73
18170,0,0,29,0,-29
18171,0,0,6,0,-6
18172,0,0,8,0,-8
18173,1,1,120,1212,1092
18174,0,0,18,0,-18
18175,0,0,103,0,-103
18176,1,1,325,1339,1014
18177,1,0,106,0,-106
18178,1,0,14,0,-14
18179,0,0,81,0,-81
18180,1,0,2,0,-2
18181,1,0,60,0,-60
18182,1,0,95,0,-95
18183,1,0,18,0,-18
18184,1,1,115,1497,1382
18185,0,0,66,0,-66
18186,1,1,500,1593,1093
18187,1,0,51,0,-51
18188,1,0,8,0,-8
18189,1,1,235,1485,1250
18190,1,0,114,0,-114
18191,1,0,8,0,-8
18192,1,1,110,1554,1444
18193,0,0,15,0,-15
18194,1,0,100,0,-100
18195,1,1,372,1341,969
18196,0,0,17,0,-17
18197,1,1,353,1238,885
18198,1,1,888,1399,511
18199,0,0,42,0,-42
18200,1,1,903,1386,483
18201,0,0,27,0,-27
18202,0,0,1,0,-1
18203,0,0,111,0,-111
18204,1,1,365,1209,844
18205,0,0,127,0,-127
18206,1,1,506,1223,717
18207,1,1,109,1967,1858
18208,1,0,9,0,-9
18209,0,0,20,0,-20
18210,1,1,702,1213,511
18211,0,0,55,0,-55
18212,1,1,71,1285,1214
18213,1,0,45,0,-45
18214,1,1,1046,1542,496
18215,1,1,83,1256,1173
18216,0,0,51,0,-51
18217,1,0,46,0,-46
18218,1,0,31,0,-31
18219,1,0,3,0,-3
18220,0,0,3,0,-3
18221,1,1,105,1221,1116
18222,1,1,1082,1404,322
18223,1,1,728,1221,493
18224,1,0,77,0,-77
18225,0,0,23,0,-23
18226,1,0,24,0,-24
18227,1,1,481,2121,1640
18228,1,0,47,0,-47
18229,1,1,1599,1360,-239
18230,1,1,100,1234,1134
18231,1,0,443,0,-443
18232,0,0,43,0,-43
18233,0,0,75,0,-75
18234,0,0,10,0,-10
18235,1,0,28,0,-28
18236,1,1,719,1203,484
18237,1,1,43,1809,1766
18238,0,0,44,0,-44
18239,0,0,111,0,-111
18240,0,0,6,0,-6
18241,1,1,196,2106,1910
18242,1,0,84,0,-84
18243,0,0,51,0,-51
18244,0,0,17,0,-17
18245,0,0,54,0,-54
18246,1,1,274,1358,1084
18247,1,1,921,1582,661
18248,1,1,524,1449,925
18249,0,0,0,0,0
18250,1,0,20,0,-20
18251,1,1,218,1565,1347
18252,0,0,121,0,-121
18253,0,0,118,0,-118
18254,0,0,147,0,-147
18255,1,1,1096,1402,306
18256,1,0,205,0,-205
18257,1,0,162,0,-162
18258,1,1,532,1377,845
18259,0,0,135,0,-135
18260,0,0,81,0,-81
18261,0,0,23,0,-23
18262,1,1,501,1647,1146
18263,0,0,12,0,-12
18264,1,1,126,1274,1148
18265,0,0,5,0,-5
18266,1,0,37,0,-37
18267,1,0,2,0,-2
18268,0,0,3,0,-3
18269,1,0,115,0,-115
18270,0,0,95,0,-95
18271,1,1,392,1281,889
18272,1,1,696,1594,898
18273,0,0,1,0,-1
18274,0,0,3,0,-3
18275,0,0,78,0,-78
18276,1,1,35,2208,2173
18277,0,0,6,0,-6
18278,1,0,13,0,-13
18279,1,0,91,0,-91
18280,0,0,45,0,-45
18281,0,0,32,0,-32
18282,0,0,46,0,-46
18283,1,0,18,0,-18
18284,0,0,191,0,-191
18285,1,1,696,1359,663
18286,1,0,21,0,-21
18287,0,0,76,0,-76
18288,1,1,897,1269,372
18289,0,0,4,0,-4
18290,1,1,708,1492,784
18291,0,0,11,0,-11
18292,1,1,115,1977,1862
18293,0,0,6,0,-6
18294,1,1,129,1366,1237
18295,0,0,11,0,-11
18296,0,0,9,0,-9
18297,0,0,2,0,-2
18298,1,0,47,0,-47
18299,0,0,62,0,-62
18300,1,0,8,0,-8
18301,0,0,20,0,-20
18302,1,1,2279,1549,-730
18303,0,0,14,0,-14
18304,1,0,2,0,-2
18305,1,0,42,0,-42
18306,1,1,61,1332,1271
18307,1,1,160,1248,1088
18308,0,0,29,0,-29
18309,1,1,1469,1211,-258
18310,1,0,18,0,-18
18311,0,0,84,0,-84
18312,1,1,57,7201,7144
18313,1,1,90,1324,1234
18314,1,1,1115,1344,229
18315,1,1,225,1247,1022
18316,1,0,57,0,-57
18317,1,1,274,1286,1012
18318,0,0,147,0,-147
18319,1,1,126,2333,2207
18320,0,0,8,0,-8
18321,1,0,59,0,-59
18322,0,0,15,0,-15
18323,1,1,412,1611,1199
18324,0,0,25,0,-25
18325,1,1,307,2117,1810
18326,0,0,21,0,-21
18327,0,0,51,0,-51
18328,1,0,26,0,-26
18329,0,0,35,0,-35
18330,0,0,54,0,-54
18331,1,0,16,0,-16
18332,0,0,7,0,-7
18333,1,0,50,0,-50
18334,1,0,106,0,-106
18335,1,1,451,1361,910
18336,1,1,664,1522,858
18337,0,0,37,0,-37
18338,0,0,1,0,-1
18339,0,0,5,0,-5
18340,1,0,23,0,-23
18341,1,1,468,1681,1213
18342,0,0,23,0,-23
18343,0,0,26,0,-26
18344,0,0,60,0,-60
18345,1,0,4,0,-4
18346,0,0,149,0,-149
18347,0,0,95,0,-95
18348,0,0,90,0,-90
18349,0,0,18,0,-18
18350,1,0,70,0,-70
18351,1,1,2456,1226,-1230
18352,1,0,14,0,-14
18353,0,0,44,0,-44
18354,1,0,127,0,-127
18355,0,0,15,0,-15
18356,0,0,180,0,-180
18357,0,0,11,0,-11
18358,1,0,137,0,-137
18359,1,0,99,0,-99
18360,1,1,387,1611,1224
18361,1,0,88,0,-88
18362,1,1,267,1474,1207
18363,1,0,35,0,-35
18364,1,1,1356,1263,-93
18365,1,1,34,1791,1757
18366,0,0,9,0,-9
18367,0,0,62,0,-62
18368,0,0,325,0,-325
18369,0,0,12,0,-12
18370,1,1,476,1294,818
18371,0,0,203,0,-203
18372,1,0,13,0,-13
18373,0,0,37,0,-37
18374,1,0,17,0,-17
18375,1,1,160,1804,1644
18376,0,0,94,0,-94
18377,1,1,230,3137,2907
18378,1,0,45,0,-45
18379,0,0,202,0,-202
18380,1,1,28,1804,1776
18381,1,0,2,0,-2
18382,1,1,960,1393,433
18383,1,0,89,0,-89
18384,0,0,89,0,-89
18385,0,0,43,0,-43
18386,0,0,8,0,-8
18387,0,0,114,0,-114
18388,1,1,289,1486,1197
18389,0,0,99,0,-99
18390,1,0,109,0,-109
18391,0,0,131,0,-131
18392,1,0,45,0,-45
18393,1,0,15,0,-15
18394,0,0,21,0,-21
18395,1,1,898,1244,346
18396,0,0,36,0,-36
18397,1,1,1393,1418,25
18398,0,0,35,0,-35
18399,0,0,105,0,-105
18400,1,1,1191,1213,22
18401,0,0,152,0,-152
18402,1,1,167,1317,1150
18403,0,0,2,0,-2
18404,1,0,42,0,-42
18405,0,0,14,0,-14
18406,1,0,100,0,-100
18407,0,0,39,0,-39
18408,0,0,0,0,0
18409,0,0,43,0,-43
18410,1,1,605,1652,1047
18411,1,0,84,0,-84
18412,1,1,1291,1667,376
18413,0,0,51,0,-51
18414,0,0,11,0,-11
18415,1,0,53,0,-53
18416,1,0,7,0,-7
18417,1,0,13,0,-13
18418,1,0,20,0,-20
18419,0,0,10,0,-10
18420,1,0,84,0,-84
18421,1,0,10,0,-10
18422,1,1,368,1253,885
18423,0,0,19,0,-19
18424,1,0,31,0,-31
18425,1,0,83,0,-83
18426,0,0,28,0,-28
18427,1,0,24,0,-24
18428,0,0,30,0,-30
18429,0,0,23,0,-23
18430,1,1,476,1856,1380
18431,0,0,68,0,-68
18432,0,0,30,0,-30
18433,0,0,37,0,-37
18434,1,1,56,1288,1232
18435,1,0,69,0,-69
18436,0,0,12,0,-12
18437,1,1,833,1569,736
18438,1,1,232,1493,1261
18439,1,1,15,1338,1323
18440,0,0,31,0,-31
18441,0,0,20,0,-20
18442,1,1,700,1779,1079
18443,1,0,99,0,-99
18444,1,0,44,0,-44
18445,1,0,29,0,-29
18446,1,1,74,1211,1137
18447,1,0,12,0,-12
18448,1,1,334,1275,941
18449,1,0,27,0,-27
18450,1,0,4,0,-4
18451,1,1,221,1353,1132
18452,1,0,34,0,-34
18453,1,1,860,1292,432
18454,0,0,35,0,-35
18455,1,0,53,0,-53
18456,0,0,5,0,-5
18457,1,0,141,0,-141
18458,0,0,13,0,-13
18459,1,1,32,1289,1257
18460,1,0,11,0,-11
18461,0,0,92,0,-92
18462,1,0,14,0,-14
18463,0,0,23,0,-23
18464,1,0,74,0,-74
18465,1,1,838,1921,1083
18466,1,0,33,0,-33
18467,1,0,27,0,-27
18468,0,0,77,0,-77
18469,1,1,616,1342,726
18470,1,0,13,0,-13
18471,0,0,29,0,-29
18472,1,0,63,0,-63
18473,1,1,480,1202,722
18474,0,0,29,0,-29
18475,0,0,70,0,-70
18476,1,0,27,0,-27
18477,0,0,61,0,-61
18478,1,1,22,1883,1861
18479,1,0,0,0,0
18480,0,0,69,0,-69
18481,0,0,61,0,-61
18482,0,0,3,0,-3
18483,1,0,133,0,-133
18484,1,1,389,1205,816
18485,0,0,82,0,-82
18486,1,0,41,0,-41
18487,1,1,406,1325,919
18488,1,0,12,0,-12
18489,1,0,47,0,-47
18490,1,1,477,2590,2113
18491,0,0,45,0,-45
18492,0,0,31,0,-31
18493,1,0,5,0,-5
18494,1,0,39,0,-39
18495,1,1,214,1686,1472
18496,1,0,8,0,-8
18497,0,0,142,0,-142
18498,0,0,31,0,-31
18499,0,0,31,0,-31
18500,0,0,43,0,-43
18501,0,0,43,0,-43
18502,1,1,933,1462,529
18503,1,1,625,1938,1313
18504,1,0,38,0,-38
18505,0,0,14,0,-14
18506,1,0,23,0,-23
18507,1,1,1541,1279,-262
18508,0,0,40,0,-40
18509,1,1,1211,1203,-8
18510,1,1,230,1256,1026
18511,1,0,68,0,-68
18512,1,0,164,0,-164
18513,1,1,77,1975,1898
18514,1,1,652,1491,839
18515,1,1,679,1751,1072
18516,0,0,48,0,-48
18517,1,1,573,2370,1797
18518,1,1,215,1579,1364
18519,0,0,20,0,-20
18520,0,0,58,0,-58
18521,0,0,143,0,-143
18522,1,0,12,0,-12
18523,1,1,811,1919,1108
18524,1,1,992,1296,304
18525,1,1,154,1242,1088
18526,1,1,22,1716,1694
18527,1,0,44,0,-44
18528,1,0,191,0,-191
18529,0,0,88,0,-88
18530,0,0,33,0,-33
18531,0,0,210,0,-210
18532,1,1,992,1326,334
18533,0,0,76,0,-76
18534,1,0,32,0,-32
18535,1,0,13,0,-13
18536,1,0,10,0,-10
18537,0,0,26,0,-26
18538,1,0,26,0,-26
18539,0,0,13,0,-13
18540,0,0,58,0,-58
18541,0,0,20,0,-20
18542,1,1,337,1251,914
18543,1,1,443,1223,780
18544,0,0,29,0,-29
18545,0,0,20,0,-20
18546,1,0,24,0,-24
18547,1,0,34,0,-34
18548,1,0,24,0,-24
18549,0,0,15,0,-15
18550,1,1,869,1749,880
18551,1,1,1084,1712,628
18552,1,0,17,0,-17
18553,0,0,195,0,-195
18554,0,0,152,0,-152
18555,1,1,517,2164,1647
18556,1,0,59,0,-59
18557,1,0,36,0,-36
18558,0,0,3,0,-3
18559,0,0,137,0,-137
18560,1,0,105,0,-105
18561,1,0,19,0,-19
18562,0,0,111,0,-111
18563,0,0,15,0,-15
18564,1,0,24,0,-24
18565,1,1,183,1294,1111
18566,0,0,56,0,-56
18567,0,0,16,0,-16
18568,0,0,227,0,-227
18569,0,0,58,0,-58
18570,1,1,417,1656,1239
18571,1,1,489,1387,898
18572,0,0,25,0,-25
18573,0,0,49,0,-49
18574,0,0,41,0,-41
18575,1,0,114,0,-114
18576,0,0,53,0,-53
18577,1,1,265,1459,1194
18578,1,1,448,1531,1083
18579,1,1,119,1291,1172
18580,1,0,1,0,-1
18581,0,0,87,0,-87
18582,1,1,68,1232,1164
18583,1,0,14,0,-14
18584,0,0,6,0,-6
18585,0,0,90,0,-90
18586,0,0,101,0,-101
18587,1,1,1578,1205,-373
18588,1,1,413,1206,793
18589,1,0,40,0,-40
18590,1,1,30,1544,1514
18591,1,0,1,0,-1
18592,1,0,46,0,-46
18593,0,0,20,0,-20
18594,0,0,21,0,-21
18595,0,0,50,0,-50
18596,0,0,105,0,-105
18597,1,1,141,1401,1260
18598,0,0,197,0,-197
18599,1,1,146,1576,1430
18600,1,0,27,0,-27
18601,1,1,206,1559,1353
18602,0,0,6,0,-6
18603,1,0,14,0,-14
18604,0,0,46,0,-46
18605,1,0,54,0,-54
18606,1,1,197,1661,1464
18607,1,1,183,1503,1320
18608,0,0,40,0,-40
18609,1,1,286,1467,1181
18610,0,0,1,0,-1
18611,0,0,7,0,-7
18612,1,0,66,0,-66
18613,0,0,86,0,-86
18614,1,0,20,0,-20
18615,1,1,162,1474,1312
18616,1,1,1023,1457,434
18617,1,0,69,0,-69
18618,0,0,46,0,-46
18619,1,0,5,0,-5
18620,1,0,19,0,-19
18621,0,0,11,0,-11
18622,1,0,59,0,-59
18623,1,0,13,0,-13
18624,0,0,15,0,-15
18625,0,0,13,0,-13
18626,0,0,2,0,-2
18627,1,0,46,0,-46
18628,1,1,231,2091,1860
18629,1,1,642,1413,771
18630,0,0,24,0,-24
18631,0,0,92,0,-92
18632,0,0,19,0,-19
18633,0,0,0,0,0
18634,0,0,52,0,-52
18635,1,0,6,0,-6
18636,1,0,28,0,-28
18637,0,0,2,0,-2
18638,0,0,107,0,-107
18639,0,0,38,0,-38
18640,0,0,47,0,-47
18641,0,0,31,0,-31
18642,1,0,10,0,-10
18643,1,1,419,1280,861
18644,0,0,44,0,-44
18645,0,0,2,0,-2
18646,1,0,19,0,-19
18647,1,0,83,0,-83
18648,0,0,32,0,-32
18649,0,0,28,0,-28
18650,0,0,100,0,-100
18651,0,0,38,0,-38
18652,0,0,7,0,-7
18653,1,0,272,0,-272
18654,0,0,25,0,-25
18655,0,0,25,0,-25
18656,1,1,366,1487,1121
18657,1,0,34,0,-34
18658,1,0,84,0,-84
18659,1,1,141,1356,1215
18660,0,0,11,0,-11
18661,1,1,836,1617,781
18662,1,1,144,1670,1526
18663,1,1,605,1344,739
18664,0,0,16,0,-16
18665,0,0,24,0,-24
18666,1,0,13,0,-13
18667,1,0,6,0,-6
18668,1,1,1136,1684,548
18669,1,1,167,1328,1161
18670,1,0,2,0,-2
18671,0,0,111,0,-111
18672,0,0,84,0,-84
18673,1,1,470,1638,1168
18674,0,0,24,0,-24
18675,1,1,1136,1580,444
18676,0,0,3,0,-3
18677,1,1,163,1268,1105
18678,1,1,1461,1407,-54
18679,1,0,18,0,-18
18680,1,1,193,1384,1191
18681,0,0,66,0,-66
18682,0,0,196,0,-196
18683,0,0,51,0,-51
18684,1,1,1434,1249,-185
18685,0,0,0,0,0
18686,1,0,250,0,-250
18687,0,0,20,0,-20
18688,1,1,466,1301,835
18689,1,1,1031,1241,210
18690,1,0,14,0,-14
18691,1,0,9,0,-9
18692,0,0,90,0,-90
18693,1,0,5,0,-5
18694,0,0,2,0,-2
18695,0,0,10,0,-10
18696,1,0,84,0,-84
18697,1,0,43,0,-43
18698,0,0,30,0,-30
18699,1,1,202,1336,1134
18700,0,0,76,0,-76
18701,1,1,292,2979,2687
18702,0,0,13,0,-13
18703,0,0,19,0,-19
18704,1,1,435,1708,1273
18705,0,0,6,0,-6
18706,1,0,43,0,-43
18707,1,1,533,2657,2124
18708,1,1,33,1623,1590
18709,1,0,47,0,-47
18710,0,0,15,0,-15
18711,1,0,60,0,-60
18712,0,0,83,0,-83
18713,1,0,10,0,-10
18714,1,0,26,0,-26
18715,0,0,38,0,-38
18716,1,1,123,1684,1561
18717,0,0,3,0,-3
18718,0,0,3,0,-3
18719,1,0,58,0,-58
18720,1,1,641,1975,1334
18721,0,0,5,0,-5
18722,0,0,72,0,-72
18723,1,0,26,0,-26
18724,1,1,91,1347,1256
18725,1,0,50,0,-50
18726,1,1,600,1210,610
18727,0,0,25,0,-25
18728,0,0,11,0,-11
18729,0,0,9,0,-9
18730,1,1,128,1584,1456
18731,0,0,113,0,-113
18732,1,0,28,0,-28
18733,0,0,70,0,-70
18734,1,1,337,1445,1108
18735,0,0,40,0,-40
18736,1,1,181,1450,1269
18737,1,0,64,0,-64
18738,1,1,88,1951,1863
18739,0,0,30,0,-30
18740,0,0,23,0,-23
18741,1,1,1060,1219,159
18742,1,0,44,0,-44
18743,1,0,3,0,-3
18744,1,0,57,0,-57
18745,1,1,655,1264,609
18746,1,0,3,0,-3
18747,1,1,235,1644,1409
18748,0,0,43,0,-43
18749,1,1,890,1669,779
18750,1,0,4,0,-4
18751,1,1,531,1558,1027
18752,1,1,182,1274,1092
18753,1,1,207,1212,1005
18754,0,0,46,0,-46
18755,0,0,2,0,-2
18756,0,0,1,0,-1
18757,0,0,40,0,-40
18758,1,1,165,1428,1263
18759,1,1,1604,1205,-399
18760,0,0,49,0,-49
18761,1,1,232,3341,3109
18762,0,0,173,0,-173
18763,0,0,32,0,-32
18764,1,1,495,1201,706
18765,1,0,8,0,-8
18766,1,1,1100,1640,540
18767,1,0,31,0,-31
18768,1,0,3,0,-3
18769,1,1,215,1450,1235
18770,1,1,602,4430,3828
18771,1,1,261,1824,1563
18772,0,0,93,0,-93
18773,1,1,240,1255,1015
18774,1,0,41,0,-41
18775,1,0,6,0,-6
18776,1,0,20,0,-20
18777,0,0,65,0,-65
18778,1,1,150,1429,1279
18779,1,1,155,1720,1565
18780,0,0,39,0,-39
18781,0,0,32,0,-32
18782,1,0,72,0,-72
18783,0,0,109,0,-109
18784,0,0,62,0,-62
18785,0,0,160,0,-160
18786,1,0,85,0,-85
18787,0,0,8,0,-8
18788,1,0,50,0,-50
18789,1,0,86,0,-86
18790,0,0,3,0,-3
18791,1,0,25,0,-25
18792,0,0,61,0,-61
18793,1,0,10,0,-10
18794,1,1,156,1468,1312
18795,1,1,190,1280,1090
18796,1,1,139,1496,1357
18797,0,0,21,0,-21
18798,0,0,10,0,-10
18799,0,0,57,0,-57
18800,0,0,76,0,-76
18801,0,0,9,0,-9
18802,0,0,0,0,0
18803,0,0,63,0,-63
18804,1,1,490,1577,1087
18805,0,0,11,0,-11
18806,1,0,11,0,-11
18807,0,0,49,0,-49
18808,0,0,20,0,-20
18809,1,0,32,0,-32
18810,1,0,117,0,-117
18811,1,0,0,0,0
18812,0,0,11,0,-11
18813,0,0,46,0,-46
18814,0,0,172,0,-172
18815,0,0,43,0,-43
18816,1,1,802,1294,492
18817,1,0,16,0,-16
18818,1,1,331,1435,1104
18819,0,0,5,0,-5
18820,1,0,72,0,-72
18821,1,0,29,0,-29
18822,1,1,164,1245,1081
18823,0,0,18,0,-18
18824,0,0,31,0,-31
18825,0,0,68,0,-68
18826,0,0,33,0,-33
18827,1,0,1,0,-1
18828,1,1,149,2260,2111
18829,0,0,64,0,-64
18830,1,0,129,0,-129
18831,1,1,233,2149,1916
18832,1,1,960,1228,268
18833,0,0,26,0,-26
18834,1,0,4,0,-4
18835,0,0,19,0,-19
18836,1,0,25,0,-25
18837,0,0,53,0,-53
18838,1,1,971,1649,678
18839,0,0,78,0,-78
18840,0,0,153,0,-153
18841,1,0,61,0,-61
18842,1,1,1392,1364,-28
18843,1,0,21,0,-21
18844,1,1,16,1526,1510
18845,1,0,46,0,-46
18846,1,0,364,0,-364
18847,1,0,73,0,-73
18848,0,0,16,0,-16
18849,1,0,15,0,-15
18850,1,1,168,1410,1242
18851,0,0,63,0,-63
18852,0,0,86,0,-86
18853,0,0,93,0,-93
18854,0,0,48,0,-48
18855,1,1,1141,1467,326
18856,1,0,63,0,-63
18857,1,0,38,0,-38
18858,0,0,111,0,-111
18859,0,0,52,0,-52
18860,1,0,79,0,-79
18861,0,0,15,0,-15
18862,1,0,13,0,-13
18863,0,0,137,0,-137
18864,0,0,12,0,-12
18865,1,1,696,1820,1124
18866,0,0,90,0,-90
18867,1,0,3,0,-3
18868,0,0,58,0,-58
18869,1,1,660,2106,1446
18870,0,0,0,0,0
18871,1,1,432,1522,1090
18872,1,0,47,0,-47
18873,0,0,14,0,-14
18874,1,0,160,0,-160
18875,1,0,142,0,-142
18876,0,0,4,0,-4
18877,1,0,23,0,-23
18878,1,0,11,0,-11
18879,1,0,48,0,-48
18880,1,0,57,0,-57
18881,1,1,322,1502,1180
18882,0,0,21,0,-21
18883,1,0,27,0,-27
18884,1,0,77,0,-77
18885,1,0,8,0,-8
18886,0,0,89,0,-89
18887,0,0,36,0,-36
18888,1,0,74,0,-74
18889,1,0,126,0,-126
18890,1,1,672,1301,629
18891,1,0,95,0,-95
18892,0,0,34,0,-34
18893,0,0,40,0,-40
18894,0,0,28,0,-28
18895,1,1,140,1431,1291
18896,1,0,56,0,-56
18897,1,0,31,0,-31
18898,0,0,86,0,-86
18899,1,0,30,0,-30
18900,1,1,377,1228,851
18901,1,1,37,1936,1899
18902,1,1,305,1387,1082
18903,0,0,107,0,-107
18904,1,1,1752,1289,-463
18905,1,1,640,1326,686
18906,1,0,10,0,-10
18907,1,0,85,0,-85
18908,1,0,64,0,-64
18909,0,0,56,0,-56
18910,1,0,8,0,-8
18911,1,0,24,0,-24
18912,1,1,355,1577,1222
18913,0,0,66,0,-66
18914,0,0,25,0,-25
18915,1,0,13,0,-13
18916,1,1,1496,1618,122
18917,1,1,100,1343,1243
18918,1,0,10,0,-10
18919,1,1,371,1200,829
18920,1,0,72,0,-72
18921,0,0,69,0,-69
18922,1,0,5,0,-5
18923,0,0,44,0,-44
18924,1,1,1374,1282,-92
18925,1,0,10,0,-10
18926,1,0,67,0,-67
18927,1,1,63,1444,1381
18928,1,0,85,0,-85
18929,1,0,30,0,-30
18930,0,0,14,0,-14
18931,1,1,862,1366,504
18932,1,0,13,0,-13
18933,1,0,17,0,-17
18934,1,1,397,1201,804
18935,0,0,28,0,-28
18936,1,1,1502,1403,-99
18937,1,1,2379,1416,-963
18938,1,0,3,0,-3
18939,1,0,1,0,-1
18940,1,0,36,0,-36
18941,1,0,33,0,-33
18942,1,1,360,1229,869
18943,1,0,18,0,-18
18944,1,1,594,3521,2927
18945,1,0,34,0,-34
18946,1,1,694,1277,583
18947,1,1,86,1435,1349
18948,0,0,57,0,-57
18949,0,0,46,0,-46
18950,0,0,38,0,-38
18951,1,1,1147,1472,325
18952,1,0,50,0,-50
18953,1,1,1946,2024,78
18954,0,0,48,0,-48
18955,0,0,180,0,-180
18956,1,0,18,0,-18
18957,1,1,852,1211,359
18958,1,1,253,1291,1038
18959,1,0,211,0,-211
18960,0,0,82,0,-82
18961,1,0,12,0,-12
18962,0,0,15,0,-15
18963,1,0,10,0,-10
18964,0,0,29,0,-29
18965,0,0,34,0,-34
18966,0,0,10,0,-10
18967,0,0,30,0,-30
18968,0,0,92,0,-92
18969,1,0,31,0,-31
18970,0,0,168,0,-168
18971,1,1,188,1214,1026
18972,1,0,99,0,-99
18973,0,0,26,0,-26
18974,0,0,3,0,-3
18975,1,1,128,1858,1730
18976,1,1,1055,2273,1218
18977,0,0,32,0,-32
18978,0,0,82,0,-82
18979,0,0,42,0,-42
18980,1,0,34,0,-34
18981,1,1,491,1313,822
18982,0,0,12,0,-12
18983,1,0,60,0,-60
18984,1,1,156,1281,1125
18985,1,1,119,1343,1224
18986,1,1,634,2069,1435
18987,0,0,54,0,-54
18988,1,0,4,0,-4
18989,1,1,130,1645,1515
18990,1,1,313,1211,898
18991,1,1,637,1378,741
18992,1,1,224,1888,1664
18993,1,1,268,1229,961
18994,1,0,246,0,-246
18995,1,0,54,0,-54
18996,1,1,1212,1700,488
18997,1,0,81,0,-81
18998,0,0,25,0,-25
18999,1,0,68,0,-68
19000,1,1,478,1358,880
19001,1,1,341,1849,1508
19002,0,0,30,0,-30
19003,1,0,21,0,-21
19004,0,0,231,0,-231
19005,1,1,558,1941,1383
19006,1,1,171,1682,1511
19007,1,0,3,0,-3
19008,1,0,14,0,-14
19009,1,1,149,1356,1207
19010,0,0,83,0,-83
19011,0,0,20,0,-20
19012,1,1,1564,1578,14
19013,0,0,24,0,-24
19014,0,0,3,0,-3
19015,1,1,845,1471,626
19016,1,1,444,1567,1123
19017,1,1,302,1318,1016
19018,1,0,15,0,-15
19019,1,0,8,0,-8
19020,1,1,1301,1558,257
19021,0,0,16,0,-16
19022,1,0,12,0,-12
19023,1,0,76,0,-76
19024,1,1,1027,2637,1610
19025,1,0,18,0,-18
19026,0,0,55,0,-55
19027,0,0,26,0,-26
19028,0,0,39,0,-39
19029,1,0,71,0,-71
19030,0,0,18,0,-18
19031,1,1,707,1310,603
19032,1,0,23,0,-23
19033,0,0,243,0,-243
19034,0,0,8,0,-8
19035,1,0,113,0,-113
19036,1,1,462,1445,983
19037,0,0,133,0,-133
19038,0,0,178,0,-178
19039,0,0,2,0,-2
19040,1,1,1113,1222,109
19041,1,1,125,1445,1320
19042,1,1,490,1765,1275
19043,0,0,39,0,-39
19044,1,1,764,1273,509
19045,1,1,264,1304,1040
19046,0,0,8,0,-8
19047,1,1,762,2399,1637
19048,1,1,352,1269,917
19049,1,0,81,0,-81
19050,1,0,65,0,-65
19051,1,1,817,1466,649
19052,0,0,18,0,-18
19053,1,1,891,1433,542
19054,0,0,32,0,-32
19055,1,0,3,0,-3
19056,1,0,17,0,-17
19057,1,0,91,0,-91
19058,1,0,38,0,-38
19059,0,0,32,0,-32
19060,0,0,91,0,-91
19061,1,0,11,0,-11
19062,0,0,141,0,-141
19063,1,1,505,2195,1690
19064,0,0,55,0,-55
19065,1,0,20,0,-20
19066,0,0,66,0,-66
19067,1,1,355,1796,1441
19068,1,1,487,2313,1826
19069,1,1,392,1508,1116
19070,1,1,479,1432,953
19071,1,0,62,0,-62
19072,0,0,4,0,-4
19073,1,0,8,0,-8
19074,1,0,4,0,-4
19075,0,0,16,0,-16
19076,0,0,19,0,-19
19077,0,0,64,0,-64
19078,1,1,400,1243,843
19079,1,0,6,0,-6
19080,0,0,73,0,-73
19081,1,0,51,0,-51
19082,1,0,126,0,-126
19083,0,0,14,0,-14
19084,1,0,16,0,-16
19085,0,0,54,0,-54
19086,1,0,10,0,-10
19087,0,0,58,0,-58
19088,1,1,120,1301,1181
19089,0,0,1,0,-1
19090,1,0,140,0,-140
19091,1,1,927,1913,986
19092,1,0,19,0,-19
19093,1,1,399,2091,1692
19094,0,0,11,0,-11
19095,1,1,475,1295,820
19096,1,1,909,1412,503
19097,0,0,57,0,-57
19098,1,1,1342,1594,252
19099,0,0,74,0,-74
19100,0,0,7,0,-7
19101,0,0,35,0,-35
19102,1,1,581,1341,760
19103,1,0,35,0,-35
19104,0,0,17,0,-17
19105,1,1,304,2015,1711
19106,1,0,44,0,-44
19107,1,1,594,1541,947
19108,1,1,475,1251,776
19109,1,1,186,1205,1019
19110,1,1,158,2130,1972
19111,1,1,1130,1575,445
19112,0,0,10,0,-10
19113,1,1,461,2450,1989
19114,1,0,21,0,-21
19115,0,0,6,0,-6
19116,0,0,11,0,-11
19117,1,0,18,0,-18
19118,1,1,561,1826,1265
19119,1,1,217,1444,1227
19120,1,1,115,1333,1218
19121,0,0,18,0,-18
19122,0,0,47,0,-47
19123,0,0,98,0,-98
19124,1,0,3,0,-3
19125,0,0,56,0,-56
19126,0,0,22,0,-22
19127,1,0,7,0,-7
19128,1,0,4,0,-4
19129,1,1,70,1303,1233
19130,1,0,45,0,-45
19131,1,1,1173,1730,557
19132,1,1,77,1557,1480
19133,1,0,9,0,-9
19134,0,0,214,0,-214
19135,0,0,11,0,-11
19136,0,0,38,0,-38
19137,1,0,16,0,-16
19138,0,0,13,0,-13
19139,0,0,20,0,-20
19140,1,0,60,0,-60
19141,1,0,44,0,-44
19142,1,1,64,4663,4599
19143,1,0,138,0,-138
19144,0,0,18,0,-18
19145,0,0,24,0,-24
19146,0,0,146,0,-146
19147,0,0,39,0,-39
19148,1,1,1115,1858,743
19149,1,1,403,1376,973
19150,1,0,61,0,-61
19151,1,0,13,0,-13
19152,0,0,193,0,-193
19153,0,0,30,0,-30
19154,0,0,103,0,-103
19155,0,0,134,0,-134
19156,1,1,30,1506,1476
19157,0,0,17,0,-17
19158,1,1,274,1701,1427
19159,1,1,643,1356,713
19160,0,0,79,0,-79
19161,1,0,9,0,-9
19162,0,0,48,0,-48
19163,0,0,99,0,-99
19164,0,0,3,0,-3
19165,0,0,14,0,-14
19166,1,0,37,0,-37
19167,0,0,2,0,-2
19168,0,0,80,0,-80
19169,1,1,771,1389,618
19170,0,0,8,0,-8
19171,0,0,7,0,-7
19172,0,0,59,0,-59
19173,1,1,1244,1297,53
19174,0,0,77,0,-77
19175,1,1,66,1744,1678
19176,1,1,173,1278,1105
19177,1,0,54,0,-54
19178,0,0,11,0,-11
19179,0,0,24,0,-24
19180,1,1,365,1276,911
19181,0,0,67,0,-67
19182,0,0,63,0,-63
19183,1,1,367,1518,1151
19184,0,0,49,0,-49
19185,1,1,934,1450,516
19186,1,0,57,0,-57
19187,1,1,351,2434,2083
19188,1,1,204,1360,1156
19189,1,0,25,0,-25
19190,0,0,50,0,-50
19191,0,0,34,0,-34
19192,0,0,117,0,-117
19193,1,1,676,1317,641
19194,1,1,747,1769,1022
19195,0,0,83,0,-83
19196,1,0,27,0,-27
19197,0,0,12,0,-12
19198,0,0,7,0,-7
19199,1,0,2,0,-2
19200,1,1,1168,1758,590
19201,1,0,26,0,-26
19202,0,0,54,0,-54
19203,1,0,7,0,-7
19204,0,0,87,0,-87
19205,0,0,4,0,-4
19206,1,1,560,1226,666
19207,0,0,97,0,-97
19208,1,1,435,1315,880
19209,0,0,28,0,-28
19210,0,0,52,0,-52
19211,0,0,97,0,-97
19212,1,1,354,1649,1295
19213,0,0,57,0,-57
19214,1,1,518,1250,732
19215,1,1,581,2008,1427
19216,1,1,148,1426,1278
19217,0,0,27,0,-27
19218,0,0,8,0,-8
19219,1,1,335,1293,958
19220,1,0,145,0,-145
19221,0,0,44,0,-44
19222,1,0,121,0,-121
19223,1,0,3,0,-3
19224,0,0,130,0,-130
19225,0,0,27,0,-27
19226,1,0,51,0,-51
19227,0,0,39,0,-39
19228,0,0,213,0,-213
19229,1,1,211,1246,1035
19230,1,0,71,0,-71
19231,0,0,8,0,-8
19232,1,1,338,1620,1282
19233,1,1,689,1669,980
19234,0,0,12,0,-12
19235,1,0,60,0,-60
19236,1,0,150,0,-150
19237,1,0,145,0,-145
19238,0,0,3,0,-3
19239,0,0,35,0,-35
19240,0,0,67,0,-67
19241,1,1,190,1991,1801
19242,0,0,38,0,-38
19243,0,0,24,0,-24
19244,1,0,49,0,-49
19245,1,0,32,0,-32
19246,0,0,38,0,-38
19247,0,0,25,0,-25
19248,0,0,38,0,-38
19249,1,1,36,1544,1508
19250,1,0,11,0,-11
19251,1,0,36,0,-36
19252,1,0,24,0,-24
19253,1,1,72,1298,1226
19254,0,0,180,0,-180
19255,1,0,81,0,-81
19256,0,0,51,0,-51
19257,0,0,209,0,-209
19258,0,0,15,0,-15
19259,1,0,127,0,-127
19260,1,0,12,0,-12
19261,0,0,97,0,-97
19262,0,0,20,0,-20
19263,1,0,0,0,0
19264,1,1,349,2139,1790
19265,1,1,330,1494,1164
19266,1,0,3,0,-3
19267,1,1,191,1351,1160
19268,1,0,80,0,-80
19269,1,1,131,1897,1766
19270,0,0,23,0,-23
19271,1,0,117,0,-117
19272,0,0,39,0,-39
19273,1,0,7,0,-7
19274,1,0,102,0,-102
19275,0,0,56,0,-56
19276,1,1,540,1287,747
19277,1,1,1251,1221,-30
19278,1,0,27,0,-27
19279,1,1,2110,1354,-756
19280,0,0,16,0,-16
19281,1,1,381,1648,1267
19282,0,0,31,0,-31
19283,1,0,70,0,-70
19284,1,0,124,0,-124
19285,1,0,21,0,-21
19286,0,0,31,0,-31
19287,0,0,62,0,-62
19288,0,0,14,0,-14
19289,0,0,160,0,-160
19290,1,1,957,1915,958
19291,1,1,541,1462,921
19292,1,0,21,0,-21
19293,0,0,50,0,-50
19294,1,1,261,1405,1144
19295,0,0,27,0,-27
19296,1,0,6,0,-6
19297,1,0,61,0,-61
19298,0,0,41,0,-41
19299,1,0,16,0,-16
19300,0,0,27,0,-27
19301,1,0,96,0,-96
19302,1,0,24,0,-24
19303,1,1,536,1231,695
19304,1,0,3,0,-3
19305,1,1,62,1433,1371
19306,1,0,7,0,-7
19307,0,0,78,0,-78
19308,1,1,999,1294,295
19309,0,0,18,0,-18
19310,1,0,36,0,-36
19311,1,1,85,2259,2174
19312,1,1,449,1292,843
19313,1,1,57,1292,1235
19314,1,0,104,0,-104
19315,0,0,48,0,-48
19316,1,1,965,1248,283
19317,1,0,31,0,-31
19318,1,0,181,0,-181
19319,1,0,176,0,-176
19320,1,1,291,2001,1710
19321,0,0,58,0,-58
19322,1,0,73,0,-73
19323,0,0,0,0,0
19324,0,0,20,0,-20
19325,1,1,1706,1997,291
19326,1,1,274,1797,1523
19327,0,0,75,0,-75
19328,1,0,52,0,-52
19329,0,0,87,0,-87
19330,0,0,37,0,-37
19331,0,0,60,0,-60
19332,1,0,24,0,-24
19333,1,1,2193,1317,-876
19334,0,0,76,0,-76
19335,1,1,687,3568,2881
19336,0,0,49,0,-49
19337,0,0,23,0,-23
19338,1,0,90,0,-90
19339,0,0,15,0,-15
19340,1,1,899,2554,1655
19341,1,1,451,3275,2824
19342,0,0,8,0,-8
19343,1,1,238,1830,1592
19344,1,0,18,0,-18
19345,0,0,6,0,-6
19346,0,0,0,0,0
19347,0,0,71,0,-71
19348,0,0,53,0,-53
19349,0,0,33,0,-33
19350,1,1,76,2890,2814
19351,0,0,10,0,-10
19352,0,0,74,0,-74
19353,1,1,863,2358,1495
19354,1,0,39,0,-39
19355,0,0,21,0,-21
19356,0,0,9,0,-9
19357,0,0,18,0,-18
19358,0,0,92,0,-92
19359,1,0,40,0,-40
19360,1,0,32,0,-32
19361,1,1,86,1379,1293
19362,0,0,38,0,-38
19363,1,0,77,0,-77
19364,0,0,13,0,-13
19365,1,0,25,0,-25
19366,0,0,53,0,-53
19367,0,0,19,0,-19
19368,1,0,54,0,-54
19369,1,1,210,2995,2785
19370,1,0,7,0,-7
19371,0,0,114,0,-114
19372,0,0,45,0,-45
19373,0,0,33,0,-33
19374,0,0,1,0,-1
19375,1,0,165,0,-165
19376,1,0,61,0,-61
19377,1,1,982,1367,385
19378,1,1,108,1630,1522
19379,1,1,360,1409,1049
19380,0,0,2,0,-2
19381,1,0,22,0,-22
19382,1,1,892,1287,395
19383,1,1,45,1491,1446
19384,0,0,20,0,-20
19385,0,0,34,0,-34
19386,1,1,442,2167,1725
19387,0,0,75,0,-75
19388,1,1,685,1435,750
19389,1,1,844,1621,777
19390,1,1,311,1719,1408
19391,1,0,24,0,-24
19392,0,0,87,0,-87
19393,1,1,447,1266,819
19394,1,0,0,0,0
19395,0,0,21,0,-21
19396,0,0,14,0,-14
19397,1,0,56,0,-56
19398,0,0,87,0,-87
19399,1,1,470,1794,1324
19400,0,0,11,0,-11
19401,0,0,62,0,-62
19402,1,1,595,1604,1009
19403,0,0,8,0,-8
19404,0,0,66,0,-66
19405,0,0,31,0,-31
19406,0,0,41,0,-41
19407,0,0,29,0,-29
19408,0,0,22,0,-22
19409,1,0,0,0,0
19410,1,0,53,0,-53
19411,1,0,11,0,-11
19412,1,0,4,0,-4
19413,1,0,12,0,-12
19414,0,0,31,0,-31
19415,1,1,965,1451,486
19416,0,0,77,0,-77
19417,1,0,106,0,-106
19418,1,0,1,0,-1
19419,1,0,13,0,-13
19420,1,1,442,1426,984
19421,1,0,34,0,-34
19422,0,0,75,0,-75
19423,1,1,100,1217,1117
19424,0,0,27,0,-27
19425,1,0,16,0,-16
19426,1,0,38,0,-38
19427,1,0,2,0,-2
19428,0,0,209,0,-209
19429,0,0,77,0,-77
19430,0,0,81,0,-81
19431,1,1,92,1205,1113
19432,0,0,13,0,-13
19433,0,0,74,0,-74
19434,0,0,55,0,-55
19435,1,1,77,1384,1307
19436,1,1,187,1253,1066
19437,1,1,1778,1669,-109
19438,1,0,11,0,-11
19439,0,0,14,0,-14
19440,0,0,62,0,-62
19441,1,1,43,1800,1757
19442,0,0,262,0,-262
19443,0,0,57,0,-57
19444,1,1,1063,1388,325
19445,1,1,81,1764,1683
19446,1,1,1185,1431,246
19447,1,1,204,1616,1412
19448,1,1,151,1663,1512
19449,1,1,617,1559,942
19450,1,1,62,1237,1175
19451,1,0,15,0,-15
19452,1,0,24,0,-24
19453,1,1,221,1393,1172
19454,0,0,89,0,-89
19455,1,0,42,0,-42
19456,1,1,295,1427,1132
19457,0,0,4,0,-4
19458,0,0,5,0,-5
19459,1,1,1881,2241,360
19460,0,0,47,0,-47
19461,1,1,246,1291,1045
19462,1,1,345,1450,1105
19463,0,0,22,0,-22
19464,1,0,39,0,-39
19465,1,1,44,1529,1485
19466,1,1,1520,1510,-10
19467,0,0,57,0,-57
19468,1,1,711,1571,860
19469,1,1,1197,1837,640
19470,0,0,4,0,-4
19471,1,0,22,0,-22
19472,1,0,121,0,-121
19473,0,0,107,0,-107
19474,1,1,48,1643,1595
19475,1,0,17,0,-17
19476,0,0,59,0,-59
19477,0,0,24,0,-24
19478,0,0,16,0,-16
19479,0,0,28,0,-28
19480,1,1,882,1442,560
19481,0,0,7,0,-7
19482,0,0,148,0,-148
19483,0,0,97,0,-97
19484,0,0,101,0,-101
19485,1,1,2066,1433,-633
19486,0,0,32,0,-32
19487,1,0,54,0,-54
19488,0,0,17,0,-17
19489,1,1,67,2386,2319
19490,1,1,1107,2253,1146
19491,0,0,83,0,-83
19492,1,1,1180,1635,455
19493,0,0,197,0,-197
19494,0,0,2,0,-2
19495,0,0,20,0,-20
19496,0,0,22,0,-22
19497,1,1,15,1454,1439
19498,1,1,836,1638,802
19499,0,0,35,0,-35
19500,0,0,22,0,-22
19501,1,0,218,0,-218
19502,0,0,20,0,-20
19503,1,0,2,0,-2
19504,0,0,77,0,-77
19505,1,1,948,1519,571
19506,1,1,702,1230,528
19507,1,0,47,0,-47
19508,1,0,48,0,-48
19509,1,0,48,0,-48
19510,0,0,19,0,-19
19511,1,1,67,1349,1282
19512,0,0,28,0,-28
19513,0,0,79,0,-79
19514,0,0,99,0,-99
19515,1,1,484,1246,762
19516,1,1,295,1279,984
19517,1,0,1,0,-1
19518,1,1,69,1406,1337
19519,0,0,6,0,-6
19520,0,0,42,0,-42
19521,0,0,5,0,-5
19522,0,0,63,0,-63
19523,1,0,0,0,0
19524,1,0,11,0,-11
19525,0,0,33,0,-33
19526,0,0,50,0,-50
19527,0,0,51,0,-51
19528,1,0,77,0,-77
19529,0,0,86,0,-86
19530,0,0,108,0,-108
19531,0,0,91,0,-91
19532,0,0,43,0,-43
19533,0,0,174,0,-174
19534,1,0,29,0,-29
19535,1,0,7,0,-7
19536,0,0,40,0,-40
19537,1,0,16,0,-16
19538,0,0,61,0,-61
19539,0,0,50,0,-50
19540,0,0,24,0,-24
19541,1,1,118,1489,1371
19542,1,0,21,0,-21
19543,0,0,268,0,-268
19544,0,0,47,0,-47
19545,1,0,0,0,0
19546,0,0,22,0,-22
19547,1,1,472,2954,2482
19548,1,0,55,0,-55
19549,0,0,23,0,-23
19550,1,0,8,0,-8
19551,1,0,70,0,-70
19552,1,0,109,0,-109
19553,1,1,1245,1544,299
19554,1,1,636,1445,809
19555,1,0,138,0,-138
19556,1,1,528,1250,722
19557,1,1,178,1325,1147
19558,1,0,54,0,-54
19559,1,1,1693,1623,-70
19560,0,0,27,0,-27
19561,0,0,52,0,-52
19562,1,1,140,2766,2626
19563,0,0,81,0,-81
19564,0,0,9,0,-9
19565,1,0,48,0,-48
19566,1,0,2,0,-2
19567,0,0,3,0,-3
19568,0,0,0,0,0
19569,0,0,19,0,-19
19570,1,0,8,0,-8
19571,1,1,1123,1336,213
19572,1,0,6,0,-6
19573,0,0,22,0,-22
19574,1,1,858,1561,703
19575,1,0,53,0,-53
19576,1,0,12,0,-12
19577,0,0,21,0,-21
19578,1,0,67,0,-67
19579,1,0,51,0,-51
19580,0,0,128,0,-128
19581,1,1,613,1239,626
19582,1,0,91,0,-91
19583,1,0,112,0,-112
19584,1,1,110,1610,1500
19585,1,1,621,1735,1114
19586,1,0,16,0,-16
19587,1,1,1214,2071,857
19588,1,1,124,1721,1597
19589,1,1,1548,1377,-171
19590,1,1,193,1545,1352
19591,1,1,45,1278,1233
19592,0,0,8,0,-8
19593,1,1,1079,1432,353
19594,1,0,89,0,-89
19595,1,0,37,0,-37
19596,0,0,19,0,-19
19597,1,1,777,1200,423
19598,0,0,0,0,0
19599,1,0,47,0,-47
19600,1,0,107,0,-107
19601,1,0,4,0,-4
19602,1,0,9,0,-9
19603,1,1,140,1253,1113
19604,0,0,51,0,-51
19605,1,0,74,0,-74
19606,0,0,60,0,-60
19607,1,1,219,1466,1247
19608,1,0,26,0,-26
19609,1,0,0,0,0
19610,0,0,53,0,-53
19611,1,1,348,1223,875
19612,0,0,56,0,-56
19613,1,1,344,1261,917
19614,1,1,1800,1209,-591
19615,1,1,219,1292,1073
19616,0,0,56,0,-56
19617,0,0,13,0,-13
19618,1,1,957,1891,934
19619,1,0,24,0,-24
19620,0,0,95,0,-95
19621,1,1,583,1457,874
19622,1,1,217,1298,1081
19623,1,1,576,1252,676
19624,1,0,16,0,-16
19625,0,0,8,0,-8
19626,1,0,36,0,-36
19627,1,1,70,1678,1608
19628,1,0,71,0,-71
19629,1,1,863,3574,2711
19630,1,1,351,1887,1536
19631,1,0,5,0,-5
19632,1,1,187,1763,1576
19633,1,0,21,0,-21
19634,1,0,48,0,-48
19635,0,0,92,0,-92
19636,1,0,40,0,-40
19637,1,1,877,2136,1259
19638,1,0,99,0,-99
19639,1,1,163,2042,1879
19640,1,1,49,2456,2407
19641,1,1,277,1908,1631
19642,1,0,48,0,-48
19643,1,0,32,0,-32
19644,0,0,32,0,-32
19645,0,0,57,0,-57
19646,0,0,95,0,-95
19647,1,1,179,1329,1150
19648,1,1,790,1291,501
19649,1,1,490,1419,929
19650,0,0,3,0,-3
19651,1,0,37,0,-37
19652,0,0,0,0,0
19653,1,1,125,1501,1376
19654,0,0,13,0,-13
19655,0,0,34,0,-34
19656,0,0,53,0,-53
19657,1,0,90,0,-90
19658,1,0,72,0,-72
19659,0,0,12,0,-12
19660,1,0,91,0,-91
19661,0,0,265,0,-265
19662,1,0,57,0,-57
19663,1,1,135,1348,1213
19664,1,1,855,1315,460
19665,1,1,819,1496,677
19666,0,0,6,0,-6
19667,0,0,4,0,-4
19668,0,0,14,0,-14
19669,1,1,93,1297,1204
19670,1,1,804,1463,659
19671,0,0,27,0,-27
19672,1,0,33,0,-33
19673,1,0,168,0,-168
19674,0,0,29,0,-29
19675,1,1,111,1729,1618
19676,0,0,7,0,-7
19677,0,0,78,0,-78
19678,1,1,255,1453,1198
19679,0,0,7,0,-7
19680,1,0,89,0,-89
19681,1,1,673,1219,546
19682,1,0,196,0,-196
19683,1,0,14,0,-14
19684,0,0,30,0,-30
19685,1,0,45,0,-45
19686,0,0,39,0,-39
19687,1,1,1360,1389,29
19688,0,0,7,0,-7
19689,1,0,47,0,-47
19690,0,0,25,0,-25
19691,1,1,633,1296,663
19692,0,0,27,0,-27
19693,0,0,13,0,-13
19694,0,0,20,0,-20
19695,1,1,210,1594,1384
19696,1,1,526,1421,895
19697,0,0,55,0,-55
19698,0,0,83,0,-83
19699,1,1,466,1212,746
19700,0,0,142,0,-142
19701,1,1,213,2006,1793
19702,1,1,228,1248,1020
19703,1,0,48,0,-48
19704,0,0,31,0,-31
19705,1,1,2077,1416,-661
19706,1,1,1175,2376,1201
19707,1,1,2767,1236,-1531
19708,1,1,983,1385,402
19709,0,0,18,0,-18
19710,0,0,1,0,-1
19711,1,0,2,0,-2
19712,1,0,111,0,-111
19713,1,0,140,0,-140
19714,0,0,49,0,-49
19715,1,1,890,1448,558
19716,0,0,47,0,-47
19717,1,1,172,1350,1178
19718,1,1,1084,1552,468
19719,0,0,98,0,-98
19720,1,0,45,0,-45
19721,1,0,12,0,-12
19722,0,0,7,0,-7
19723,0,0,0,0,0
19724,1,1,290,1316,1026
19725,1,1,663,1216,553
19726,1,1,453,1522,1069
19727,1,1,60,1610,1550
19728,1,0,19,0,-19
19729,0,0,6,0,-6
19730,0,0,95,0,-95
19731,0,0,68,0,-68
19732,1,1,1332,1292,-40
19733,0,0,18,0,-18
19734,1,1,1087,2862,1775
19735,1,0,99,0,-99
19736,0,0,28,0,-28
19737,0,0,3,0,-3
19738,0,0,20,0,-20
19739,1,0,54,0,-54
19740,1,1,27,4543,4516
19741,0,0,177,0,-177
19742,1,0,60,0,-60
19743,0,0,22,0,-22
19744,0,0,14,0,-14
19745,1,1,44,4706,4662
19746,0,0,33,0,-33
19747,1,0,115,0,-115
19748,1,0,28,0,-28
19749,1,1,284,1374,1090
19750,1,1,1646,1942,296
19751,1,0,236,0,-236
19752,1,0,16,0,-16
19753,1,1,398,1352,954
19754,0,0,62,0,-62
19755,1,1,407,1616,1209
19756,0,0,57,0,-57
19757,1,0,8,0,-8
19758,0,0,118,0,-118
19759,0,0,198,0,-198
19760,0,0,103,0,-103
19761,1,0,22,0,-22
19762,1,1,704,3660,2956
19763,1,0,69,0,-69
19764,0,0,3,0,-3
19765,1,1,104,1472,1368
19766,1,0,14,0,-14
19767,1,1,543,1258,715
19768,0,0,1,0,-1
19769,1,0,10,0,-10
19770,0,0,41,0,-41
19771,1,1,286,1964,1678
19772,0,0,30,0,-30
19773,1,0,79,0,-79
19774,1,1,905,1226,321
19775,0,0,14,0,-14
19776,1,1,187,1603,1416
19777,0,0,64,0,-64
19778,1,0,2,0,-2
19779,1,0,200,0,-200
19780,0,0,9,0,-9
19781,0,0,15,0,-15
19782,1,1,1244,1288,44
19783,0,0,12,0,-12
19784,1,0,8,0,-8
19785,1,1,466,1215,749
19786,0,0,141,0,-141
19787,0,0,4,0,-4
19788,0,0,51,0,-51
19789,0,0,203,0,-203
19790,1,1,855,1518,663
19791,1,1,863,1438,575
19792,1,0,91,0,-91
19793,1,0,169,0,-169
19794,1,0,90,0,-90
19795,0,0,79,0,-79
19796,1,1,205,1524,1319
19797,0,0,34,0,-34
19798,1,0,31,0,-31
19799,1,0,139,0,-139
19800,0,0,48,0,-48
19801,1,0,39,0,-39
19802,1,0,2,0,-2
19803,1,1,2295,1343,-952
19804,0,0,147,0,-147
19805,1,0,99,0,-99
19806,0,0,79,0,-79
19807,0,0,39,0,-39
19808,1,0,28,0,-28
19809,0,0,141,0,-141
19810,1,0,33,0,-33
19811,1,0,31,0,-31
19812,0,0,100,0,-100
19813,1,1,201,2316,2115
19814,0,0,5,0,-5
19815,1,0,73,0,-73
19816,0,0,197,0,-197
19817,1,1,812,1600,788
19818,1,1,299,1370,1071
19819,1,1,401,2117,1716
19820,1,0,58,0,-58
19821,1,1,726,1496,770
19822,1,1,122,1728,1606
19823,1,0,20,0,-20
19824,0,0,28,0,-28
19825,1,1,71,1382,1311
19826,1,0,213,0,-213
19827,0,0,8,0,-8
19828,1,1,1628,1416,-212
19829,0,0,10,0,-10
19830,1,1,253,1833,1580
19831,1,0,57,0,-57
19832,1,1,899,1269,370
19833,0,0,123,0,-123
19834,1,1,667,1371,704
19835,1,1,706,1287,581
19836,0,0,43,0,-43
19837,1,0,73,0,-73
19838,0,0,5,0,-5
19839,0,0,24,0,-24
19840,1,0,43,0,-43
19841,1,0,20,0,-20
19842,0,0,146,0,-146
19843,1,1,958,1240,282
19844,1,0,3,0,-3
19845,1,0,105,0,-105
19846,1,1,226,1215,989
19847,0,0,56,0,-56
19848,0,0,192,0,-192
19849,0,0,37,0,-37
19850,1,1,238,2740,2502
19851,0,0,49,0,-49
19852,0,0,41,0,-41
19853,1,1,160,1292,1132
19854,1,1,162,1466,1304
19855,0,0,15,0,-15
19856,0,0,32,0,-32
19857,1,1,1016,1394,378
19858,1,0,26,0,-26
19859,1,1,753,1458,705
19860,1,1,104,2246,2142
19861,1,1,159,1377,1218
19862,0,0,20,0,-20
19863,1,0,84,0,-84
19864,1,0,5,0,-5
19865,0,0,33,0,-33
19866,1,0,28,0,-28
19867,1,1,1355,1319,-36
19868,1,0,170,0,-170
19869,1,1,1524,1296,-228
19870,1,1,1472,1381,-91
19871,0,0,84,0,-84
19872,0,0,69,0,-69
19873,1,0,14,0,-14
19874,1,1,607,1531,924
19875,1,1,1064,1680,616
19876,0,0,13,0,-13
19877,1,1,1253,1305,52
19878,1,1,264,1369,1105
19879,0,0,152,0,-152
19880,1,1,544,1328,784
19881,1,0,24,0,-24
19882,1,1,346,1206,860
19883,0,0,58,0,-58
19884,1,0,37,0,-37
19885,0,0,24,0,-24
19886,0,0,31,0,-31
19887,1,0,85,0,-85
19888,1,1,206,1572,1366
19889,1,0,219,0,-219
19890,1,0,29,0,-29
19891,1,0,3,0,-3
19892,0,0,30,0,-30
19893,0,0,30,0,-30
19894,0,0,98,0,-98
19895,0,0,43,0,-43
19896,0,0,23,0,-23
19897,0,0,75,0,-75
19898,0,0,8,0,-8
19899,1,1,380,1318,938
19900,0,0,54,0,-54
19901,1,1,792,1389,597
19902,1,1,962,1317,355
19903,1,0,5,0,-5
19904,1,0,176,0,-176
19905,0,0,82,0,-82
19906,0,0,40,0,-40
19907,1,1,213,1855,1642
19908,1,0,113,0,-113
19909,1,0,46,0,-46
19910,1,0,91,0,-91
19911,0,0,55,0,-55
19912,1,1,894,1388,494
19913,1,0,71,0,-71
19914,0,0,79,0,-79
19915,1,0,47,0,-47
19916,1,0,19,0,-19
19917,1,1,102,1416,1314
19918,1,1,158,2433,2275
19919,1,1,513,2655,2142
19920,0,0,65,0,-65
19921,1,1,1334,1238,-96
19922,0,0,13,0,-13
19923,0,0,14,0,-14
19924,1,0,0,0,0
19925,0,0,31,0,-31
19926,1,1,597,2229,1632
19927,1,0,36,0,-36
19928,1,1,71,1807,1736
19929,1,0,16,0,-16
19930,1,1,1427,2308,881
19931,1,0,56,0,-56
19932,1,1,568,1359,791
19933,1,1,140,1644,1504
19934,0,0,42,0,-42
19935,0,0,10,0,-10
19936,0,0,25,0,-25
19937,1,0,4,0,-4
19938,0,0,42,0,-42
19939,1,1,1019,1257,238
19940,0,0,125,0,-125
19941,1,1,203,1519,1316
19942,1,1,1120,2311,1191
19943,1,0,64,0,-64
19944,1,1,137,1451,1314
19945,1,0,35,0,-35
19946,1,1,59,1228,1169
19947,0,0,39,0,-39
19948,1,0,25,0,-25
19949,1,1,809,1626,817
19950,1,0,43,0,-43
19951,0,0,21,0,-21
19952,1,1,376,1376,1000
19953,0,0,25,0,-25
19954,0,0,19,0,-19
19955,1,0,198,0,-198
19956,1,0,15,0,-15
19957,1,1,184,1402,1218
19958,0,0,19,0,-19
19959,1,0,26,0,-26
19960,1,0,21,0,-21
19961,1,1,71,1520,1449
19962,1,0,55,0,-55
19963,0,0,21,0,-21
19964,0,0,77,0,-77
19965,1,1,587,2649,2062
19966,1,1,240,1637,1397
19967,0,0,110,0,-110
19968,1,0,111,0,-111
19969,1,0,57,0,-57
19970,1,0,10,0,-10
19971,1,0,71,0,-71
19972,1,0,87,0,-87
19973,0,0,18,0,-18
19974,1,1,747,1477,730
19975,0,0,206,0,-206
19976,0,0,17,0,-17
19977,1,0,93,0,-93
19978,0,0,48,0,-48
19979,0,0,63,0,-63
19980,1,0,14,0,-14
19981,1,1,294,1802,1508
19982,1,0,25,0,-25
19983,0,0,35,0,-35
19984,0,0,19,0,-19
19985,1,1,1663,1368,-295
19986,0,0,98,0,-98
19987,0,0,173,0,-173
19988,1,1,1950,1875,-75
19989,1,1,51,1295,1244
19990,0,0,2,0,-2
19991,1,1,1209,1848,639
19992,1,1,249,1795,1546
19993,1,1,102,1289,1187
19994,1,0,30,0,-30
19995,1,0,37,0,-37
19996,1,0,198,0,-198
19997,1,1,145,1592,1447
19998,1,0,38,0,-38
19999,1,1,323,1269,946
20000,1,1,485,2376,1891
20001,1,0,31,0,-31
20002,1,1,283,1217,934
20003,1,0,92,0,-92
20004,0,0,39,0,-39
20005,0,0,2,0,-2
20006,0,0,31,0,-31
20007,1,0,33,0,-33
20008,1,1,420,1224,804
20009,1,1,76,1271,1195
20010,0,0,82,0,-82
20011,1,1,1859,1252,-607
20012,0,0,10,0,-10
20013,0,0,105,0,-105
20014,0,0,132,0,-132
20015,1,0,62,0,-62
20016,1,1,2777,1336,-1441
20017,1,1,1166,1473,307
20018,0,0,22,0,-22
20019,0,0,42,0,-42
20020,0,0,38,0,-38
20021,0,0,46,0,-46
20022,1,0,21,0,-21
20023,1,0,105,0,-105
20024,0,0,94,0,-94
20025,0,0,27,0,-27
20026,0,0,0,0,0
20027,0,0,2,0,-2
20028,1,0,22,0,-22
20029,1,0,3,0,-3
20030,0,0,2,0,-2
20031,1,0,49,0,-49
20032,0,0,8,0,-8
20033,1,0,67,0,-67
20034,1,0,0,0,0
20035,1,1,754,1702,948
20036,0,0,11,0,-11
20037,1,1,1114,1642,528
20038,1,0,80,0,-80
20039,1,1,449,1234,785
20040,1,1,1505,1429,-76
20041,1,1,142,1971,1829
20042,0,0,105,0,-105
20043,1,0,23,0,-23
20044,0,0,7,0,-7
20045,1,1,157,1239,1082
20046,1,1,684,1204,520
20047,0,0,73,0,-73
20048,0,0,4,0,-4
20049,1,1,268,1575,1307
20050,1,0,48,0,-48
20051,0,0,23,0,-23
20052,1,1,119,1243,1124
20053,0,0,9,0,-9
20054,0,0,67,0,-67
20055,0,0,134,0,-134
20056,0,0,21,0,-21
20057,0,0,82,0,-82
20058,1,0,41,0,-41
20059,1,1,251,1344,1093
20060,0,0,33,0,-33
20061,1,1,291,1684,1393
20062,0,0,97,0,-97
20063,0,0,25,0,-25
20064,0,0,137,0,-137
20065,0,0,1,0,-1
20066,0,0,58,0,-58
20067,1,1,395,1450,1055
20068,1,0,93,0,-93
20069,1,1,297,1437,1140
20070,1,0,1,0,-1
20071,1,0,13,0,-13
20072,1,1,1037,1318,281
20073,1,0,27,0,-27
20074,1,0,25,0,-25
20075,1,0,84,0,-84
20076,0,0,50,0,-50
20077,1,1,920,1361,441
20078,1,1,1143,1210,67
20079,0,0,181,0,-181
20080,0,0,26,0,-26
20081,1,0,5,0,-5
20082,1,0,1,0,-1
20083,0,0,33,0,-33
20084,0,0,52,0,-52
20085,0,0,77,0,-77
20086,1,1,1235,2709,1474
20087,0,0,42,0,-42
20088,1,1,383,2110,1727
20089,0,0,6,0,-6
20090,0,0,75,0,-75
20091,1,1,238,1591,1353
20092,1,1,129,1956,1827
20093,1,0,1,0,-1
20094,1,0,35,0,-35
20095,1,1,345,1488,1143
20096,1,1,329,2684,2355
20097,1,0,178,0,-178
20098,0,0,93,0,-93
20099,1,1,289,1487,1198
20100,1,1,603,1600,997
20101,0,0,27,0,-27
20102,0,0,280,0,-280
20103,1,0,70,0,-70
20104,0,0,24,0,-24
20105,1,0,23,0,-23
20106,1,1,1220,1208,-12
20107,0,0,8,0,-8
20108,1,1,121,1616,1495
20109,1,1,273,1553,1280
20110,1,1,786,1266,480
20111,1,0,78,0,-78
20112,0,0,48,0,-48
20113,1,1,228,1555,1327
20114,1,1,2061,1312,-749
20115,1,1,2988,1256,-1732
20116,0,0,167,0,-167
20117,1,0,44,0,-44
20118,0,0,75,0,-75
20119,1,1,83,1353,1270
20120,1,1,299,1301,1002
20121,0,0,5,0,-5
20122,1,0,4,0,-4
20123,0,0,4,0,-4
20124,1,0,102,0,-102
20125,0,0,21,0,-21
20126,1,1,1786,1335,-451
20127,1,1,277,1200,923
20128,0,0,73,0,-73
20129,1,0,129,0,-129
20130,0,0,35,0,-35
20131,0,0,82,0,-82
20132,0,0,78,0,-78
20133,1,0,108,0,-108
20134,1,0,112,0,-112
20135,0,0,13,0,-13
20136,1,0,26,0,-26
20137,0,0,32,0,-32
20138,0,0,7,0,-7
20139,0,0,44,0,-44
20140,1,1,170,1391,1221
20141,1,0,38,0,-38
20142,1,0,26,0,-26
20143,0,0,38,0,-38
20144,1,0,3,0,-3
20145,0,0,80,0,-80
20146,0,0,2,0,-2
20147,0,0,32,0,-32
20148,0,0,5,0,-5
20149,1,1,725,1628,903
20150,1,0,31,0,-31
20151,0,0,97,0,-97
20152,1,0,34,0,-34
20153,1,0,195,0,-195
20154,1,1,295,1760,1465
20155,0,0,7,0,-7
20156,1,0,140,0,-140
20157,1,1,685,1367,682
20158,0,0,81,0,-81
20159,1,1,983,1333,350
20160,0,0,86,0,-86
20161,1,1,233,1220,987
20162,1,1,1415,1227,-188
20163,0,0,96,0,-96
20164,0,0,6,0,-6
20165,0,0,45,0,-45
20166,0,0,6,0,-6
20167,1,1,120,1217,1097
20168,1,1,418,1367,949
20169,1,1,89,1638,1549
20170,1,0,104,0,-104
20171,0,0,16,0,-16
20172,1,0,14,0,-14
20173,1,0,11,0,-11
20174,1,0,35,0,-35
20175,1,0,63,0,-63
20176,1,1,315,1224,909
20177,1,1,291,1328,1037
20178,1,0,12,0,-12
20179,0,0,14,0,-14
20180,0,0,0,0,0
20181,1,0,13,0,-13
20182,1,0,97,0,-97
20183,1,0,42,0,-42
20184,0,0,65,0,-65
20185,1,1,47,1423,1376
20186,1,1,300,2863,2563
20187,1,1,569,1392,823
20188,1,1,779,1280,501
20189,1,0,17,0,-17
20190,0,0,79,0,-79
20191,0,0,45,0,-45
20192,0,0,260,0,-260
20193,0,0,8,0,-8
20194,1,0,36,0,-36
20195,0,0,95,0,-95
20196,0,0,23,0,-23
20197,1,1,420,1207,787
20198,1,0,13,0,-13
20199,1,0,25,0,-25
20200,1,1,1248,1271,23
20201,1,0,64,0,-64
20202,1,1,229,1206,977
20203,0,0,0,0,0
20204,1,1,846,1231,385
20205,1,1,166,2449,2283
20206,1,0,5,0,-5
20207,1,1,212,1203,991
20208,0,0,22,0,-22
20209,1,0,41,0,-41
20210,0,0,47,0,-47
20211,0,0,5,0,-5
20212,1,1,279,1662,1383
20213,0,0,40,0,-40
20214,0,0,64,0,-64
20215,1,0,23,0,-23
20216,1,1,44,1238,1194
20217,1,1,65,2078,2013
20218,0,0,15,0,-15
20219,0,0,115,0,-115
20220,0,0,37,0,-37
20221,1,1,762,1459,697
20222,1,0,0,0,0
20223,1,1,314,1204,890
20224,1,1,291,1736,1445
20225,0,0,23,0,-23
20226,1,1,87,3147,3060
20227,1,0,93,0,-93
20228,0,0,94,0,-94
20229,1,1,1023,1627,604
20230,0,0,40,0,-40
20231,1,1,180,1903,1723
20232,1,1,555,1496,941
20233,0,0,79,0,-79
20234,1,1,537,5528,4991
20235,1,0,34,0,-34
20236,1,1,239,1563,1324
20237,0,0,7,0,-7
20238,0,0,67,0,-67
20239,1,1,708,1320,612
20240,0,0,7,0,-7
20241,0,0,62,0,-62
20242,0,0,4,0,-4
20243,1,1,380,2978,2598
20244,1,0,128,0,-128
20245,0,0,30,0,-30
20246,0,0,94,0,-94
20247,1,0,145,0,-145
20248,1,1,227,1288,1061
20249,0,0,7,0,-7
20250,0,0,116,0,-116
20251,1,1,482,1425,943
20252,0,0,1,0,-1
20253,1,1,52,1212,1160
20254,0,0,0,0,0
20255,1,1,493,1469,976
20256,1,0,29,0,-29
20257,1,1,1014,1226,212
20258,1,0,164,0,-164
20259,1,0,98,0,-98
20260,1,1,5233,2028,-3205
20261,0,0,45,0,-45
20262,0,0,48,0,-48
20263,1,1,2252,1263,-989
20264,0,0,21,0,-21
20265,0,0,37,0,-37
20266,0,0,43,0,-43
20267,1,0,54,0,-54
20268,1,0,179,0,-179
20269,1,1,594,2129,1535
20270,0,0,87,0,-87
20271,0,0,33,0,-33
20272,1,0,78,0,-78
20273,1,1,474,1571,1097
20274,0,0,31,0,-31
20275,1,1,195,1335,1140
20276,1,0,3,0,-3
20277,1,1,246,1288,1042
20278,1,0,62,0,-62
20279,1,1,271,1299,1028
20280,1,0,191,0,-191
20281,1,0,19,0,-19
20282,1,1,367,2307,1940
20283,1,1,776,1325,549
20284,1,1,738,1200,462
20285,0,0,25,0,-25
20286,1,0,23,0,-23
20287,0,0,0,0,0
20288,0,0,26,0,-26
20289,0,0,9,0,-9
20290,0,0,5,0,-5
20291,1,0,166,0,-166
20292,1,0,14,0,-14
20293,1,0,99,0,-99
20294,1,0,52,0,-52
20295,1,1,53,1225,1172
20296,1,0,46,0,-46
20297,1,0,1,0,-1
20298,1,1,914,1759,845
20299,1,0,21,0,-21
20300,1,0,174,0,-174
20301,1,0,1,0,-1
20302,0,0,59,0,-59
20303,0,0,41,0,-41
20304,1,0,24,0,-24
20305,1,0,70,0,-70
20306,0,0,21,0,-21
20307,0,0,14,0,-14
20308,1,0,24,0,-24
20309,1,1,329,1453,1124
20310,1,1,451,1641,1190
20311,1,0,40,0,-40
20312,1,1,1149,1270,121
20313,0,0,46,0,-46
20314,1,0,26,0,-26
20315,1,1,1239,1307,68
20316,0,0,11,0,-11
20317,1,0,10,0,-10
20318,1,0,42,0,-42
20319,1,1,615,1788,1173
20320,1,0,52,0,-52
20321,1,1,1438,1631,193
20322,1,1,317,1939,1622
20323,1,0,69,0,-69
20324,1,1,37,1336,1299
20325,1,1,913,1940,1027
20326,1,1,231,1256,1025
20327,1,0,11,0,-11
20328,1,0,138,0,-138
20329,1,0,31,0,-31
20330,0,0,3,0,-3
20331,1,1,1225,1227,2
20332,1,0,56,0,-56
20333,0,0,158,0,-158
20334,1,1,226,1921,1695
20335,1,0,31,0,-31
20336,1,1,166,1268,1102
20337,1,1,227,1380,1153
20338,1,1,166,1789,1623
20339,1,1,801,1507,706
20340,0,0,94,0,-94
20341,0,0,47,0,-47
20342,1,1,981,1306,325
20343,0,0,14,0,-14
20344,0,0,10,0,-10
20345,1,0,62,0,-62
20346,1,1,333,1769,1436
20347,1,0,51,0,-51
20348,1,0,6,0,-6
20349,0,0,71,0,-71
20350,1,0,152,0,-152
20351,0,0,19,0,-19
20352,1,0,13,0,-13
20353,1,0,9,0,-9
20354,1,0,37,0,-37
20355,0,0,18,0,-18
20356,1,0,67,0,-67
20357,0,0,35,0,-35
20358,1,1,204,2747,2543
20359,1,1,128,1245,1117
20360,1,1,211,1567,1356
20361,1,0,239,0,-239
20362,1,0,108,0,-108
20363,0,0,16,0,-16
20364,1,0,42,0,-42
20365,1,1,139,1239,1100
20366,1,0,43,0,-43
20367,0,0,33,0,-33
20368,1,1,726,1270,544
20369,1,1,389,1395,1006
20370,1,1,779,2315,1536
20371,0,0,114,0,-114
20372,1,0,2,0,-2
20373,0,0,124,0,-124
20374,0,0,6,0,-6
20375,1,1,641,1419,778
20376,0,0,45,0,-45
20377,1,1,725,1280,555
20378,0,0,34,0,-34
20379,1,0,72,0,-72
20380,1,0,43,0,-43
20381,1,1,336,1272,936
20382,1,0,27,0,-27
20383,1,1,340,2599,2259
20384,1,1,693,1351,658
20385,0,0,14,0,-14
20386,0,0,79,0,-79
20387,0,0,21,0,-21
20388,1,1,1314,1250,-64
20389,1,1,1253,1537,284
20390,1,1,356,1291,935
20391,1,0,156,0,-156
20392,1,1,716,2171,1455
20393,1,1,586,1286,700
20394,1,0,56,0,-56
20395,0,0,52,0,-52
20396,1,1,303,1987,1684
20397,0,0,78,0,-78
20398,1,0,11,0,-11
20399,1,1,639,1243,604
20400,1,0,17,0,-17
20401,1,1,338,1573,1235
20402,1,1,242,1654,1412
20403,1,1,122,1207,1085
20404,1,1,58,1333,1275
20405,0,0,150,0,-150
20406,0,0,112,0,-112
20407,0,0,21,0,-21
20408,0,0,50,0,-50
20409,1,1,69,1841,1772
20410,1,0,83,0,-83
20411,0,0,95,0,-95
20412,1,1,92,1253,1161
20413,0,0,93,0,-93
20414,0,0,57,0,-57
20415,1,1,629,1335,706
20416,1,1,85,1622,1537
20417,0,0,13,0,-13
20418,1,1,464,2912,2448
20419,1,0,34,0,-34
20420,1,0,5,0,-5
20421,0,0,127,0,-127
20422,0,0,1,0,-1
20423,0,0,19,0,-19
20424,1,0,71,0,-71
20425,1,0,83,0,-83
20426,1,0,11,0,-11
20427,0,0,82,0,-82
20428,1,1,587,2074,1487
20429,1,0,0,0,0
20430,0,0,84,0,-84
20431,1,1,552,1570,1018
20432,1,0,6,0,-6
20433,1,0,22,0,-22
20434,1,0,3,0,-3
20435,0,0,50,0,-50
20436,1,0,85,0,-85
20437,1,1,1429,1393,-36
20438,1,1,248,1222,974
20439,0,0,89,0,-89
20440,1,1,566,1345,779
20441,1,0,58,0,-58
20442,0,0,39,0,-39
20443,1,0,146,0,-146
20444,0,0,3,0,-3
20445,1,1,334,1895,1561
20446,0,0,9,0,-9
20447,1,0,76,0,-76
20448,0,0,60,0,-60
20449,0,0,19,0,-19
20450,0,0,12,0,-12
20451,0,0,1,0,-1
20452,0,0,36,0,-36
20453,0,0,5,0,-5
20454,1,1,175,2957,2782
20455,0,0,139,0,-139
20456,0,0,61,0,-61
20457,1,0,24,0,-24
20458,1,0,108,0,-108
20459,1,0,46,0,-46
20460,1,0,51,0,-51
20461,0,0,89,0,-89
20462,1,1,1835,1255,-580
20463,0,0,7,0,-7
20464,0,0,46,0,-46
20465,1,0,13,0,-13
20466,0,0,19,0,-19
20467,0,0,38,0,-38
20468,0,0,39,0,-39
20469,0,0,22,0,-22
20470,1,1,375,1242,867
20471,0,0,4,0,-4
20472,0,0,3,0,-3
20473,0,0,31,0,-31
20474,1,0,158,0,-158
20475,1,1,605,1715,1110
20476,0,0,28,0,-28
20477,0,0,9,0,-9
20478,1,0,90,0,-90
20479,0,0,20,0,-20
20480,0,0,34,0,-34
20481,1,0,35,0,-35
20482,1,0,42,0,-42
20483,1,0,34,0,-34
20484,0,0,74,0,-74
20485,1,1,127,1278,1151
20486,1,1,158,1394,1236
20487,0,0,32,0,-32
20488,1,0,69,0,-69
20489,0,0,5,0,-5
20490,1,0,121,0,-121
20491,1,1,540,1359,819
20492,1,1,1998,1323,-675
20493,0,0,35,0,-35
20494,1,1,870,2066,1196
20495,0,0,15,0,-15
20496,1,0,24,0,-24
20497,1,1,488,1206,718
20498,1,0,49,0,-49
20499,1,1,710,1222,512
20500,0,0,95,0,-95
20501,0,0,138,0,-138
20502,1,1,45,1346,1301
20503,1,0,50,0,-50
20504,1,1,414,2424,2010
20505,0,0,15,0,-15
20506,1,1,133,1206,1073
20507,1,0,3,0,-3
20508,0,0,8,0,-8
20509,1,1,554,1531,977
20510,0,0,14,0,-14
20511,0,0,67,0,-67
20512,1,1,501,1435,934
20513,1,1,794,1723,929
20514,0,0,7,0,-7
20515,1,1,919,1201,282
20516,1,0,132,0,-132
20517,1,1,67,1479,1412
20518,1,0,159,0,-159
20519,1,0,9,0,-9
20520,0,0,26,0,-26
20521,1,1,1018,1571,553
20522,0,0,141,0,-141
20523,0,0,12,0,-12
20524,1,1,520,1340,820
20525,1,1,133,1941,1808
20526,0,0,1,0,-1
20527,1,1,118,1313,1195
20528,1,0,42,0,-42
20529,1,0,20,0,-20
20530,1,1,559,1345,786
20531,1,0,92,0,-92
20532,1,0,61,0,-61
20533,1,0,2,0,-2
20534,0,0,42,0,-42
20535,1,1,586,1227,641
20536,1,0,37,0,-37
20537,1,0,2,0,-2
20538,0,0,12,0,-12
20539,1,0,46,0,-46
20540,1,0,33,0,-33
20541,1,1,990,1586,596
20542,1,1,588,1897,1309
20543,0,0,19,0,-19
20544,0,0,13,0,-13
20545,0,0,31,0,-31
20546,0,0,33,0,-33
20547,1,1,977,1572,595
20548,0,0,21,0,-21
20549,0,0,24,0,-24
20550,0,0,17,0,-17
20551,0,0,27,0,-27
20552,1,1,1056,1416,360
20553,1,1,1544,1278,-266
20554,1,1,1046,1282,236
20555,1,0,37,0,-37
20556,0,0,152,0,-152
20557,1,1,939,1365,426
20558,0,0,21,0,-21
20559,1,1,324,2490,2166
20560,1,0,39,0,-39
20561,1,1,422,1240,818
20562,1,1,168,1298,1130
20563,0,0,118,0,-118
20564,1,0,12,0,-12
20565,1,0,6,0,-6
20566,0,0,17,0,-17
20567,1,1,218,1313,1095
20568,0,0,136,0,-136
20569,1,0,50,0,-50
20570,0,0,64,0,-64
20571,1,0,73,0,-73
20572,1,0,35,0,-35
20573,1,0,1,0,-1
20574,1,1,292,2161,1869
20575,1,0,5,0,-5
20576,1,1,228,1663,1435
20577,0,0,32,0,-32
20578,1,1,99,1408,1309
20579,0,0,2,0,-2
20580,1,0,98,0,-98
20581,1,0,89,0,-89
20582,1,0,28,0,-28
20583,1,0,106,0,-106
20584,1,0,173,0,-173
20585,1,0,19,0,-19
20586,1,0,81,0,-81
20587,0,0,42,0,-42
20588,1,0,61,0,-61
20589,1,1,84,1230,1146
20590,0,0,3,0,-3
20591,0,0,24,0,-24
20592,1,0,22,0,-22
20593,1,1,248,1670,1422
20594,0,0,100,0,-100
20595,1,1,323,1324,1001
20596,1,0,81,0,-81
20597,1,0,41,0,-41
20598,1,1,85,1831,1746
20599,0,0,7,0,-7
20600,1,0,114,0,-114
20601,0,0,0,0,0
20602,0,0,24,0,-24
20603,1,1,1445,2528,1083
20604,1,0,14,0,-14
20605,0,0,62,0,-62
20606,0,0,20,0,-20
20607,1,1,739,1319,580
20608,0,0,123,0,-123
20609,0,0,317,0,-317
20610,0,0,12,0,-12
20611,1,1,82,1337,1255
20612,1,1,948,1328,380
20613,1,0,29,0,-29
20614,0,0,60,0,-60
20615,0,0,9,0,-9
20616,1,0,29,0,-29
20617,0,0,43,0,-43
20618,1,1,838,2734,1896
20619,1,1,480,1361,881
20620,1,0,26,0,-26
20621,0,0,23,0,-23
20622,1,1,153,1293,1140
20623,1,0,30,0,-30
20624,0,0,185,0,-185
20625,0,0,34,0,-34
20626,0,0,71,0,-71
20627,1,1,633,1391,758
20628,0,0,10,0,-10
20629,1,1,937,1214,277
20630,0,0,0,0,0
20631,0,0,1,0,-1
20632,1,0,19,0,-19
20633,1,0,10,0,-10
20634,1,0,35,0,-35
20635,1,1,395,2194,1799
20636,1,0,41,0,-41
20637,1,1,825,1329,504
20638,0,0,27,0,-27
20639,0,0,22,0,-22
20640,0,0,51,0,-51
20641,0,0,140,0,-140
20642,1,1,2109,1430,-679
20643,0,0,9,0,-9
20644,0,0,63,0,-63
20645,1,0,38,0,-38
20646,1,1,809,1418,609
20647,1,1,528,3151,2623
20648,0,0,13,0,-13
20649,0,0,5,0,-5
20650,0,0,60,0,-60
20651,0,0,26,0,-26
20652,1,0,8,0,-8
20653,0,0,82,0,-82
20654,1,1,266,2343,2077
20655,1,1,427,2111,1684
20656,0,0,29,0,-29
20657,1,0,67,0,-67
20658,1,1,470,1345,875
20659,1,1,677,1280,603
20660,1,1,248,1203,955
20661,1,1,91,1418,1327
20662,1,1,232,1342,1110
20663,1,0,69,0,-69
20664,0,0,101,0,-101
20665,1,1,217,1209,992
20666,1,1,308,1257,949
20667,1,0,7,0,-7
20668,0,0,54,0,-54
20669,1,0,67,0,-67
20670,0,0,24,0,-24
20671,0,0,40,0,-40
20672,1,1,57,1963,1906
20673,1,1,21,1269,1248
20674,0,0,32,0,-32
20675,1,1,151,1937,1786
20676,0,0,40,0,-40
20677,1,0,0,0,0
20678,0,0,36,0,-36
20679,0,0,8,0,-8
20680,0,0,86,0,-86
20681,0,0,0,0,0
20682,1,1,483,1295,812
20683,0,0,48,0,-48
20684,1,0,91,0,-91
20685,1,1,814,1201,387
20686,1,0,33,0,-33
20687,1,1,172,2580,2408
20688,1,1,253,1372,1119
20689,0,0,22,0,-22
20690,1,1,422,1555,1133
20691,1,0,57,0,-57
20692,1,1,72,1633,1561
20693,0,0,80,0,-80
20694,1,1,382,1639,1257
20695,1,1,601,1217,616
20696,1,0,1,0,-1
20697,0,0,89,0,-89
20698,1,0,121,0,-121
20699,1,0,1,0,-1
20700,1,1,1006,1321,315
20701,0,0,113,0,-113
20702,0,0,40,0,-40
20703,1,1,383,1272,889
20704,1,1,112,3190,3078
20705,0,0,171,0,-171
20706,0,0,33,0,-33
20707,1,0,33,0,-33
20708,0,0,25,0,-25
20709,0,0,21,0,-21
20710,0,0,27,0,-27
20711,0,0,82,0,-82
20712,1,1,1361,1209,-152
20713,1,1,658,1407,749
20714,1,0,94,0,-94
20715,1,0,26,0,-26
20716,1,0,151,0,-151
20717,1,0,10,0,-10
20718,1,0,10,0,-10
20719,1,1,224,1332,1108
20720,1,1,1256,1471,215
20721,0,0,114,0,-114
20722,1,1,52,1329,1277
20723,1,0,10,0,-10
20724,0,0,28,0,-28
20725,1,0,37,0,-37
20726,1,0,60,0,-60
20727,0,0,36,0,-36
20728,0,0,40,0,-40
20729,1,0,0,0,0
20730,0,0,54,0,-54
20731,1,0,27,0,-27
20732,1,1,364,1422,1058
20733,0,0,9,0,-9
20734,1,0,18,0,-18
20735,0,0,15,0,-15
20736,1,1,363,1695,1332
20737,1,0,22,0,-22
20738,1,0,62,0,-62
20739,0,0,152,0,-152
20740,1,1,79,1387,1308
20741,1,1,394,1345,951
20742,0,0,39,0,-39
20743,1,1,263,1300,1037
20744,1,0,100,0,-100
20745,1,1,505,1895,1390
20746,0,0,45,0,-45
20747,1,0,3,0,-3
20748,1,1,442,1203,761
20749,0,0,154,0,-154
20750,1,1,1130,1251,121
20751,0,0,8,0,-8
20752,0,0,43,0,-43
20753,0,0,70,0,-70
20754,1,1,418,1362,944
20755,1,0,187,0,-187
20756,1,1,375,1352,977
20757,1,1,394,1565,1171
20758,1,1,184,1332,1148
20759,1,1,327,2195,1868
20760,1,0,14,0,-14
20761,1,0,0,0,0
20762,1,1,324,1841,1517
20763,0,0,0,0,0
20764,0,0,53,0,-53
20765,1,1,212,1247,1035
20766,1,1,130,1604,1474
20767,1,1,279,3791,3512
20768,0,0,26,0,-26
20769,1,0,60,0,-60
20770,0,0,18,0,-18
20771,1,1,344,1498,1154
20772,0,0,165,0,-165
20773,0,0,67,0,-67
20774,0,0,185,0,-185
20775,1,1,101,1366,1265
20776,1,0,7,0,-7
20777,1,1,1720,2567,847
20778,1,1,461,1492,1031
20779,1,1,63,1613,1550
20780,0,0,55,0,-55
20781,0,0,8,0,-8
20782,0,0,78,0,-78
20783,1,1,332,1641,1309
20784,1,1,1637,1317,-320
20785,1,0,34,0,-34
20786,1,1,551,1235,684
20787,1,0,129,0,-129
20788,1,1,165,1265,1100
20789,1,1,540,1280,740
20790,1,1,529,1557,1028
20791,0,0,177,0,-177
20792,0,0,53,0,-53
20793,0,0,8,0,-8
20794,1,1,591,1510,919
20795,1,0,26,0,-26
20796,1,0,75,0,-75
20797,0,0,1,0,-1
20798,1,0,75,0,-75
20799,1,1,896,1350,454
20800,1,1,573,1225,652
20801,1,1,210,1402,1192
20802,1,1,163,1393,1230
20803,0,0,17,0,-17
20804,1,0,35,0,-35
20805,1,0,53,0,-53
20806,0,0,76,0,-76
20807,0,0,14,0,-14
20808,1,1,682,1304,622
20809,1,0,69,0,-69
20810,0,0,56,0,-56
20811,1,0,30,0,-30
20812,1,1,661,1887,1226
20813,1,1,351,1322,971
20814,1,1,303,1772,1469
20815,1,1,230,1240,1010
20816,1,1,507,2055,1548
20817,0,0,53,0,-53
20818,0,0,11,0,-11
20819,1,0,5,0,-5
20820,0,0,172,0,-172
20821,1,0,16,0,-16
20822,1,1,518,2489,1971
20823,1,1,94,1270,1176
20824,0,0,87,0,-87
20825,0,0,23,0,-23
20826,1,0,106,0,-106
20827,1,0,113,0,-113
20828,1,1,286,1385,1099
20829,0,0,8,0,-8
20830,1,0,25,0,-25
20831,1,1,2964,1586,-1378
20832,0,0,26,0,-26
20833,0,0,35,0,-35
20834,1,1,1920,1565,-355
20835,0,0,168,0,-168
20836,1,1,215,1988,1773
20837,0,0,60,0,-60
20838,1,1,174,1591,1417
20839,1,0,102,0,-102
20840,1,0,31,0,-31
20841,0,0,144,0,-144
20842,1,0,88,0,-88
20843,0,0,142,0,-142
20844,1,0,13,0,-13
20845,1,1,207,1377,1170
20846,0,0,15,0,-15
20847,1,1,578,1696,1118
20848,1,0,36,0,-36
20849,0,0,12,0,-12
20850,1,1,406,1243,837
20851,0,0,48,0,-48
20852,0,0,6,0,-6
20853,1,1,246,1822,1576
20854,0,0,89,0,-89
20855,1,0,57,0,-57
20856,1,1,756,1432,676
20857,1,1,376,1654,1278
20858,1,0,73,0,-73
20859,1,1,773,1403,630
20860,0,0,40,0,-40
20861,0,0,29,0,-29
20862,0,0,13,0,-13
20863,1,1,462,1265,803
20864,1,1,133,3137,3004
20865,0,0,2,0,-2
20866,0,0,38,0,-38
20867,0,0,35,0,-35
20868,1,1,457,1201,744
20869,1,0,153,0,-153
20870,1,0,119,0,-119
20871,1,0,8,0,-8
20872,1,1,1394,1700,306
20873,0,0,69,0,-69
20874,0,0,43,0,-43
20875,0,0,5,0,-5
20876,0,0,12,0,-12
20877,1,0,25,0,-25
20878,0,0,134,0,-134
20879,1,0,60,0,-60
20880,1,1,179,1280,1101
20881,1,0,25,0,-25
20882,0,0,48,0,-48
20883,1,1,147,1865,1718
20884,1,0,6,0,-6
20885,1,0,24,0,-24
20886,0,0,10,0,-10
20887,0,0,64,0,-64
20888,1,1,705,1732,1027
20889,1,0,33,0,-33
20890,1,0,35,0,-35
20891,0,0,4,0,-4
20892,1,0,41,0,-41
20893,0,0,12,0,-12
20894,0,0,8,0,-8
20895,1,0,78,0,-78
20896,1,1,150,1610,1460
20897,1,1,209,1530,1321
20898,0,0,21,0,-21
20899,0,0,17,0,-17
20900,1,0,72,0,-72
20901,0,0,65,0,-65
20902,1,1,590,2024,1434
20903,1,1,141,1784,1643
20904,0,0,9,0,-9
20905,1,1,309,1263,954
20906,1,1,649,1230,581
20907,0,0,78,0,-78
20908,1,0,6,0,-6
20909,0,0,62,0,-62
20910,1,0,114,0,-114
20911,0,0,21,0,-21
20912,1,1,235,1277,1042
20913,1,1,523,1865,1342
20914,0,0,36,0,-36
20915,1,0,36,0,-36
20916,1,0,17,0,-17
20917,1,0,14,0,-14
20918,0,0,99,0,-99
20919,1,1,373,1214,841
20920,0,0,22,0,-22
20921,1,1,1458,1393,-65
20922,0,0,43,0,-43
20923,0,0,50,0,-50
20924,0,0,35,0,-35
20925,1,0,119,0,-119
20926,1,0,14,0,-14
20927,1,1,272,1206,934
20928,0,0,162,0,-162
20929,0,0,34,0,-34
20930,1,0,8,0,-8
20931,1,1,772,1291,519
20932,0,0,2,0,-2
20933,1,0,15,0,-15
20934,1,1,677,1714,1037
20935,1,1,356,1484,1128
20936,1,1,204,3667,3463
20937,1,0,4,0,-4
20938,0,0,3,0,-3
20939,0,0,15,0,-15
20940,0,0,13,0,-13
20941,0,0,49,0,-49
20942,0,0,38,0,-38
20943,1,0,48,0,-48
20944,1,0,57,0,-57
20945,1,1,24,1324,1300
20946,0,0,15,0,-15
20947,0,0,15,0,-15
20948,0,0,53,0,-53
20949,1,1,118,1317,1199
20950,1,1,387,1279,892
20951,0,0,15,0,-15
20952,1,1,161,1382,1221
20953,0,0,35,0,-35
20954,0,0,4,0,-4
20955,1,1,2797,1210,-1587
20956,1,1,246,1304,1058
20957,0,0,179,0,-179
20958,1,0,4,0,-4
20959,1,1,295,1210,915
20960,0,0,22,0,-22
20961,0,0,34,0,-34
20962,0,0,220,0,-220
20963,1,0,87,0,-87
20964,1,1,389,1349,960
20965,0,0,113,0,-113
20966,1,0,9,0,-9
20967,0,0,47,0,-47
20968,1,1,296,1444,1148
20969,0,0,35,0,-35
20970,1,0,40,0,-40
20971,0,0,34,0,-34
20972,1,1,253,1570,1317
20973,1,0,11,0,-11
20974,1,1,854,1771,917
20975,0,0,4,0,-4
20976,1,1,115,1330,1215
20977,1,1,1127,2128,1001
20978,1,0,32,0,-32
20979,0,0,17,0,-17
20980,0,0,50,0,-50
20981,0,0,8,0,-8
20982,1,0,40,0,-40
20983,0,0,66,0,-66
20984,1,0,29,0,-29
20985,0,0,7,0,-7
20986,0,0,42,0,-42
20987,1,1,945,1830,885
20988,0,0,3,0,-3
20989,1,1,791,2395,1604
20990,1,1,266,2429,2163
20991,0,0,29,0,-29
20992,1,0,96,0,-96
20993,1,0,67,0,-67
20994,1,0,0,0,0
20995,0,0,13,0,-13
20996,1,1,78,1280,1202
20997,0,0,32,0,-32
20998,0,0,7,0,-7
20999,1,1,505,1593,1088
21000,1,1,438,1556,1118
21001,1,0,21,0,-21
21002,1,1,1669,1330,-339
21003,1,1,840,1999,1159
21004,0,0,11,0,-11
21005,1,0,14,0,-14
21006,0,0,29,0,-29
21007,0,0,51,0,-51
21008,1,1,649,1254,605
21009,0,0,39,0,-39
21010,0,0,184,0,-184
21011,1,0,19,0,-19
21012,1,0,121,0,-121
21013,0,0,202,0,-202
21014,1,0,64,0,-64
21015,0,0,2,0,-2
21016,1,1,1524,1368,-156
21017,0,0,12,0,-12
21018,1,1,997,1341,344
21019,0,0,16,0,-16
21020,1,1,308,1240,932
21021,1,0,55,0,-55
21022,1,0,45,0,-45
21023,1,0,1,0,-1
21024,0,0,67,0,-67
21025,1,0,6,0,-6
21026,1,0,136,0,-136
21027,0,0,9,0,-9
21028,0,0,27,0,-27
21029,1,1,514,1303,789
21030,1,1,1267,1310,43
21031,1,1,304,1227,923
21032,0,0,48,0,-48
21033,1,0,53,0,-53
21034,0,0,63,0,-63
21035,0,0,24,0,-24
21036,0,0,35,0,-35
21037,1,1,157,1658,1501
21038,0,0,61,0,-61
21039,0,0,62,0,-62
21040,0,0,42,0,-42
21041,0,0,7,0,-7
21042,0,0,33,0,-33
21043,1,0,8,0,-8
21044,0,0,36,0,-36
21045,1,1,307,1955,1648
21046,1,1,939,1759,820
21047,1,1,617,1847,1230
21048,0,0,25,0,-25
21049,0,0,363,0,-363
21050,1,0,27,0,-27
21051,1,0,21,0,-21
21052,1,0,2,0,-2
21053,0,0,7,0,-7
21054,1,1,522,1309,787
21055,1,0,120,0,-120
21056,0,0,10,0,-10
21057,1,0,75,0,-75
21058,1,0,39,0,-39
21059,1,0,54,0,-54
21060,0,0,25,0,-25
21061,0,0,53,0,-53
21062,0,0,15,0,-15
21063,1,1,245,1457,1212
21064,0,0,49,0,-49
21065,0,0,2,0,-2
21066,0,0,49,0,-49
21067,1,0,8,0,-8
21068,1,0,57,0,-57
21069,1,1,356,1269,913
21070,1,1,125,1448,1323
21071,1,1,28,2873,2845
21072,1,0,24,0,-24
21073,1,1,453,2054,1601
21074,1,0,16,0,-16
21075,1,1,286,1296,1010
21076,1,1,150,1329,1179
21077,1,1,585,1342,757
21078,1,1,838,1287,449
21079,1,0,40,0,-40
21080,0,0,28,0,-28
21081,1,1,1639,1339,-300
21082,1,0,52,0,-52
21083,0,0,80,0,-80
21084,1,1,417,2572,2155
21085,1,0,80,0,-80
21086,1,0,12,0,-12
21087,1,1,362,1213,851
21088,1,0,33,0,-33
21089,0,0,26,0,-26
21090,1,0,70,0,-70
21091,1,0,15,0,-15
21092,0,0,22,0,-22
21093,1,1,396,1358,962
21094,0,0,125,0,-125
21095,1,1,74,1342,1268
21096,1,0,5,0,-5
21097,0,0,49,0,-49
21098,0,0,59,0,-59
21099,0,0,1,0,-1
21100,0,0,59,0,-59
21101,1,0,4,0,-4
21102,1,1,53,1770,1717
21103,1,1,423,4370,3947
21104,0,0,13,0,-13
21105,0,0,69,0,-69
21106,1,0,18,0,-18
21107,0,0,46,0,-46
21108,1,1,252,1656,1404
21109,1,1,619,3037,2418
21110,0,0,6,0,-6
21111,1,0,58,0,-58
21112,0,0,14,0,-14
21113,1,1,198,1715,1517
21114,0,0,178,0,-178
21115,1,0,2,0,-2
21116,1,0,5,0,-5
21117,1,1,389,1764,1375
21118,1,0,17,0,-17
21119,1,1,1338,1398,60
21120,1,0,153,0,-153
21121,0,0,35,0,-35
21122,1,0,1,0,-1
21123,1,0,21,0,-21
21124,1,0,188,0,-188
21125,0,0,11,0,-11
21126,0,0,15,0,-15
21127,1,1,578,1202,624
21128,1,1,783,1993,1210
21129,1,0,22,0,-22
21130,0,0,0,0,0
21131,1,1,171,1259,1088
21132,1,1,336,1238,902
21133,1,0,38,0,-38
21134,0,0,21,0,-21
21135,1,1,550,1837,1287
21136,1,0,110,0,-110
21137,1,1,525,2097,1572
21138,0,0,2,0,-2
21139,0,0,122,0,-122
21140,1,0,63,0,-63
21141,1,1,427,1300,873
21142,0,0,52,0,-52
21143,1,0,32,0,-32
21144,0,0,21,0,-21
21145,1,0,20,0,-20
21146,1,1,755,1474,719
21147,0,0,65,0,-65
21148,1,0,48,0,-48
21149,0,0,37,0,-37
21150,0,0,10,0,-10
21151,0,0,12,0,-12
21152,1,1,82,1299,1217
21153,1,1,262,1887,1625
21154,1,1,3002,1325,-1677
21155,0,0,15,0,-15
21156,0,0,314,0,-314
21157,0,0,58,0,-58
21158,0,0,42,0,-42
21159,1,0,36,0,-36
21160,0,0,32,0,-32
21161,0,0,5,0,-5
21162,0,0,124,0,-124
21163,0,0,8,0,-8
21164,1,0,11,0,-11
21165,1,1,493,1289,796
21166,1,0,39,0,-39
21167,1,1,230,1421,1191
21168,1,1,181,1760,1579
21169,0,0,19,0,-19
21170,0,0,16,0,-16
21171,1,1,67,1627,1560
21172,1,0,155,0,-155
21173,1,0,27,0,-27
21174,1,1,245,1449,1204
21175,1,0,64,0,-64
21176,1,0,149,0,-149
21177,1,1,1318,1295,-23
21178,1,1,394,1313,919
21179,0,0,20,0,-20
21180,0,0,47,0,-47
21181,0,0,8,0,-8
21182,0,0,36,0,-36
21183,1,1,581,5497,4916
21184,1,0,98,0,-98
21185,0,0,27,0,-27
21186,1,0,9,0,-9
21187,0,0,35,0,-35
21188,0,0,30,0,-30
21189,1,1,155,1683,1528
21190,0,0,74,0,-74
21191,1,0,285,0,-285
21192,0,0,3,0,-3
21193,1,0,57,0,-57
21194,1,1,2452,1581,-871
21195,0,0,44,0,-44
21196,1,0,227,0,-227
21197,1,0,57,0,-57
21198,1,0,95,0,-95
21199,1,1,560,1330,770
21200,1,1,232,1519,1287
21201,0,0,44,0,-44
21202,1,0,11,0,-11
21203,1,0,15,0,-15
21204,1,1,156,1893,1737
21205,0,0,30,0,-30
21206,0,0,0,0,0
21207,1,0,116,0,-116
21208,1,1,283,1225,942
21209,1,1,1054,1307,253
21210,0,0,1,0,-1
21211,0,0,273,0,-273
21212,1,1,1103,1297,194
21213,1,1,2017,1489,-528
21214,0,0,78,0,-78
21215,0,0,72,0,-72
21216,1,1,251,1421,1170
21217,0,0,85,0,-85
21218,1,1,642,1588,946
21219,1,1,192,1870,1678
21220,1,0,20,0,-20
21221,1,1,1028,1533,505
21222,0,0,93,0,-93
21223,1,1,776,2409,1633
21224,1,1,889,1218,329
21225,1,1,1428,2548,1120
21226,1,0,20,0,-20
21227,1,0,36,0,-36
21228,1,0,8,0,-8
21229,0,0,71,0,-71
21230,0,0,180,0,-180
21231,0,0,31,0,-31
21232,1,0,4,0,-4
21233,1,0,79,0,-79
21234,0,0,8,0,-8
21235,1,1,222,1355,1133
21236,1,0,51,0,-51
21237,1,1,270,1512,1242
21238,0,0,9,0,-9
21239,0,0,51,0,-51
21240,0,0,14,0,-14
21241,0,0,0,0,0
21242,0,0,73,0,-73
21243,1,0,7,0,-7
21244,1,1,1226,1368,142
21245,1,1,315,1277,962
21246,1,0,130,0,-130
21247,0,0,20,0,-20
21248,0,0,32,0,-32
21249,0,0,12,0,-12
21250,1,0,1,0,-1
21251,1,1,90,2157,2067
21252,0,0,58,0,-58
21253,1,1,123,1413,1290
21254,0,0,30,0,-30
21255,1,1,1983,1625,-358
21256,1,1,233,3406,3173
21257,1,0,25,0,-25
21258,0,0,0,0,0
21259,1,0,42,0,-42
21260,0,0,23,0,-23
21261,0,0,112,0,-112
21262,1,0,39,0,-39
21263,1,1,215,2139,1924
21264,0,0,74,0,-74
21265,1,1,315,1221,906
21266,0,0,31,0,-31
21267,0,0,34,0,-34
21268,0,0,26,0,-26
21269,1,0,120,0,-120
21270,0,0,146,0,-146
21271,1,0,160,0,-160
21272,1,0,222,0,-222
21273,0,0,44,0,-44
21274,0,0,58,0,-58
21275,0,0,29,0,-29
21276,1,0,63,0,-63
21277,0,0,9,0,-9
21278,1,1,795,1484,689
21279,0,0,23,0,-23
21280,0,0,32,0,-32
21281,1,1,170,2050,1880
21282,0,0,12,0,-12
21283,1,1,259,2347,2088
21284,1,0,27,0,-27
21285,1,0,26,0,-26
21286,1,1,104,1439,1335
21287,0,0,77,0,-77
21288,1,0,25,0,-25
21289,1,0,174,0,-174
21290,1,0,0,0,0
21291,1,0,96,0,-96
21292,1,1,2365,1321,-1044
21293,1,0,17,0,-17
21294,1,1,637,1259,622
21295,0,0,4,0,-4
21296,0,0,11,0,-11
21297,1,0,94,0,-94
21298,1,1,802,1281,479
21299,0,0,53,0,-53
21300,1,0,15,0,-15
21301,1,0,142,0,-142
21302,1,1,1563,1438,-125
21303,1,0,77,0,-77
21304,1,0,120,0,-120
21305,0,0,17,0,-17
21306,1,0,0,0,0
21307,1,0,36,0,-36
21308,1,0,17,0,-17
21309,0,0,88,0,-88
21310,0,0,36,0,-36
21311,1,0,1,0,-1
21312,0,0,133,0,-133
21313,0,0,44,0,-44
21314,0,0,62,0,-62
21315,1,0,8,0,-8
21316,1,1,169,1505,1336
21317,1,1,480,1619,1139
21318,0,0,12,0,-12
21319,1,1,488,2235,1747
21320,1,0,3,0,-3
21321,0,0,3,0,-3
21322,1,1,346,1617,1271
21323,1,0,51,0,-51
21324,1,0,61,0,-61
21325,0,0,85,0,-85
21326,0,0,7,0,-7
21327,0,0,96,0,-96
21328,0,0,18,0,-18
21329,1,1,854,1256,402
21330,1,1,678,1579,901
21331,1,0,43,0,-43
21332,1,0,68,0,-68
21333,1,0,39,0,-39
21334,1,1,313,1208,895
21335,1,1,119,1359,1240
21336,1,0,72,0,-72
21337,1,1,443,2413,1970
21338,1,1,392,1215,823
21339,1,0,15,0,-15
21340,0,0,40,0,-40
21341,0,0,12,0,-12
21342,0,0,0,0,0
21343,0,0,29,0,-29
21344,0,0,255,0,-255
21345,0,0,11,0,-11
21346,1,1,1310,1498,188
21347,1,0,42,0,-42
21348,0,0,18,0,-18
21349,1,0,163,0,-163
21350,1,1,74,1301,1227
21351,1,0,5,0,-5
21352,1,1,272,1566,1294
21353,1,0,5,0,-5
21354,1,1,335,1218,883
21355,0,0,8,0,-8
21356,1,1,136,1543,1407
21357,1,0,29,0,-29
21358,1,1,99,1546,1447
21359,0,0,72,0,-72
21360,1,1,164,1246,1082
21361,0,0,68,0,-68
21362,1,0,44,0,-44
21363,0,0,9,0,-9
21364,1,0,5,0,-5
21365,1,0,62,0,-62
21366,1,1,499,1231,732
21367,1,1,657,1320,663
21368,0,0,60,0,-60
21369,0,0,111,0,-111
21370,0,0,51,0,-51
21371,0,0,130,0,-130
21372,1,0,29,0,-29
21373,1,1,82,1298,1216
21374,1,0,44,0,-44
21375,1,1,1422,1249,-173
21376,1,1,424,1331,907
21377,1,1,157,1392,1235
21378,1,1,214,1332,1118
21379,0,0,94,0,-94
21380,1,1,610,1259,649
21381,1,0,28,0,-28
21382,1,0,218,0,-218
21383,0,0,11,0,-11
21384,1,1,148,2375,2227
21385,1,0,42,0,-42
21386,0,0,131,0,-131
21387,1,1,221,1518,1297
21388,0,0,154,0,-154
21389,0,0,62,0,-62
21390,1,0,92,0,-92
21391,0,0,15,0,-15
21392,1,0,34,0,-34
21393,0,0,59,0,-59
21394,1,0,17,0,-17
21395,1,0,213,0,-213
21396,1,1,1385,1729,344
21397,0,0,48,0,-48
21398,0,0,77,0,-77
21399,1,1,123,1295,1172
21400,0,0,24,0,-24
21401,0,0,5,0,-5
21402,1,1,286,1568,1282
21403,0,0,39,0,-39
21404,0,0,11,0,-11
21405,0,0,65,0,-65
21406,0,0,72,0,-72
21407,1,1,1174,2742,1568
21408,1,0,9,0,-9
21409,0,0,31,0,-31
21410,0,0,10,0,-10
21411,1,1,615,2772,2157
21412,1,1,543,1268,725
21413,0,0,180,0,-180
21414,1,1,130,1447,1317
21415,1,1,297,1228,931
21416,0,0,155,0,-155
21417,0,0,4,0,-4
21418,1,1,566,1351,785
21419,1,0,87,0,-87
21420,1,0,21,0,-21
21421,0,0,13,0,-13
21422,1,0,209,0,-209
21423,0,0,12,0,-12
21424,1,1,722,1324,602
21425,0,0,78,0,-78
21426,0,0,65,0,-65
21427,1,0,59,0,-59
21428,0,0,24,0,-24
21429,0,0,4,0,-4
21430,1,0,83,0,-83
21431,1,1,545,1300,755
21432,0,0,34,0,-34
21433,0,0,143,0,-143
21434,1,0,112,0,-112
21435,0,0,102,0,-102
21436,1,0,22,0,-22
21437,1,0,2,0,-2
21438,1,1,178,1241,1063
21439,1,0,72,0,-72
21440,0,0,2,0,-2
21441,1,0,57,0,-57
21442,0,0,26,0,-26
21443,1,0,24,0,-24
21444,0,0,24,0,-24
21445,1,1,728,1271,543
21446,1,0,59,0,-59
21447,1,0,22,0,-22
21448,1,0,9,0,-9
21449,0,0,66,0,-66
21450,0,0,10,0,-10
21451,1,1,142,1311,1169
21452,0,0,69,0,-69
21453,1,1,368,1358,990
21454,0,0,4,0,-4
21455,0,0,93,0,-93
21456,0,0,118,0,-118
21457,1,0,23,0,-23
21458,0,0,145,0,-145
21459,0,0,189,0,-189
21460,1,0,5,0,-5
21461,1,0,38,0,-38
21462,1,1,539,1685,1146
21463,1,1,426,2213,1787
21464,1,1,242,1420,1178
21465,1,0,14,0,-14
21466,1,0,99,0,-99
21467,1,0,25,0,-25
21468,1,0,73,0,-73
21469,0,0,54,0,-54
21470,1,1,61,2088,2027
21471,0,0,30,0,-30
21472,0,0,35,0,-35
21473,1,0,12,0,-12
21474,1,0,79,0,-79
21475,1,1,250,1613,1363
21476,0,0,2,0,-2
21477,1,0,64,0,-64
21478,0,0,157,0,-157
21479,1,1,1369,1233,-136
21480,0,0,33,0,-33
21481,1,0,41,0,-41
21482,1,0,46,0,-46
21483,0,0,128,0,-128
21484,1,1,957,1202,245
21485,0,0,131,0,-131
21486,0,0,130,0,-130
21487,0,0,56,0,-56
21488,1,1,377,1376,999
21489,1,0,142,0,-142
21490,1,1,1602,1264,-338
21491,1,0,42,0,-42
21492,1,0,31,0,-31
21493,1,1,1481,1447,-34
21494,1,1,141,1203,1062
21495,0,0,31,0,-31
21496,1,0,4,0,-4
21497,0,0,44,0,-44
21498,0,0,97,0,-97
21499,1,1,925,1851,926
21500,0,0,62,0,-62
21501,1,1,177,1259,1082
21502,0,0,37,0,-37
21503,1,1,628,1271,643
21504,1,0,37,0,-37
21505,0,0,6,0,-6
21506,1,0,94,0,-94
21507,1,1,122,1335,1213
21508,0,0,77,0,-77
21509,0,0,42,0,-42
21510,0,0,107,0,-107
21511,0,0,121,0,-121
21512,0,0,14,0,-14
21513,0,0,68,0,-68
21514,0,0,88,0,-88
21515,1,0,58,0,-58
21516,0,0,20,0,-20
21517,0,0,3,0,-3
21518,1,0,6,0,-6
21519,1,1,492,1227,735
21520,1,1,283,1297,1014
21521,1,1,178,1292,1114
21522,1,0,19,0,-19
21523,1,1,719,1224,505
21524,0,0,0,0,0
21525,1,0,42,0,-42
21526,0,0,12,0,-12
21527,0,0,38,0,-38
21528,1,1,1198,1259,61
21529,0,0,16,0,-16
21530,0,0,70,0,-70
21531,0,0,51,0,-51
21532,0,0,18,0,-18
21533,1,0,122,0,-122
21534,1,1,49,1544,1495
21535,1,1,3345,1216,-2129
21536,0,0,72,0,-72
21537,1,1,302,1205,903
21538,1,0,11,0,-11
21539,0,0,8,0,-8
21540,0,0,8,0,-8
21541,1,1,439,1406,967
21542,0,0,24,0,-24
21543,0,0,143,0,-143
21544,0,0,26,0,-26
21545,1,1,226,1306,1080
21546,1,0,58,0,-58
21547,1,1,424,1716,1292
21548,1,1,201,1311,1110
21549,1,1,596,1446,850
21550,1,1,362,1630,1268
21551,1,1,1044,1309,265
21552,1,1,232,1493,1261
21553,1,1,2390,1396,-994
21554,0,0,226,0,-226
21555,1,1,1030,1353,323
21556,0,0,37,0,-37
21557,1,0,31,0,-31
21558,1,0,28,0,-28
21559,1,0,33,0,-33
21560,1,0,313,0,-313
21561,1,0,28,0,-28
21562,1,1,712,1642,930
21563,1,0,25,0,-25
21564,1,0,175,0,-175
21565,1,0,66,0,-66
21566,0,0,22,0,-22
21567,1,1,1577,3383,1806
21568,1,0,14,0,-14
21569,1,1,321,1258,937
21570,1,1,675,1383,708
21571,1,1,70,1269,1199
21572,1,0,68,0,-68
21573,0,0,0,0,0
21574,1,1,466,1253,787
21575,0,0,12,0,-12
21576,1,1,329,1305,976
21577,0,0,1,0,-1
21578,0,0,42,0,-42
21579,1,1,595,1264,669
21580,1,0,75,0,-75
21581,0,0,73,0,-73
21582,1,1,784,1846,1062
21583,1,0,4,0,-4
21584,1,1,449,1734,1285
21585,0,0,27,0,-27
21586,1,1,141,1356,1215
21587,1,0,9,0,-9
21588,0,0,51,0,-51
21589,0,0,83,0,-83
21590,1,1,133,1252,1119
21591,0,0,19,0,-19
21592,1,0,71,0,-71
21593,1,1,552,1427,875
21594,1,1,288,1314,1026
21595,0,0,73,0,-73
21596,1,0,47,0,-47
21597,1,1,513,1468,955
21598,1,1,1148,1456,308
21599,0,0,112,0,-112
21600,1,1,361,2726,2365
21601,0,0,28,0,-28
21602,1,0,90,0,-90
21603,1,1,61,1358,1297
21604,1,0,27,0,-27
21605,1,1,96,5648,5552
21606,1,0,190,0,-190
21607,0,0,12,0,-12
21608,1,1,116,1294,1178
21609,1,1,141,1837,1696
21610,1,0,45,0,-45
21611,0,0,40,0,-40
21612,0,0,26,0,-26
21613,1,0,29,0,-29
21614,0,0,82,0,-82
21615,1,0,19,0,-19
21616,0,0,8,0,-8
21617,1,1,253,2743,2490
21618,1,1,1344,1601,257
21619,1,0,88,0,-88
21620,0,0,4,0,-4
21621,0,0,57,0,-57
21622,1,0,28,0,-28
21623,1,0,28,0,-28
21624,1,0,18,0,-18
21625,0,0,10,0,-10
21626,1,1,263,2153,1890
21627,1,1,699,1317,618
21628,1,1,663,1492,829
21629,0,0,21,0,-21
21630,1,1,1016,1800,784
21631,0,0,101,0,-101
21632,1,1,535,2042,1507
21633,1,1,203,1241,1038
21634,0,0,111,0,-111
21635,0,0,3,0,-3
21636,1,1,206,1411,1205
21637,0,0,213,0,-213
21638,1,0,44,0,-44
21639,0,0,96,0,-96
21640,1,0,0,0,0
21641,1,1,372,1832,1460
21642,1,1,698,1519,821
21643,1,0,15,0,-15
21644,0,0,31,0,-31
21645,1,1,127,1378,1251
21646,1,0,1,0,-1
21647,0,0,13,0,-13
21648,1,0,1,0,-1
21649,1,1,123,1276,1153
21650,0,0,19,0,-19
21651,1,1,541,1202,661
21652,0,0,2,0,-2
21653,1,0,24,0,-24
21654,1,0,50,0,-50
21655,0,0,33,0,-33
21656,1,0,36,0,-36
21657,1,0,23,0,-23
21658,0,0,31,0,-31
21659,1,1,365,1685,1320
21660,1,1,13,1540,1527
21661,0,0,59,0,-59
21662,1,0,12,0,-12
21663,1,1,688,1372,684
21664,0,0,77,0,-77
21665,0,0,16,0,-16
21666,1,0,21,0,-21
21667,1,0,24,0,-24
21668,1,0,5,0,-5
21669,1,1,767,1520,753
21670,1,0,21,0,-21
21671,1,1,117,1795,1678
21672,0,0,100,0,-100
21673,0,0,151,0,-151
21674,1,1,799,1961,1162
21675,1,1,182,1204,1022
21676,1,1,398,1329,931
21677,1,1,174,1232,1058
21678,0,0,67,0,-67
21679,1,1,49,1332,1283
21680,1,0,18,0,-18
21681,1,0,3,0,-3
21682,0,0,18,0,-18
21683,0,0,89,0,-89
21684,1,0,94,0,-94
21685,0,0,2,0,-2
21686,0,0,66,0,-66
21687,1,0,102,0,-102
21688,1,0,83,0,-83
21689,0,0,21,0,-21
21690,0,0,163,0,-163
21691,0,0,44,0,-44
21692,0,0,11,0,-11
21693,1,1,599,2730,2131
21694,0,0,128,0,-128
21695,0,0,142,0,-142
21696,0,0,11,0,-11
21697,1,1,485,2901,2416
21698,1,0,8,0,-8
21699,1,1,373,1342,969
21700,1,0,33,0,-33
21701,1,1,137,2082,1945
21702,0,0,91,0,-91
21703,0,0,24,0,-24
21704,0,0,126,0,-126
21705,0,0,20,0,-20
21706,0,0,3,0,-3
21707,0,0,76,0,-76
21708,1,0,9,0,-9
21709,0,0,16,0,-16
21710,0,0,57,0,-57
21711,1,0,0,0,0
21712,0,0,74,0,-74
21713,0,0,64,0,-64
21714,1,1,868,1253,385
21715,0,0,18,0,-18
21716,0,0,27,0,-27
21717,0,0,23,0,-23
21718,0,0,12,0,-12
21719,1,0,10,0,-10
21720,1,1,297,1520,1223
21721,1,0,66,0,-66
21722,0,0,73,0,-73
21723,1,0,58,0,-58
21724,0,0,39,0,-39
21725,0,0,15,0,-15
21726,1,1,182,1264,1082
21727,1,1,128,1257,1129
21728,1,1,745,1415,670
21729,1,0,10,0,-10
21730,0,0,17,0,-17
21731,1,0,80,0,-80
21732,1,1,231,1333,1102
21733,1,1,233,1243,1010
21734,1,0,36,0,-36
21735,0,0,131,0,-131
21736,1,0,6,0,-6
21737,0,0,145,0,-145
21738,1,1,923,1917,994
21739,1,0,14,0,-14
21740,1,1,164,1553,1389
21741,0,0,1,0,-1
21742,0,0,73,0,-73
21743,1,0,93,0,-93
21744,0,0,41,0,-41
21745,1,1,157,1994,1837
21746,1,0,5,0,-5
21747,0,0,21,0,-21
21748,1,1,302,1582,1280
21749,0,0,4,0,-4
21750,1,0,24,0,-24
21751,1,1,124,2205,2081
21752,1,0,2,0,-2
21753,1,0,21,0,-21
21754,0,0,59,0,-59
21755,1,1,363,1387,1024
21756,1,1,43,1333,1290
21757,0,0,17,0,-17
21758,0,0,26,0,-26
21759,1,0,35,0,-35
21760,1,0,91,0,-91
21761,1,0,8,0,-8
21762,1,0,1,0,-1
21763,1,1,395,1869,1474
21764,1,1,671,1343,672
21765,1,0,72,0,-72
21766,1,1,198,1676,1478
21767,1,1,91,1207,1116
21768,0,0,25,0,-25
21769,0,0,9,0,-9
21770,1,1,200,1326,1126
21771,1,0,77,0,-77
21772,1,1,109,1568,1459
21773,1,0,56,0,-56
21774,1,0,46,0,-46
21775,1,1,130,1366,1236
21776,1,1,690,1253,563
21777,1,1,105,1201,1096
21778,1,0,10,0,-10
21779,0,0,38,0,-38
21780,1,0,10,0,-10
21781,1,1,248,1291,1043
21782,1,0,13,0,-13
21783,1,0,125,0,-125
21784,1,0,30,0,-30
21785,0,0,6,0,-6
21786,0,0,1,0,-1
21787,0,0,230,0,-230
21788,1,1,232,3425,3193
21789,1,0,19,0,-19
21790,0,0,37,0,-37
21791,0,0,43,0,-43
21792,1,1,277,1327,1050
21793,1,1,430,1278,848
21794,0,0,13,0,-13
21795,1,1,1487,1997,510
21796,0,0,41,0,-41
21797,1,0,180,0,-180
21798,0,0,39,0,-39
21799,1,1,1089,1495,406
21800,1,1,258,1806,1548
21801,1,1,225,1874,1649
21802,0,0,67,0,-67
21803,1,0,23,0,-23
21804,1,1,491,1449,958
21805,1,0,0,0,0
21806,0,0,9,0,-9
21807,1,1,195,1292,1097
21808,1,0,159,0,-159
21809,0,0,30,0,-30
21810,0,0,11,0,-11
21811,1,0,137,0,-137
21812,0,0,102,0,-102
21813,1,1,591,1353,762
21814,1,1,137,1395,1258
21815,0,0,28,0,-28
21816,0,0,2,0,-2
21817,1,1,516,1712,1196
21818,1,0,67,0,-67
21819,1,1,524,1224,700
21820,1,1,622,1624,1002
21821,0,0,114,0,-114
21822,1,0,76,0,-76
21823,1,0,36,0,-36
21824,1,1,280,1353,1073
21825,0,0,54,0,-54
21826,1,1,305,1388,1083
21827,0,0,11,0,-11
21828,0,0,10,0,-10
21829,0,0,3,0,-3
21830,1,1,247,1403,1156
21831,1,1,2193,1212,-981
21832,1,1,504,1304,800
21833,1,0,29,0,-29
21834,0,0,9,0,-9
21835,1,1,121,1942,1821
21836,1,1,523,1699,1176
21837,1,1,279,1242,963
21838,1,0,21,0,-21
21839,1,0,14,0,-14
21840,0,0,36,0,-36
21841,1,0,1,0,-1
21842,0,0,9,0,-9
21843,0,0,11,0,-11
21844,0,0,14,0,-14
21845,1,0,6,0,-6
21846,0,0,7,0,-7
21847,1,1,52,1488,1436
21848,1,1,139,1834,1695
21849,0,0,21,0,-21
21850,1,0,47,0,-47
21851,0,0,17,0,-17
21852,1,0,0,0,0
21853,1,0,1,0,-1
21854,1,1,217,1279,1062
21855,1,0,19,0,-19
21856,1,1,290,9933,9643
21857,1,1,136,1994,1858
21858,1,1,1809,1902,93
21859,1,1,1514,1269,-245
21860,1,1,503,1915,1412
21861,0,0,46,0,-46
21862,1,1,996,1538,542
21863,1,0,26,0,-26
21864,1,0,57,0,-57
21865,0,0,1,0,-1
21866,0,0,27,0,-27
21867,0,0,80,0,-80
21868,1,1,454,1478,1024
21869,1,0,16,0,-16
21870,1,0,9,0,-9
21871,1,0,137,0,-137
21872,1,0,58,0,-58
21873,1,0,95,0,-95
21874,1,0,2,0,-2
21875,0,0,1,0,-1
21876,1,1,1039,1322,283
21877,0,0,104,0,-104
21878,1,0,4,0,-4
21879,1,0,110,0,-110
21880,1,0,0,0,0
21881,1,0,24,0,-24
21882,1,1,189,1288,1099
21883,1,1,1023,2276,1253
21884,0,0,7,0,-7
21885,0,0,37,0,-37
21886,0,0,94,0,-94
21887,1,1,1105,1537,432
21888,1,0,36,0,-36
21889,1,0,23,0,-23
21890,1,0,175,0,-175
21891,1,1,17,1340,1323
21892,0,0,145,0,-145
21893,1,0,12,0,-12
21894,1,1,131,1373,1242
21895,0,0,44,0,-44
21896,1,0,11,0,-11
21897,1,0,4,0,-4
21898,1,1,221,1534,1313
21899,1,1,41,2222,2181
21900,0,0,32,0,-32
21901,1,0,23,0,-23
21902,1,0,135,0,-135
21903,1,0,48,0,-48
21904,1,0,44,0,-44
21905,1,1,455,1370,915
21906,0,0,1,0,-1
21907,0,0,67,0,-67
21908,1,0,6,0,-6
21909,0,0,32,0,-32
21910,1,0,19,0,-19
21911,1,1,1214,1265,51
21912,1,1,631,1442,811
21913,0,0,50,0,-50
21914,0,0,159,0,-159
21915,1,1,555,1415,860
21916,1,0,26,0,-26
21917,0,0,30,0,-30
21918,0,0,71,0,-71
21919,1,0,35,0,-35
21920,1,0,13,0,-13
21921,0,0,10,0,-10
21922,0,0,46,0,-46
21923,0,0,30,0,-30
21924,0,0,45,0,-45
21925,1,0,22,0,-22
21926,1,0,126,0,-126
21927,1,0,43,0,-43
21928,0,0,106,0,-106
21929,1,0,6,0,-6
21930,0,0,16,0,-16
21931,0,0,120,0,-120
21932,0,0,165,0,-165
21933,1,0,91,0,-91
21934,1,1,230,1382,1152
21935,1,0,59,0,-59
21936,0,0,113,0,-113
21937,1,1,1325,1781,456
21938,0,0,40,0,-40
21939,0,0,12,0,-12
21940,1,1,146,1643,1497
21941,1,0,34,0,-34
21942,1,0,51,0,-51
21943,1,1,826,1366,540
21944,1,0,115,0,-115
21945,1,1,505,1530,1025
21946,1,0,90,0,-90
21947,0,0,167,0,-167
21948,0,0,9,0,-9
21949,1,1,2049,1216,-833
21950,1,0,6,0,-6
21951,1,0,33,0,-33
21952,0,0,6,0,-6
21953,1,1,561,1744,1183
21954,1,1,849,1746,897
21955,0,0,63,0,-63
21956,1,1,617,2156,1539
21957,0,0,16,0,-16
21958,1,0,0,0,0
21959,0,0,40,0,-40
21960,0,0,20,0,-20
21961,1,1,864,2577,1713
21962,0,0,84,0,-84
21963,1,0,29,0,-29
21964,0,0,158,0,-158
21965,1,1,1238,1373,135
21966,1,0,175,0,-175
21967,1,0,3,0,-3
21968,1,1,113,1691,1578
21969,0,0,10,0,-10
21970,0,0,48,0,-48
21971,1,1,110,2477,2367
21972,1,0,175,0,-175
21973,1,0,99,0,-99
21974,0,0,124,0,-124
21975,1,0,67,0,-67
21976,0,0,4,0,-4
21977,1,0,140,0,-140
21978,0,0,55,0,-55
21979,1,1,1283,1258,-25
21980,0,0,43,0,-43
21981,0,0,0,0,0
21982,1,0,20,0,-20
21983,1,0,54,0,-54
21984,0,0,2,0,-2
21985,1,0,147,0,-147
21986,1,0,11,0,-11
21987,1,1,263,1285,1022
21988,1,0,9,0,-9
21989,1,0,149,0,-149
21990,1,0,82,0,-82
21991,1,1,700,1336,636
21992,0,0,116,0,-116
21993,1,0,143,0,-143
21994,1,0,76,0,-76
21995,1,0,28,0,-28
21996,0,0,27,0,-27
21997,0,0,43,0,-43
21998,0,0,3,0,-3
21999,0,0,37,0,-37
22000,1,1,835,2156,1321
22001,1,0,28,0,-28
22002,1,0,176,0,-176
22003,1,0,103,0,-103
22004,1,1,1333,2373,1040
22005,0,0,140,0,-140
22006,1,1,128,1849,1721
22007,0,0,186,0,-186
22008,1,0,41,0,-41
22009,1,1,408,1237,829
22010,1,0,48,0,-48
22011,0,0,73,0,-73
22012,1,1,289,1302,1013
22013,1,1,506,1363,857
22014,0,0,33,0,-33
22015,0,0,21,0,-21
22016,1,0,163,0,-163
22017,0,0,140,0,-140
22018,0,0,31,0,-31
22019,1,0,111,0,-111
22020,1,0,126,0,-126
22021,0,0,98,0,-98
22022,1,1,2147,1305,-842
22023,0,0,14,0,-14
22024,1,0,37,0,-37
22025,1,1,336,1289,953
22026,0,0,212,0,-212
22027,0,0,1,0,-1
22028,1,0,56,0,-56
22029,0,0,172,0,-172
22030,1,0,81,0,-81
22031,1,1,394,1883,1489
22032,0,0,34,0,-34
22033,1,1,546,1316,770
22034,0,0,109,0,-109
22035,1,0,48,0,-48
22036,0,0,84,0,-84
22037,1,0,144,0,-144
22038,1,0,71,0,-71
22039,0,0,170,0,-170
22040,0,0,0,0,0
22041,1,0,0,0,0
22042,0,0,18,0,-18
22043,1,1,1320,1251,-69
22044,1,0,68,0,-68
22045,0,0,3,0,-3
22046,1,0,80,0,-80
22047,1,1,183,1910,1727
22048,1,0,23,0,-23
22049,1,0,66,0,-66
22050,0,0,26,0,-26
22051,0,0,31,0,-31
22052,1,1,879,1667,788
22053,1,0,0,0,0
22054,0,0,90,0,-90
22055,0,0,163,0,-163
22056,0,0,78,0,-78
22057,0,0,12,0,-12
22058,1,1,486,1471,985
22059,0,0,94,0,-94
22060,1,0,98,0,-98
22061,1,0,36,0,-36
22062,1,0,9,0,-9
22063,0,0,79,0,-79
22064,0,0,13,0,-13
22065,0,0,44,0,-44
22066,0,0,81,0,-81
22067,0,0,182,0,-182
22068,1,0,106,0,-106
22069,0,0,0,0,0
22070,1,0,0,0,0
22071,1,0,81,0,-81
22072,1,1,949,1240,291
22073,1,1,650,4100,3450
22074,0,0,14,0,-14
22075,1,1,317,1863,1546
22076,0,0,0,0,0
22077,0,0,23,0,-23
22078,1,0,70,0,-70
22079,1,0,17,0,-17
22080,0,0,66,0,-66
22081,1,0,56,0,-56
22082,1,0,78,0,-78
22083,1,1,49,1279,1230
22084,0,0,58,0,-58
22085,1,1,523,1382,859
22086,0,0,108,0,-108
22087,0,0,20,0,-20
22088,0,0,31,0,-31
22089,0,0,6,0,-6
22090,1,1,284,1922,1638
22091,1,1,767,2176,1409
22092,1,0,6,0,-6
22093,1,1,394,1367,973
22094,0,0,66,0,-66
22095,0,0,48,0,-48
22096,1,0,29,0,-29
22097,1,0,40,0,-40
22098,1,1,636,1218,582
22099,0,0,32,0,-32
22100,0,0,36,0,-36
22101,1,1,488,1212,724
22102,1,1,503,1710,1207
22103,0,0,24,0,-24
22104,0,0,92,0,-92
22105,1,0,77,0,-77
22106,0,0,157,0,-157
22107,0,0,7,0,-7
22108,1,1,81,1514,1433
22109,1,0,51,0,-51
22110,1,0,46,0,-46
22111,0,0,10,0,-10
22112,1,0,11,0,-11
22113,1,0,108,0,-108
22114,0,0,56,0,-56
22115,0,0,56,0,-56
22116,1,0,4,0,-4
22117,0,0,57,0,-57
22118,1,0,163,0,-163
22119,0,0,100,0,-100
22120,1,0,6,0,-6
22121,0,0,128,0,-128
22122,0,0,85,0,-85
22123,1,1,465,1223,758
22124,1,0,5,0,-5
22125,1,0,48,0,-48
22126,1,1,122,2816,2694
22127,0,0,1,0,-1
22128,1,1,460,2131,1671
22129,1,0,8,0,-8
22130,1,0,1,0,-1
22131,0,0,37,0,-37
22132,0,0,13,0,-13
22133,1,0,71,0,-71
22134,0,0,28,0,-28
22135,1,0,63,0,-63
22136,0,0,2,0,-2
22137,0,0,39,0,-39
22138,1,0,21,0,-21
22139,0,0,114,0,-114
22140,1,0,10,0,-10
22141,1,0,108,0,-108
22142,1,1,145,2280,2135
22143,1,1,115,1446,1331
22144,0,0,2,0,-2
22145,0,0,16,0,-16
22146,0,0,0,0,0
22147,1,0,90,0,-90
22148,0,0,32,0,-32
22149,1,1,1685,1333,-352
22150,1,0,34,0,-34
22151,1,0,8,0,-8
22152,1,0,67,0,-67
22153,0,0,10,0,-10
22154,1,1,1394,1339,-55
22155,0,0,41,0,-41
22156,1,0,65,0,-65
22157,0,0,60,0,-60
22158,0,0,12,0,-12
22159,1,0,40,0,-40
22160,1,0,99,0,-99
22161,0,0,104,0,-104
22162,1,1,236,2134,1898
22163,1,0,4,0,-4
22164,1,1,215,1454,1239
22165,0,0,58,0,-58
22166,0,0,60,0,-60
22167,0,0,43,0,-43
22168,1,0,102,0,-102
22169,1,0,0,0,0
22170,1,1,389,1621,1232
22171,0,0,95,0,-95
22172,0,0,14,0,-14
22173,1,0,14,0,-14
22174,1,0,38,0,-38
22175,1,1,1150,1232,82
22176,1,0,73,0,-73
22177,1,1,1609,1200,-409
22178,0,0,80,0,-80
22179,0,0,131,0,-131
22180,1,1,78,1212,1134
22181,0,0,8,0,-8
22182,0,0,67,0,-67
22183,1,0,2,0,-2
22184,1,1,128,1330,1202
22185,0,0,51,0,-51
22186,0,0,21,0,-21
22187,1,1,2443,1321,-1122
22188,1,1,467,1510,1043
22189,0,0,8,0,-8
22190,0,0,8,0,-8
22191,1,1,551,1286,735
22192,0,0,9,0,-9
22193,1,0,68,0,-68
22194,0,0,22,0,-22
22195,0,0,16,0,-16
22196,0,0,61,0,-61
22197,0,0,117,0,-117
22198,0,0,92,0,-92
22199,0,0,69,0,-69
22200,1,1,283,1374,1091
22201,1,0,104,0,-104
22202,0,0,16,0,-16
22203,1,1,280,1892,1612
22204,1,1,1080,1410,330
22205,1,0,11,0,-11
22206,1,0,23,0,-23
22207,0,0,6,0,-6
22208,0,0,12,0,-12
22209,0,0,1,0,-1
22210,1,0,18,0,-18
22211,1,0,12,0,-12
22212,1,0,2,0,-2
22213,0,0,34,0,-34
22214,1,1,622,1476,854
22215,1,1,200,1432,1232
22216,0,0,15,0,-15
22217,1,1,1550,1312,-238
22218,1,0,62,0,-62
22219,1,0,48,0,-48
22220,1,0,36,0,-36
22221,0,0,107,0,-107
22222,0,0,1,0,-1
22223,0,0,1,0,-1
22224,1,0,5,0,-5
22225,1,1,369,2132,1763
22226,0,0,126,0,-126
22227,0,0,22,0,-22
22228,1,0,76,0,-76
22229,1,1,224,1211,987
22230,1,0,23,0,-23
22231,1,0,8,0,-8
22232,1,0,97,0,-97
22233,0,0,15,0,-15
22234,1,0,30,0,-30
22235,1,0,2,0,-2
22236,1,1,994,1400,406
22237,1,1,309,1216,907
22238,1,1,724,1306,582
22239,0,0,3,0,-3
22240,1,0,49,0,-49
22241,1,0,85,0,-85
22242,1,1,314,1616,1302
22243,0,0,119,0,-119
22244,1,0,25,0,-25
22245,0,0,3,0,-3
22246,0,0,5,0,-5
22247,1,0,15,0,-15
22248,1,0,4,0,-4
22249,1,1,135,1462,1327
22250,0,0,2,0,-2
22251,1,0,148,0,-148
22252,1,1,1061,1519,458
22253,1,1,291,1302,1011
22254,0,0,37,0,-37
22255,0,0,61,0,-61
22256,1,1,221,2034,1813
22257,0,0,20,0,-20
22258,1,0,4,0,-4
22259,1,1,443,1444,1001
22260,1,0,3,0,-3
22261,0,0,15,0,-15
22262,1,0,33,0,-33
22263,1,0,22,0,-22
22264,1,0,42,0,-42
22265,1,0,247,0,-247
22266,1,1,336,2666,2330
22267,1,1,975,1237,262
22268,1,1,716,3862,3146
22269,0,0,11,0,-11
22270,1,0,86,0,-86
22271,0,0,20,0,-20
22272,1,0,29,0,-29
22273,1,1,574,1514,940
22274,0,0,11,0,-11
22275,1,1,310,1913,1603
22276,0,0,25,0,-25
22277,1,1,616,1203,587
22278,0,0,9,0,-9
22279,0,0,21,0,-21
22280,1,0,50,0,-50
22281,0,0,18,0,-18
22282,0,0,21,0,-21
22283,0,0,169,0,-169
22284,1,1,616,1408,792
22285,1,0,42,0,-42
22286,1,0,29,0,-29
22287,0,0,42,0,-42
22288,1,0,3,0,-3
22289,1,0,8,0,-8
22290,1,1,848,1612,764
22291,1,1,82,1638,1556
22292,0,0,4,0,-4
22293,0,0,22,0,-22
22294,0,0,125,0,-125
22295,0,0,12,0,-12
22296,1,1,607,1461,854
22297,1,0,14,0,-14
22298,0,0,83,0,-83
22299,1,1,239,2851,2612
22300,0,0,48,0,-48
22301,1,0,18,0,-18
22302,0,0,227,0,-227
22303,0,0,53,0,-53
22304,0,0,10,0,-10
22305,0,0,52,0,-52
22306,1,0,4,0,-4
22307,0,0,61,0,-61
22308,1,1,83,1693,1610
22309,0,0,56,0,-56
22310,0,0,43,0,-43
22311,1,1,120,1593,1473
22312,0,0,28,0,-28
22313,0,0,10,0,-10
22314,1,0,20,0,-20
22315,1,1,248,1222,974
22316,0,0,112,0,-112
22317,1,1,1096,1259,163
22318,1,0,16,0,-16
22319,1,1,722,1447,725
22320,1,1,226,1913,1687
22321,0,0,14,0,-14
22322,0,0,29,0,-29
22323,1,1,659,1341,682
22324,1,1,192,1273,1081
22325,1,0,113,0,-113
22326,1,1,1686,1475,-211
22327,0,0,1,0,-1
22328,0,0,22,0,-22
22329,1,0,8,0,-8
22330,1,1,85,2304,2219
22331,1,1,401,1404,1003
22332,1,1,927,1353,426
22333,0,0,39,0,-39
22334,1,0,15,0,-15
22335,1,1,1233,1764,531
22336,0,0,4,0,-4
22337,1,0,33,0,-33
22338,0,0,158,0,-158
22339,0,0,17,0,-17
22340,1,1,2113,1518,-595
22341,1,0,15,0,-15
22342,0,0,43,0,-43
22343,1,0,9,0,-9
22344,1,1,67,1209,1142
22345,1,1,404,1904,1500
22346,1,1,308,1370,1062
22347,0,0,192,0,-192
22348,1,0,65,0,-65
22349,1,0,1,0,-1
22350,1,1,1669,1219,-450
22351,1,0,21,0,-21
22352,1,0,72,0,-72
22353,1,1,448,1220,772
22354,0,0,44,0,-44
22355,0,0,10,0,-10
22356,1,0,0,0,0
22357,1,1,2240,1919,-321
22358,1,1,518,1229,711
22359,1,1,74,1550,1476
22360,0,0,1,0,-1
22361,1,0,5,0,-5
22362,0,0,3,0,-3
22363,1,0,46,0,-46
22364,1,0,41,0,-41
22365,0,0,12,0,-12
22366,0,0,34,0,-34
22367,1,0,18,0,-18
22368,0,0,37,0,-37
22369,1,0,2,0,-2
22370,1,0,58,0,-58
22371,0,0,56,0,-56
22372,0,0,112,0,-112
22373,0,0,49,0,-49
22374,1,0,158,0,-158
22375,0,0,20,0,-20
22376,0,0,0,0,0
22377,1,0,5,0,-5
22378,0,0,11,0,-11
22379,0,0,124,0,-124
22380,0,0,9,0,-9
22381,0,0,9,0,-9
22382,0,0,4,0,-4
22383,1,0,256,0,-256
22384,0,0,22,0,-22
22385,0,0,181,0,-181
22386,1,1,1028,1641,613
22387,1,0,9,0,-9
22388,0,0,13,0,-13
22389,1,0,36,0,-36
22390,1,1,1064,1662,598
22391,1,1,1888,2512,624
22392,1,0,48,0,-48
22393,0,0,126,0,-126
22394,0,0,77,0,-77
22395,1,1,774,1544,770
22396,0,0,10,0,-10
22397,1,0,24,0,-24
22398,1,0,2,0,-2
22399,0,0,58,0,-58
22400,1,1,212,1333,1121
22401,1,0,109,0,-109
22402,0,0,10,0,-10
22403,1,1,657,1456,799
22404,0,0,28,0,-28
22405,0,0,150,0,-150
22406,0,0,37,0,-37
22407,0,0,88,0,-88
22408,1,1,292,2960,2668
22409,0,0,70,0,-70
22410,1,0,108,0,-108
22411,1,1,465,1727,1262
22412,1,0,35,0,-35
22413,1,0,204,0,-204
22414,1,0,49,0,-49
22415,0,0,5,0,-5
22416,0,0,91,0,-91
22417,1,1,173,1563,1390
22418,1,1,82,1224,1142
22419,1,1,81,2458,2377
22420,1,0,29,0,-29
22421,0,0,12,0,-12
22422,1,0,192,0,-192
22423,1,1,238,1429,1191
22424,1,1,810,1814,1004
22425,0,0,4,0,-4
22426,1,0,6,0,-6
22427,1,0,52,0,-52
22428,1,1,46,1220,1174
22429,1,0,5,0,-5
22430,1,0,8,0,-8
22431,1,1,296,1614,1318
22432,1,0,21,0,-21
22433,0,0,38,0,-38
22434,1,0,53,0,-53
22435,1,1,773,1404,631
22436,1,0,23,0,-23
22437,0,0,44,0,-44
22438,1,1,615,2093,1478
22439,0,0,10,0,-10
22440,1,1,85,1578,1493
22441,1,1,591,1820,1229
22442,1,1,173,1685,1512
22443,0,0,5,0,-5
22444,0,0,76,0,-76
22445,1,0,39,0,-39
22446,1,0,65,0,-65
22447,1,1,127,1757,1630
22448,1,0,80,0,-80
22449,0,0,33,0,-33
22450,1,1,3670,1714,-1956
22451,1,1,436,1856,1420
22452,0,0,25,0,-25
22453,1,1,97,1545,1448
22454,1,0,19,0,-19
22455,1,0,32,0,-32
22456,0,0,35,0,-35
22457,1,0,74,0,-74
22458,0,0,14,0,-14
22459,0,0,6,0,-6
22460,0,0,17,0,-17
22461,1,0,23,0,-23
22462,1,0,22,0,-22
22463,1,1,784,1628,844
22464,1,0,47,0,-47
22465,1,0,6,0,-6
22466,1,0,98,0,-98
22467,0,0,42,0,-42
22468,1,1,1243,1273,30
22469,1,1,419,1322,903
22470,1,1,592,1200,608
22471,1,1,192,1266,1074
22472,1,1,281,1216,935
22473,1,1,482,1436,954
22474,0,0,11,0,-11
22475,1,1,1738,1506,-232
22476,0,0,51,0,-51
22477,1,0,105,0,-105
22478,1,1,1237,2370,1133
22479,1,1,96,1780,1684
22480,1,1,205,1392,1187
22481,1,0,35,0,-35
22482,1,1,78,2068,1990
22483,0,0,157,0,-157
22484,0,0,32,0,-32
22485,1,0,78,0,-78
22486,0,0,22,0,-22
22487,1,1,2890,1486,-1404
22488,0,0,170,0,-170
22489,1,1,306,1200,894
22490,0,0,0,0,0
22491,1,1,414,1372,958
22492,1,1,663,1325,662
22493,1,0,3,0,-3
22494,0,0,35,0,-35
22495,0,0,47,0,-47
22496,0,0,5,0,-5
22497,1,1,1487,1684,197
22498,0,0,40,0,-40
22499,0,0,31,0,-31
22500,1,0,10,0,-10
22501,1,0,32,0,-32
22502,0,0,92,0,-92
22503,0,0,119,0,-119
22504,1,0,50,0,-50
22505,0,0,49,0,-49
22506,1,0,36,0,-36
22507,1,0,83,0,-83
22508,0,0,10,0,-10
22509,1,1,1730,1341,-389
22510,1,0,46,0,-46
22511,1,1,442,1613,1171
22512,0,0,13,0,-13
22513,0,0,158,0,-158
22514,0,0,4,0,-4
22515,1,0,70,0,-70
22516,0,0,5,0,-5
22517,1,1,388,1503,1115
22518,1,0,57,0,-57
22519,1,1,1398,1323,-75
22520,0,0,99,0,-99
22521,1,0,16,0,-16
22522,1,0,35,0,-35
22523,1,0,116,0,-116
22524,0,0,5,0,-5
22525,1,0,27,0,-27
22526,1,0,58,0,-58
22527,1,1,1069,1342,273
22528,0,0,62,0,-62
22529,0,0,42,0,-42
22530,1,0,34,0,-34
